FULL ADDRESS,FIRST SALE,FIRST PRICE,LAST SALE,LAST PRICE,PRICE CHANGE,PERIOD,DAILY PRICE CHANGE
"300 EAST 55 STREET, 3E",2004-12-22,987702,2005-04-12,1380000,392298,111,3534.2162162162163
"240 WEST 98TH ST.NY,NY, 13B",2008-03-04,1004529,2009-03-06,2300000,1295471,367,3529.893732970027
"155 FRANKLIN STREET, 4S",2014-09-15,4750000,2015-05-14,5600000,850000,241,3526.9709543568465
"201 EAST 80TH STREET, 8G",2012-12-21,200000,2016-02-12,4200000,4000000,1148,3484.320557491289
"15 BROAD STREET, 1414",2006-06-16,1071460,2006-11-22,1625000,553540,159,3481.383647798742
"250 EAST 53RD STREET, 2901",2008-05-09,2300511,2008-09-16,2750000,449489,130,3457.607692307692
"597 BROADWAY, 4W",2004-12-15,2500000,2007-03-22,5350000,2850000,827,3446.1910519951634
"225 WEST 60TH   STREET, 15B",2013-11-19,1252598,2014-04-25,1790000,537402,157,3422.9426751592355
"70 LITTLE WEST STREET, 3A",2015-06-24,490000,2015-12-09,1065000,575000,168,3422.6190476190477
"15 BROAD STREET, 2216",2006-07-18,1097216,2006-11-01,1460000,362784,106,3422.490566037736
"48 BEACH STREET, 3C",2012-02-22,2687290,2013-03-28,4042819,1355529,400,3388.8225
"212 WEST 18TH   STREET, 16D",2013-11-26,5905850,2017-09-15,10600000,4694150,1389,3379.517638588913
"200 EAST 79TH   STREET, 5A",2013-10-24,3253308,2014-10-28,4500000,1246692,369,3378.569105691057
"28 LAIGHT STREET, 6AB",2009-07-21,4400000,2011-08-03,6900000,2500000,743,3364.737550471063
"39 VESTRY STREET, 1A",2011-05-24,3550000,2013-02-20,5687500,2137500,638,3350.3134796238246
"151 EAST 58 STREET, 33F",2005-05-19,3843893,2005-11-01,4400000,556107,166,3350.0421686746986
"2211 BROADWAY, 3B",2015-05-28,4100000,2017-05-22,6500000,2400000,725,3310.344827586207
"25 COLUMBUS CIRCLE, ST57E",2003-12-31,2153465,2004-05-14,2600000,446535,135,3307.6666666666665
"15 BROAD STREET, 1914",2006-06-15,1174485,2006-11-21,1700000,525515,159,3305.125786163522
"768 5 AVENUE, 902",2013-06-25,3250000,2014-10-10,4800000,1550000,472,3283.898305084746
"15 BROAD STREET, 1724",2007-01-08,656771,2007-07-11,1255000,598229,184,3251.2445652173915
"744 GREENWICH STREET, PH",2007-05-11,7076837,2008-07-22,8500000,1423163,438,3249.2305936073058
"5 FRANKLIN PLACE, 12A",2016-04-25,3617333,2017-01-23,4500000,882667,273,3233.2124542124543
"1 YORK STREET, 11A",2008-12-08,14747425,2012-12-18,19500000,4752575,1471,3230.846363018355
"151 EAST 58TH STREET, 37F",2006-03-09,3450000,2007-09-10,5225000,1775000,550,3227.2727272727275
"155 WEST 68TH   STREET, 34-B",2012-05-08,15000,2013-11-01,1750000,1735000,542,3201.1070110701107
"41 WEST 72ND STREET, 12A",2017-07-17,1400000,2018-06-26,2495000,1095000,344,3183.139534883721
"15 CENTRAL PARK WEST, 11K",2007-12-03,5162527,2010-10-07,8450000,3287473,1039,3164.0741097208856
"145 EAST 48TH   STREET, 22G",2017-07-27,250000,2018-03-09,960000,710000,225,3155.5555555555557
"15 BROAD STREET, 2130",2006-11-15,605858,2007-04-16,1085000,479142,152,3152.25
"38 LAIGHT STREET, 4A",2005-01-12,1570802,2006-12-06,3750000,2179198,693,3144.5858585858587
"721 5 AVENUE, 42A",2008-07-15,1625000,2009-11-10,3137500,1512500,483,3131.4699792960664
"73 WORTH STREET, 2B",2014-03-13,3600000,2015-01-29,4600000,1000000,322,3105.590062111801
"15 CENTRAL PARK WEST, 23C",2008-06-30,4734862,2009-08-14,6000000,1265138,410,3085.70243902439
"15 WEST 53 STREET, 45B/C",2004-07-06,2775000,2006-10-04,5300000,2525000,820,3079.268292682927
"1107 BROADWAY, 5A",2015-10-30,1325214,2016-04-29,1885000,559786,182,3075.747252747253
"25 COLUMBUS CIRCLE, ST61B",2005-06-14,5046674,2008-07-16,8500000,3453326,1128,3061.459219858156
"310 WEST 52ND   STREET, 36J",2007-05-31,1247356,2007-09-07,1550000,302644,99,3057.010101010101
"65 LEONARD STREET, 5",2012-12-04,2150000,2015-05-06,4847500,2697500,883,3054.9263873159684
"207 EAST 57TH STREET, 19A",2012-06-05,1791213,2012-12-20,2395000,603787,198,3049.429292929293
"13 RECTOR STREET, 1901",2008-01-31,1965000,2008-05-29,2325000,360000,119,3025.2100840336134
"40 MERCER STREET, 18",2007-04-20,3640243,2007-11-21,4289700,649457,215,3020.7302325581395
"15 BROAD STREET, 1710",2006-06-20,1608835,2006-10-06,1935000,326165,108,3020.046296296296
"222 WEST 14 STREET, 8E",2004-04-20,400000,2004-12-17,1125000,725000,241,3008.298755186722
"230 WEST 56 STREET, 63A",2003-06-04,2810370,2003-11-14,3300000,489630,163,3003.865030674847
"15 BROAD STREET, 2112",2006-06-29,1092065,2006-12-14,1596000,503935,168,2999.6130952380954
"230 WEST 56 STREET, 49B",2003-03-10,1114934,2003-08-19,1600000,485066,162,2994.2345679012346
"2211 BROADWAY, 7J",2010-12-28,3906261,2013-02-25,6250000,2343739,790,2966.7582278481013
"150 CHARLES STREET, 6DN",2015-12-21,7000594,2016-06-07,7500000,499406,169,2955.0650887573966
"1107 BROADWAY, 2D",2017-03-03,3003837,2018-04-30,4250000,1246163,423,2946.0118203309694
"7 HUBERT STREET, 6B",2004-08-18,4505756,2007-06-12,7520000,3014244,1028,2932.1439688715955
"65 WEST 13TH STREET, 11A",2009-03-31,3750000,2011-09-09,6350000,2600000,892,2914.798206278027
"101 WEST 87TH   STREET, 202",2014-02-06,274395,2014-09-05,888000,613605,211,2908.0805687203792
"52 EAST 72ND STREET, 7",2007-11-15,1650000,2010-06-22,4400000,2750000,950,2894.7368421052633
"22 GRAMERCY PARK SOUTH, 2",2012-07-26,9186142,2016-09-30,13600000,4413858,1527,2890.542239685658
"123 WASHINGTON STREET, 43B",2013-09-19,2026875,2014-02-04,2425000,398125,138,2884.963768115942
"1 MORTON SQUARE, 8B W",2004-12-14,2952925,2007-02-27,5275000,2322075,805,2884.5652173913045
"50 CENTRAL PARK WEST, 4A",2003-12-12,228036,2004-08-05,910000,681964,237,2877.4852320675104
"15 BROAD ST, 1030",2007-03-30,880786,2007-08-09,1260000,379214,132,2872.8333333333335
"47 EAST 91ST STREET, 3",2004-09-14,5829481,2007-07-17,8800018,2970537,1036,2867.3137065637065
"217 WEST 19TH STREET, 6N",2008-04-21,2400000,2008-11-06,2970300,570300,199,2865.829145728643
"212 WEST 18TH   STREET, PH5",2014-01-29,14255500,2017-03-08,17500000,3244500,1134,2861.1111111111113
"230 WEST 78TH   STREET, 16A",2011-05-26,7127750,2015-02-09,11000000,3872250,1355,2857.749077490775
"80 RIVERSIDE BOULEVARD, 35C/D",2011-03-29,5500000,2012-04-18,6600000,1100000,386,2849.740932642487
"1 CENTRAL PARK WEST, 28G",2010-12-20,5150000,2012-01-10,6250000,1100000,386,2849.740932642487
"279 CENTRAL PARK WEST, PH6A",2003-08-21,2800000,2004-04-23,3500000,700000,246,2845.528455284553
"59 WEST 12 STREET, 10B",2003-10-30,455000,2006-08-25,3375000,2920000,1030,2834.9514563106795
"40 EAST 61ST STREET, 5A",2005-03-31,900000,2005-08-01,1248000,348000,123,2829.268292682927
"170 EAST END AVENUE, 12B",2008-12-12,5625831,2009-07-23,6250000,624169,223,2798.964125560538
"80 COLUMBUS CIRCLE, NT68D",2004-03-19,4862144,2006-02-17,6800000,1937856,700,2768.365714285714
"49 EAST 21ST STREET, 8A",2004-11-17,1282995,2005-04-08,1675000,392005,142,2760.5985915492956
"88 FRANKLIN STREET, 3",2012-12-21,3576197,2016-04-29,6925000,3348803,1225,2733.7167346938777
"407 GREENWICH STREET, 2A",2017-02-16,3550000,2017-11-07,4270000,720000,264,2727.2727272727275
"5 EAST 22 STREET, 19-C",2003-11-06,915000,2004-06-08,1500000,585000,215,2720.9302325581393
"15 BROAD STREET, 1506",2006-06-16,664511,2006-10-06,969000,304489,112,2718.651785714286
"207 EAST 57TH   STREET, 34A",2007-07-03,3436593,2008-05-16,4300000,863407,318,2715.116352201258
"20 WEST 64TH STREET, 10R",2009-02-19,450000,2010-02-23,1450000,1000000,369,2710.027100271003
"1 CENTRAL PARK WEST, 39G",2004-05-25,5738615,2006-05-01,7650000,1911385,706,2707.344192634561
"345 WEST 13TH STREET, 5F",2009-06-30,3000000,2010-12-01,4400000,1400000,519,2697.495183044316
"25 COLUMBUS CIRCLE, ST56A",2003-12-12,3978047,2008-06-20,8425000,4446953,1652,2691.8601694915255
"217 WEST 14 STREET, 5R",2004-08-30,765000,2005-07-07,1600000,835000,311,2684.887459807074
"207 EAST 57TH STREET, 30B",2010-08-12,970000,2011-12-22,2300000,1330000,497,2676.056338028169
"205 EAST 85TH   STREET, PH1A",2010-08-09,6671874,2013-07-24,9550000,2878126,1080,2664.9314814814816
"80 COLUMBUS CIRCLE, NT64B",2004-07-06,3563875,2008-05-08,7300000,3736125,1402,2664.8537803138374
"56 LEONARD STREET, 20BW",2016-06-22,5927168,2017-02-28,6595000,667832,251,2660.6852589641435
"120 RIVERSIDE BOULEVARD, 7A",2006-02-07,562074,2006-05-15,820000,257926,97,2659.0309278350514
"137 DUANE STREET, 3A",2014-04-03,6211325,2018-04-12,10116000,3904675,1470,2656.2414965986395
"900 PARK AVENUE, 17A",2007-06-05,2200000,2008-06-16,3200000,1000000,377,2652.5198938992044
"41 WEST 72ND STREET, 14C",2005-06-16,610950,2007-03-13,2295000,1684050,635,2652.047244094488
"1107 BROADWAY, 6D",2015-12-17,3614787,2016-06-17,4100000,485213,183,2651.437158469945
"438 EAST 12TH STREET, 3A",2018-03-14,1349181,2018-06-28,1630000,280819,106,2649.235849056604
"225 LAFAYETTE STREET, 4A",2005-01-12,1038615,2005-08-22,1625000,586385,222,2641.373873873874
"1 CENTRAL PARK WEST, 31C",2004-04-27,2272500,2005-11-09,3750000,1477500,561,2633.6898395721923
"205 WEST 76TH   STREET, 1402",2010-05-03,6275323,2012-09-13,8550000,2274677,864,2632.728009259259
"132 WEST 22ND STREET, 5",2011-09-02,3200000,2013-09-03,5125000,1925000,732,2629.781420765027
"1235 PARK AVENUE, 11B",2007-01-11,1725000,2007-06-18,2138325,413325,158,2615.981012658228
"25 CENTRAL PARK WEST, 17R",2009-06-12,3360225,2013-07-30,7300000,3939775,1509,2610.85155732273
"155 FRANKLIN STREET, 2N",2013-10-02,5870000,2017-11-10,9750000,3880000,1500,2586.6666666666665
"1641 3 AVENUE, 8H",2003-02-20,361998,2003-05-29,615000,253002,98,2581.6530612244896
"211 EAST 13TH   STREET, 3K",2014-06-17,1743207,2015-01-09,2275000,531793,206,2581.519417475728
"721 5 AVENUE, 61A/B",2010-01-29,5941967,2013-11-20,9500000,3558033,1391,2557.8957584471605
"151 EAST 58TH   STREET, 34B",2007-03-22,10995000,2011-02-18,14650000,3655000,1429,2557.732680195941
"2211 BROADWAY, 8L",2010-07-27,3865277,2013-09-19,6800000,2934723,1150,2551.933043478261
"54 BLEECKER STREET, 5B",2010-05-18,825000,2014-09-16,4850000,4025000,1582,2544.2477876106195
"2211 BROADWAY, 11C",2010-09-03,3851021,2011-11-09,4950000,1098979,432,2543.9328703703704
"225 5 AVENUE, 7J",2007-02-07,3036930,2007-12-12,3820000,783070,308,2542.435064935065
"141 WEST 24 STREET, RES-7",2003-09-02,1530939,2005-07-07,3239750,1708811,674,2535.327893175074
"123 WASHINGTON STREET, 41A",2013-09-19,1380672,2014-05-16,1985587,604915,239,2531.0251046025105
"140 EAST 63RD STREET, 6D",2007-12-04,2031408,2008-04-18,2375000,343592,136,2526.4117647058824
"161 GRAND STREET, 9A",2005-09-14,100000,2008-07-29,2750000,2650000,1049,2526.2154432793136
"150 CHARLES STREET, 7BS",2016-02-02,12253689,2017-09-19,13750000,1496311,595,2514.8084033613445
"101 WARREN STREET, 960M",2011-02-28,100000,2013-07-24,2300000,2200000,877,2508.551881413911
"93 CROSBY STREET, 6",2012-12-10,560037,2015-12-07,3275000,2714963,1092,2486.2298534798533
"7 HUBERT STREET, 11B",2004-09-10,3446776,2008-02-19,6570000,3123224,1257,2484.66507557677
"15 UNION SQUARE WEST, 18",2011-11-17,5243987,2014-06-24,7600000,2356013,950,2480.013684210526
"7 HUBERT STREET, M9C",2004-11-19,2739092,2007-05-01,4950000,2210908,893,2475.820828667413
"210 LAFAYETTE STREET, 4C",2005-12-19,992793,2006-04-12,1275000,282207,114,2475.5
"79 EAST 2ND   STREET, R2",2009-07-16,2650000,2011-03-14,4150000,1500000,606,2475.2475247524753
"230 WEST 56 STREET, 49E",2003-06-17,926608,2003-11-13,1295000,368392,149,2472.4295302013425
"200 CHAMBERS STREET, 23C",2007-05-21,2072138,2008-01-10,2650000,577862,234,2469.4957264957266
"101 WEST 67TH   STREET, 54P1D",2010-06-23,7000000,2012-12-21,9250000,2250000,912,2467.1052631578946
"161 HUDSON STREET, 2A",2013-07-03,3025000,2015-01-12,4400000,1375000,558,2464.15770609319
"404 EAST 76 STREET, 30C",2003-12-09,1410276,2005-02-03,2450000,1039724,422,2463.8009478672984
"41 BOND STREET, PH",2011-12-23,8196912,2015-08-25,11500000,3303088,1341,2463.152870991797
"30 LITTLE WEST STREET, PH2F",2014-05-29,3032505,2015-10-26,4300000,1267495,515,2461.1553398058254
"160 WOOSTER STREET, PH-B",2005-07-28,5040337,2007-02-01,6400000,1359663,553,2458.7034358047017
"300 EAST 55 STREET, 17B",2005-03-02,1440823,2005-11-15,2075000,634177,258,2458.0503875968993
"308 EAST 72ND STREET, 15C",2006-09-07,1750000,2010-09-20,5350000,3600000,1474,2442.3337856173675
"3 EAST 95TH   STREET, 4",2007-10-24,19219468,2008-09-08,20000000,780532,320,2439.1625
"45 EAST 25TH   STREET, PH-C",2011-07-27,1425000,2013-12-17,3550000,2125000,874,2431.350114416476
"250 WEST STREET, J",2013-08-19,1501918,2014-09-15,2450000,948082,392,2418.576530612245
"150 CHARLES STREET, 4BS",2015-08-27,12877285,2018-01-31,15000000,2122715,888,2390.4448198198197
"220, 30G",2003-07-15,1310742,2003-10-30,1565000,254258,107,2376.2429906542056
"16 WEST 21ST   STREET, PH-A",2012-03-05,4633037,2015-06-25,7500000,2866963,1207,2375.2800331400167
"52 LAIGHT STREET, R6",2013-10-03,3054750,2015-11-19,4900000,1845250,777,2374.839124839125
"1 CENTRAL PARK WEST, 39A",2007-05-18,7250000,2012-04-17,11500000,4250000,1796,2366.369710467706
"103-05 GREENE STREET, 6B",2003-07-23,1934675,2004-03-18,2500000,565325,239,2365.3765690376567
"250 WEST STREET, 3E",2013-04-17,2830735,2014-02-28,3579000,748265,317,2360.457413249211
"250 WEST STREET, 11B",2014-03-04,5600375,2016-05-17,7500000,1899625,805,2359.782608695652
"241 5 AVENUE, 5A",2013-12-18,824782,2014-05-27,1200000,375218,160,2345.1125
"230 WEST 56 STREET, PH-A",2003-09-03,3207488,2004-11-23,4250000,1042512,447,2332.241610738255
"51 WALKER STREET, 3A",2007-02-15,1070156,2007-06-15,1350000,279844,120,2332.0333333333333
"99 JANE STREET, 9C",2008-07-10,4495000,2014-02-14,9250000,4755000,2045,2325.1833740831294
"30 LITTLE WEST STREET, 30A",2016-08-15,1550000,2018-04-11,2950000,1400000,604,2317.880794701987
"230 WEST 56 STREET, 68D",2003-07-11,2998746,2004-09-15,4000000,1001254,432,2317.7175925925926
"124 EAST 13TH STREET, 3",2013-09-18,1181814,2016-06-30,3531937,2350123,1016,2313.113188976378
"120 11TH   AVENUE, 4B",2011-04-06,3512962,2015-08-24,7200000,3687038,1601,2302.9594003747657
"400 EAST 51 STREET, 22A",2003-06-17,3371020,2005-11-15,5400000,2028980,882,2300.4308390022675
"25 COLUMBUS CIRCLE, ST53D",2003-12-05,3926699,2007-08-06,7000000,3073301,1340,2293.508208955224
"21 ASTOR PLACE, 7E",2004-04-23,3003838,2008-04-01,6300000,3296162,1439,2290.5920778318277
"65 WEST 13 STREET, 10G",2003-03-10,1403149,2004-11-09,2800000,1396851,610,2289.9196721311478
"230 WEST 56 STREET, 57D",2003-05-14,1512101,2003-10-31,1900000,387899,170,2281.758823529412
"70 BATTERY PLACE, 22C",2012-08-30,1397548,2013-09-09,2250000,852452,375,2273.2053333333333
"250 WEST STREET, 8H",2013-03-21,2723818,2015-09-01,4750000,2026182,894,2266.422818791946
"188 EAST 64TH STREET, 3803",2006-01-06,1600000,2006-09-28,2200000,600000,265,2264.1509433962265
"59 WEST 12TH   STREET, 2E",2007-09-10,2000000,2008-03-05,2400000,400000,177,2259.8870056497176
"238 EAST 4TH   STREET, -",2010-08-24,3027375,2015-06-15,6995000,3967625,1756,2259.467539863326
"30 WEST 63RD   STREET, 7K",2010-03-16,1008067,2010-12-03,1600000,591933,262,2259.2862595419847
"721 5 AVENUE, 50H",2012-05-31,1680112,2013-05-07,2450000,769888,341,2257.7360703812315
"2211 BROADWAY, 7A",2013-01-04,4022087,2014-01-06,4850000,827913,367,2255.893732970027
"161 WEST 61 STREET, 20B",2003-08-22,350000,2005-11-16,2182500,1832500,817,2242.9620563035496
"15 UNION SQUARE WEST, 27",2010-08-06,7250000,2016-05-24,12000000,4750000,2118,2242.681775259679
"220, 16D",2003-04-29,603250,2003-08-06,825000,221750,99,2239.89898989899
"535 WEST END AVENUE, 8A",2012-09-20,8858775,2013-05-20,9400000,541225,242,2236.46694214876
"1 CENTRAL PARK WEST, 29A",2009-02-12,7200000,2012-11-08,10250000,3050000,1365,2234.4322344322345
"140 FRANKLIN STREET, 5-BC",2012-08-02,14300000,2018-05-10,19000000,4700000,2107,2230.659705742762
"845 UNITED NATIONS PLAZA, 64E",2007-05-30,2998000,2008-08-01,3950000,952000,429,2219.114219114219
"350 WEST 42ND   STREET, 48A",2012-11-26,315000,2014-06-06,1550000,1235000,557,2217.235188509874
"1 CENTRAL PARK WEST, 31D",2007-09-19,7200000,2008-07-31,7900000,700000,316,2215.1898734177216
"245 EAST 93 STREET, 30G",2005-11-21,675000,2007-02-28,1700000,1025000,464,2209.051724137931
"99 JOHN STREET, PH10",2012-04-24,2550000,2014-09-29,4500000,1950000,888,2195.945945945946
"260 PARK AVENUE SOUTH, PHA",2007-08-06,8655125,2012-05-22,12500000,3844875,1751,2195.816676185037
"350 EAST 82ND   STREET, 9D",2013-12-31,1150000,2016-02-24,2870000,1720000,785,2191.082802547771
"144 WEST 18 STREET, 300W",2003-09-11,1560142,2004-09-29,2400000,839858,384,2187.1302083333335
"1 MORTON SQUARE, 4G W",2004-10-26,992868,2005-10-28,1795000,802132,367,2185.6457765667574
"519 WEST 23RD STREET, R3",2007-10-19,1781937,2008-04-16,2175000,393063,180,2183.6833333333334
"900 PARK AVENUE, 27A",2004-06-21,1800000,2005-06-23,2600000,800000,367,2179.8365122615805
"15 BROAD STREET, 2028",2006-10-16,493851,2007-02-22,775000,281149,129,2179.4496124031007
"106 CENTRAL PARK SOUTH, 3D",2012-09-07,1625000,2014-10-17,3295000,1670000,770,2168.8311688311687
"222 WEST 14TH   STREET, 7D",2017-06-15,555000,2017-10-13,815000,260000,120,2166.6666666666665
"7 EAST 20TH STREET, 7R",2013-08-07,2414000,2015-08-10,4000000,1586000,733,2163.7107776261937
"120 RIVERSIDE BOULEVARD, 7S",2006-01-19,1304989,2006-06-15,1622000,317011,147,2156.5374149659865
"245 EAST 93 STREET, 30H",2005-11-21,550000,2007-02-28,1550000,1000000,464,2155.1724137931033
"15 CENTRAL PARK WEST, 16L",2008-05-22,4734862,2013-11-06,9030000,4295138,1994,2154.0310932798393
"15 CENTRAL PARK WEST, 16K",2009-01-07,7127750,2009-06-29,7500000,372250,173,2151.734104046243
"225 5 AVENUE, 10K",2006-11-30,2667815,2007-06-19,3100000,432185,201,2150.1741293532336
"28 EAST 10TH   STREET, 11E",2010-07-13,4100000,2013-03-07,6180000,2080000,968,2148.7603305785124
"1 CENTRAL PARK WEST, PH51A",2004-03-09,11200000,2006-07-18,13050000,1850000,861,2148.664343786295
"10 WEST STREET, PH2B",2005-09-30,4250000,2007-01-09,5250000,1000000,466,2145.922746781116
"200 CHAMBERS STREET, 22F",2008-07-14,2585000,2012-07-11,5700000,3115000,1458,2136.488340192044
"144 COLUMBUS AVENUE, 20C",2011-04-11,3650000,2013-05-23,5300000,1650000,773,2134.540750323415
"215 EAST 80 STREET, 6H",2003-03-07,357334,2003-11-14,895000,537666,252,2133.595238095238
"254 PARK AVENUE SOUTH, 11CDG",2010-08-05,3360225,2013-05-29,5550000,2189775,1028,2130.1313229571983
"157 HUDSON STREET, 5B",2012-04-13,3605875,2017-10-03,7850000,4244125,1999,2123.1240620310155
"635 WEST 42ND STREET, 33E",2010-07-02,618750,2011-05-13,1285000,666250,315,2115.0793650793653
"2211 BROADWAY, 2A",2010-12-28,5303758,2014-06-30,8000000,2696242,1280,2106.4390625
"129 LAFAYETTE STREET, 9A",2005-01-25,2087412,2006-09-05,3325000,1237588,588,2104.7414965986395
"230 WEST 78TH   STREET, 5A",2011-05-11,3360225,2013-08-28,5125000,1764775,840,2100.9226190476193
"2148 BROADWAY, PH3A",2011-11-18,7370000,2014-06-19,9350000,1980000,944,2097.4576271186443
"70 BATTERY PLACE, 24C",2013-01-30,1420458,2015-03-19,3050000,1629542,778,2094.526992287918
"521 PARK AVENUE, 8A",2012-01-26,1450000,2013-06-05,2488000,1038000,496,2092.7419354838707
"250 WEST STREET, 11C",2013-06-17,6050420,2016-10-18,8600000,2549580,1219,2091.5340442986053
"203 WEST 81ST STREET, 7F",2004-11-30,15000,2005-09-30,650000,635000,304,2088.815789473684
"56 LEONARD STREET, 40W",2016-09-01,10978315,2018-08-08,12450000,1471685,706,2084.5396600566573
"15 CENTRAL PARK WEST, 12L",2007-12-06,4439570,2014-08-01,9500000,5060430,2430,2082.4814814814813
"415 GREENWICH STREET, 4H",2010-10-12,2987500,2013-08-05,5125000,2137500,1028,2079.280155642023
"100 UNITED NATIONS PLAZA, 11A/B",2017-01-13,3200000,2018-03-22,4100000,900000,433,2078.5219399538105
"15 BROAD ST, 906",2007-05-29,702592,2007-09-11,920000,217408,105,2070.552380952381
"455 CENTRAL PARK WEST, PH1",2005-10-19,5193075,2008-11-07,7500000,2306925,1115,2068.9910313901346
"40 MERCER STREET, 7",2007-03-27,3309312,2008-07-30,4325000,1015688,491,2068.61099796334
"324 PEARL STREET, 1E",2004-02-24,320194,2004-06-04,529000,208806,101,2067.3861386138615
"1 BOND STREET, 2C",2010-12-15,600000,2017-08-18,5640000,5040000,2438,2067.2682526661197
"140 EAST 63RD STREET, 11E",2007-08-30,1629200,2007-12-27,1875000,245800,119,2065.546218487395
"325 FIFTH AVENUE, 31B",2007-01-04,1568105,2007-06-26,1925000,356895,173,2062.976878612717
"1 CENTRAL PARK WEST, 39D",2004-06-11,4600000,2008-10-07,7850000,3250000,1579,2058.264724509183
"1107 BROADWAY, 5E",2016-03-23,8655125,2018-02-23,10100000,1444875,702,2058.2264957264956
"535 WEST END AVENUE, 7A",2010-12-14,8700000,2015-07-23,12150000,3450000,1682,2051.129607609988
"404 PARK AVENUE SOUTH, 10D",2014-12-11,3675882,2015-09-17,4250000,574118,280,2050.4214285714284
"50 WARREN STREET, 2FL",2003-09-03,2600000,2005-05-12,3864600,1264600,617,2049.5948136142624
"15 BROAD STREET, 2102",2006-06-29,633603,2006-11-29,947000,313397,153,2048.346405228758
"400 EAST 54 STREET, 18G",2003-09-26,370510,2004-12-20,1290000,919490,451,2038.780487804878
"415 WASHINGTON STREET, 1B",2010-05-13,3592386,2014-07-17,6700000,3107614,1526,2036.4442988204455
"129 WEST 118TH STREET, 4",2014-12-01,1216808,2016-06-10,2350000,1133192,557,2034.456014362657
"200 CHAMBERS, 22C",2007-05-23,2158690,2008-03-27,2785000,626310,309,2026.893203883495
"157 CHAMBERS STREET, PH",2011-01-12,7770262,2017-06-19,12500000,4729738,2350,2012.6544680851064
"112 WEST 18TH   STREET, 18-5C",2012-01-27,985000,2013-04-26,1900000,915000,455,2010.989010989011
"155 WEST 68 STREET, 41168",2005-12-13,435000,2006-03-15,620000,185000,92,2010.8695652173913
"310 WEST 52ND   STREET, 12B",2007-03-02,1058980,2007-07-10,1320000,261020,130,2007.8461538461538
"130 WEST 30 STREET, 3A",2004-05-14,972428,2004-09-30,1250000,277572,139,1996.9208633093526
"230 WEST 56 STREET, 63D",2003-06-10,2479439,2005-06-16,3950000,1470561,737,1995.3337856173678
"123 WASHINGTON STREET, 43A",2013-09-19,1380672,2014-02-04,1655000,274328,138,1987.8840579710145
"225 WEST 60TH   STREET, 7E",2007-03-09,539672,2008-03-26,1300000,760328,383,1985.190600522193
"123 THIRD AVENUE, 17A",2012-09-10,3700000,2014-06-03,4950000,1250000,631,1980.9825673534074
"15 CENTRAL PARK WEST, S601",2008-09-12,1028229,2010-11-15,2600000,1571771,794,1979.5604534005038
"285 LAFAYETTE STREET, PHA",2013-02-01,7900000,2016-09-07,10500000,2600000,1314,1978.6910197869101
"25 CENTRAL PARK WEST, 15J",2005-01-20,5525000,2009-03-04,8500000,2975000,1504,1978.0585106382978
"321 5 AVENUE, 38D",2007-02-26,1700477,2007-07-25,1995000,294523,149,1976.6644295302012
"1280 5 AVENUE, 14E",2013-12-18,2485000,2014-12-16,3200000,715000,363,1969.6969696969697
"15 UNION SQUARE WEST, 21",2010-01-22,7448498,2016-05-24,12000000,4551502,2314,1966.9412273120138
"15 CENTRAL PARK WEST, 6L",2007-11-29,2403070,2011-05-23,4900000,2496930,1271,1964.539732494099
"219 WEST 81ST   STREET, 3D",2010-05-27,1600000,2014-04-17,4390000,2790000,1421,1963.4060520760029
"2211 BROADWAY, 6C",2010-12-20,3866804,2014-09-03,6510000,2643196,1353,1953.581670362158
"721 5 AVENUE, 45K",2013-10-31,4100000,2016-03-31,5820000,1720000,882,1950.1133786848072
"57 READE STREET, 7E",2013-04-01,1730000,2013-09-20,2065000,335000,172,1947.6744186046512
"15 CENTRAL PARK WEST, 24C",2007-12-10,5396725,2010-05-03,7100000,1703275,875,1946.6
"200 EAST 69 STREET, 33B",2003-02-07,1475000,2005-04-28,3050000,1575000,811,1942.0468557336621
"1992 BROADWAY, 22-B",2003-08-12,577736,2004-05-25,1134586,556850,287,1940.2439024390244
"15 UNION SQUARE WEST, 13",2012-10-22,4541062,2014-04-22,5600000,1058938,547,1935.9012797074954
"205 WEST 76TH   STREET, PH1A",2010-01-05,5191362,2011-08-01,6300000,1108638,573,1934.7958115183246
"645 5 AVENUE, 31A",2004-08-25,1825000,2005-02-09,2150000,325000,168,1934.5238095238096
"1 MORTON SQUARE, 11B W",2004-12-07,2647450,2008-02-20,4900000,2252550,1170,1925.2564102564102
"845 UNITED NATIONS PLAZA, 54E",2015-06-25,2525000,2016-01-22,2930000,405000,211,1919.431279620853
"502 PARK AVENUE, 4C",2005-02-02,7036107,2009-03-09,9900000,2863893,1496,1914.3669786096257
"60 RIVERSIDE BOULEVARD, 1501",2013-05-17,4497555,2015-06-16,5950000,1452445,760,1911.1118421052631
"140 EAST 63RD STREET, 12A",2007-08-23,3250438,2008-07-15,3875000,624562,327,1909.9755351681956
"117-19 EAST 24 STREET, 0.25",2003-10-31,850000,2004-05-12,1220000,370000,194,1907.2164948453608
"117 EAST 57TH   STREET, 39H",2015-11-23,1170000,2016-05-05,1480000,310000,164,1890.2439024390244
"207 EAST 57TH   STREET, 35A",2007-02-16,3563875,2008-03-12,4300000,736125,390,1887.5
"400 WEST 12TH   STREET, 14C",2009-12-10,11709875,2013-08-19,14250000,2540125,1348,1884.3657270029673
"157 EAST 74TH   STREET, 5B/5C",2007-01-11,4150000,2007-12-20,4795000,645000,343,1880.466472303207
"219 WEST 81ST   STREET, 12D",2009-07-31,1220000,2010-08-11,1925000,705000,376,1875.0
"340 EAST 64TH STREET, 11J",2009-08-05,700000,2010-11-16,1575000,875000,468,1869.6581196581196
"200 EAST 69TH STREET, 39B",2010-05-05,1750000,2014-03-06,4368292,2618292,1401,1868.8736616702356
"60 RIVERSIDE BOULEVARD, 1911",2012-01-06,3057750,2013-07-18,4100000,1042250,559,1864.490161001789
"252 7 AVENUE, PH-D",2004-09-23,2575000,2011-03-31,7000000,4425000,2380,1859.2436974789916
"60 RIVERSIDE BOULEVARD, 3902",2011-08-29,6723450,2015-10-02,9500000,2776550,1495,1857.2240802675585
"157 EAST 84TH   STREET, 2",2011-07-01,7407768,2013-08-16,8850000,1442232,777,1856.1544401544402
"101 WARREN STREET, 2840",2008-12-31,6318241,2014-06-11,10000000,3681759,1988,1851.991448692153
"25 CENTRAL PARK WEST, 9C",2003-11-22,1130000,2004-08-02,1600000,470000,254,1850.3937007874015
"721 5 AVENUE, 43D",2004-08-18,1300000,2005-01-14,1575000,275000,149,1845.6375838926174
"7 HUBERT STREET, 7C",2010-03-18,5280000,2011-02-17,5900000,620000,336,1845.2380952380952
"30 EAST 85 STREET, 18A",2003-11-24,2800000,2004-03-17,3010000,210000,114,1842.1052631578948
"382 CENTRAL PARK WEST, 1B",2017-08-16,600000,2018-02-09,926000,326000,177,1841.8079096045199
"200 CHAMBERS STREET, 5N",2007-03-15,687318,2007-06-25,875000,187682,102,1840.0196078431372
"252 7 AVENUE, PH-R",2003-04-01,250000,2007-08-29,3200000,2950000,1611,1831.1607697082557
"88 GREENWICH STREET, 2104",2014-02-19,425000,2014-12-11,965000,540000,295,1830.5084745762713
"133 NORFOLK STREET, R-2",2005-07-20,800000,2006-08-14,1513687,713687,390,1829.9666666666667
"345 WEST 14TH   STREET, 7A",2013-07-12,3640243,2014-07-09,4300000,659757,362,1822.5331491712707
"216 EAST 47TH   STREET, 22A",2012-08-10,300000,2012-12-20,540000,240000,132,1818.1818181818182
"124 8 AVENUE, 5L",2003-11-26,746791,2004-07-30,1195000,448209,247,1814.6113360323886
"301 WEST 57TH STREET, 40C",2014-12-18,4000000,2016-11-07,5250000,1250000,690,1811.5942028985507
"300 EAST 77TH   STREET, 20A",2008-04-30,750000,2012-06-18,3481481,2731481,1510,1808.9278145695364
"706 RIVERSIDE DRIVE, 8D",2012-04-17,144000,2013-02-13,690000,546000,302,1807.9470198675497
"31-33 NORTH MOORE STREET, 3E",2004-02-12,2900000,2006-07-17,4500000,1600000,886,1805.8690744920993
"15 BROAD STREET, 2510",2006-07-05,1400093,2007-03-14,1855000,454907,252,1805.186507936508
"40 BOND STREET, 4C",2007-07-12,4887600,2008-05-05,5425000,537400,298,1803.3557046979865
"5 FRANKLIN PLACE, 8B",2016-01-25,1102500,2016-08-05,1450000,347500,193,1800.518134715026
"25 COLUMBUS CIRCLE, ST58C",2004-06-10,4538285,2008-03-06,6995000,2456715,1365,1799.7912087912089
"250 MANHATTAN AVENUE, 2B",2015-11-12,600000,2016-05-20,941881,341881,190,1799.3736842105263
"388 WEST BROADWAY, 2",2003-04-08,2240150,2007-06-20,5000000,2759850,1534,1799.1199478487615
"30 WEST 63RD   STREET, 26PR",2010-11-16,2261788,2014-02-14,4395000,2133212,1186,1798.6610455311973
"15 CENTRAL PARK WEST, 6H",2007-10-15,978737,2014-06-09,5337500,4358763,2429,1794.4680938657884
"25 COLUMBUS CIRCLE, ST59E",2004-01-28,2117828,2007-09-19,4500000,2382172,1330,1791.1067669172933
"250 WEST STREET, 4F",2013-03-08,2708545,2014-09-05,3685000,976455,546,1788.3791208791208
"21 ASTOR PLACE, 7D",2004-03-18,3411138,2008-04-30,6100000,2688862,1504,1787.8071808510638
"3 WOOSTER STREET, PH",2008-04-09,1529933,2015-04-21,6100000,4570067,2568,1779.6211059190032
"80 RIVERSIDE BOULEVARD, 33C/D",2010-03-17,5025471,2014-12-09,8100000,3074529,1728,1779.2413194444443
"1485 5 AVENUE, 2628C",2012-10-11,3054750,2018-03-30,6600000,3545250,1996,1776.1773547094188
"8 EAST 12TH   STREET, 11",2010-04-30,1250000,2013-03-08,3100000,1850000,1043,1773.7296260786193
"315 SEVENTH AVENUE, 12B",2007-03-28,541910,2007-06-28,705000,163090,92,1772.7173913043478
"366 WEST 15 STREET, 5E",2003-11-13,1624109,2005-02-28,2462500,838391,473,1772.4968287526426
"250 WEST STREET, 3C",2013-02-22,3321531,2016-03-22,5312500,1990969,1124,1771.3247330960853
"8 THOMAS STREET, 1",2010-10-20,1614600,2012-06-25,2700000,1085400,614,1767.7524429967427
"15 CENTRAL PARK WEST, 2D",2008-07-25,4327562,2011-12-06,6500000,2172438,1229,1767.646867371847
"395 BROADWAY, 5A",2015-01-02,1850000,2015-11-10,2400000,550000,312,1762.820512820513
"30 CROSBY STREET, 3A",2010-03-31,4800000,2015-12-29,8500000,3700000,2099,1762.7441638875655
"7 HUBERT STREET, 7A",2004-08-17,3029293,2011-07-29,7500000,4470707,2537,1762.2022073314938
"2000 BROADWAY, 7E",2012-08-31,800000,2015-02-27,2400000,1600000,910,1758.2417582417581
"200 EAST 89 STREET, 12H",2003-10-27,44516,2004-05-27,419000,374484,213,1758.1408450704225
"15 BROAD STREET, 1212",2006-05-08,931698,2007-05-24,1600000,668302,381,1754.0734908136483
"30 WEST 63RD   STREET, 22CD",2010-11-11,3005111,2013-03-13,4500000,1494889,853,1752.5076201641266
"16 DESBROSSES STREET, 5/6S",2009-10-20,2572499,2016-10-19,7050000,4477501,2556,1751.7609546165884
"21 EAST 66TH   STREET, 5W",2012-06-11,3650000,2015-06-30,5600000,1950000,1114,1750.4488330341112
"145 HUDSON STREET, 8A",2011-12-16,7229575,2016-09-08,10250000,3020425,1728,1747.9311342592594
"55 WEST 131ST STREET, F-3",2017-01-26,338558,2017-08-14,688000,349442,200,1747.21
"160 WOOSTER STREET, 2C",2013-09-23,2965000,2014-03-31,3295000,330000,189,1746.031746031746
"22 MERCER STREET, 3B",2008-01-17,1292741,2010-06-07,2812500,1519759,872,1742.842889908257
"15 CENTRAL PARK WEST, 6E",2007-11-12,5243987,2015-09-03,10200000,4956013,2852,1737.7324684431978
"170 EAST END AVENUE, PH1A",2009-07-01,11811700,2014-04-16,14850000,3038300,1750,1736.1714285714286
"15 CENTRAL PARK WEST, 3E",2007-11-02,4989425,2014-09-05,9325000,4335575,2499,1734.9239695878352
"100 WEST 93RD STREET, 26H",2007-12-20,471651,2008-07-31,860000,388349,224,1733.700892857143
"150 CHARLES STREET, 4CS",2015-08-25,8686635,2018-02-13,10250000,1563365,903,1731.3012181616832
"245 10TH   AVENUE, 11/6W",2012-04-26,2876556,2014-08-28,4350000,1473444,854,1725.344262295082
"81 SPRING STREET, 5",2006-01-18,7250000,2008-05-08,8700000,1450000,841,1724.1379310344828
"15 CHARLES STREET, 16B",2003-12-17,350000,2007-09-10,2695000,2345000,1363,1720.4695524578137
"7 BOND STREET, 6C",2009-07-16,3750000,2012-10-24,5800000,2050000,1196,1714.046822742475
"2148 BROADWAY, 11F",2011-10-03,4120000,2013-10-21,5400000,1280000,749,1708.9452603471295
"534 HUDSON STREET, 3D",2007-08-06,1995000,2008-06-12,2525000,530000,311,1704.1800643086817
"299 WEST 12TH   STREET, PHC",2008-06-16,5250000,2014-06-26,9000000,3750000,2201,1703.7710131758292
"415 GREENWICH STREET, 7F",2010-05-20,3450000,2014-10-23,6200000,2750000,1617,1700.6802721088436
"22 WEST 66TH   STREET, 10",2007-12-27,300000,2012-08-29,3200000,2900000,1707,1698.8869361452842
"505 GREENWICH STREET, 12E",2005-04-14,1624108,2005-08-25,1850000,225892,133,1698.436090225564
"80 RIVERSIDE BOULEVARD, 25D",2012-11-19,3057250,2014-11-06,4275000,1217750,717,1698.3960948396095
"135 EAST 54TH   STREET, 5D",2013-06-20,1500000,2014-09-05,2250000,750000,442,1696.8325791855204
"768 5 AVENUE, 1308",2007-08-15,2094191,2008-04-10,2499000,404809,239,1693.7615062761506
"200 11TH   AVENUE, 6N",2010-10-22,5498550,2015-01-22,8125000,2626450,1553,1691.2105602060528
"15 CENTRAL PARK WEST, 29D",2007-12-18,9907572,2015-05-26,14500000,4592428,2716,1690.8792341678939
"845 UNITED NATIONS PLAZA, 40E",2006-12-06,1700000,2007-11-07,2268000,568000,336,1690.4761904761904
"7 BOND STREET, PHA",2013-06-28,9200000,2018-01-10,12000000,2800000,1657,1689.8008449004224
"252 7 AVENUE, 15O",2003-11-09,1635000,2006-01-25,2999500,1364500,808,1688.7376237623762
"1992 BROADWAY, 21-B",2003-08-12,577736,2004-05-28,1067255,489519,290,1687.996551724138
"93 WORTH STREET, 502",2014-03-03,3258400,2015-07-15,4100000,841600,499,1686.573146292585
"101 WARREN STREET, 2820",2009-12-15,3400000,2014-06-06,6150000,2750000,1634,1682.9865361077111
"15 CENTRAL PARK WEST, 7H",2007-11-19,1832850,2010-01-20,3162500,1329650,793,1676.733921815889
"1992 BROADWAY, 23-B",2003-08-12,577736,2004-07-20,1151777,574041,343,1673.5889212827988
"845 UNITED NATIONS PLAZA, 86A",2008-01-03,9877025,2016-01-29,14800000,4922975,2948,1669.9372455902308
"1992 BROADWAY, 23-E",2003-08-12,388263,2004-07-22,964363,576100,345,1669.855072463768
"25 COLUMBUS CIRCLE, ST74B",2005-01-05,12231118,2010-08-16,15650000,3418882,2049,1668.5612493899464
"15 EAST 26TH STREET, 10F",2009-11-16,2698362,2013-08-29,5000000,2301638,1382,1665.4399421128799
"166 EAST 63RD   STREET, 11B",2011-08-24,470000,2017-04-18,3900000,3430000,2064,1661.8217054263566
"505 GREENWICH STREET, 10D",2005-03-03,2087412,2007-05-23,3435000,1347588,811,1661.6374845869298
"261 WEST 25TH   STREET, GRDND",2016-04-21,2591446,2017-01-24,3050000,458554,278,1649.474820143885
"15 EAST 26TH   STREET, 15AB",2010-04-12,10284325,2018-04-30,15120000,4835675,2940,1644.7874149659865
"1992 BROADWAY, 22-E",2003-08-12,388263,2004-07-19,950677,562414,342,1644.485380116959
"1992 BROADWAY, 24-B",2003-08-12,577736,2004-08-06,1168968,591232,360,1642.3111111111111
"160 WEST 66TH STREET, 46E",2013-04-23,2950000,2014-09-23,3800000,850000,518,1640.9266409266409
"17 ORCHARD STREET, 2-F",2013-02-12,456300,2013-08-01,735000,278700,170,1639.4117647058824
"1 CENTRAL PARK WEST, 27B",2003-03-12,2300000,2005-11-28,3925000,1625000,992,1638.1048387096773
"240 WEST END AVENUE, 13C/D",2011-04-14,1300000,2012-09-14,2150000,850000,519,1637.7649325626205
"15 CHARLES STREET, 5F",2005-12-22,700000,2006-06-08,975000,275000,168,1636.904761904762
"250 WEST STREET, 10E",2013-04-22,2779822,2015-05-08,4000000,1220178,746,1635.6273458445041
"505 GREENWICH STREET, 3G",2008-03-12,985000,2013-01-28,3900000,2915000,1783,1634.8850252383622
"250 WEST STREET, 9E",2013-04-03,2754366,2014-11-03,3700000,945634,579,1633.2193436960276
"40 MERCER STREET, 40",2007-06-04,7076837,2014-06-11,11250000,4173163,2564,1627.598673946958
"15 CENTRAL PARK WEST, 10C",2008-03-26,11536772,2014-11-07,15463500,3926728,2417,1624.6288787753413
"144 WEST 27TH   STREET, 7R",2012-11-15,1650000,2015-05-14,3125000,1475000,910,1620.8791208791208
"15 CENTRAL PARK WEST, 33A",2008-06-16,10997100,2015-11-09,15375000,4377900,2702,1620.2442635085122
"77 READE STREET, 2A",2012-06-04,3716613,2015-03-30,5379000,1662387,1029,1615.536443148688
"530 EAST 76TH   STREET, 28AHK",2010-08-19,3249500,2013-12-10,5200000,1950500,1209,1613.3167907361455
"15 RENWICK STREET, 402",2016-02-24,2090467,2017-05-09,2800000,709533,440,1612.575
"188 EAST 64TH STREET, 2701",2006-11-30,860000,2009-06-12,2350000,1490000,925,1610.8108108108108
"144 WEST 18TH STREET, 200E",2003-11-07,1934675,2005-06-20,2885000,950325,591,1607.9949238578681
"421 HUDSON STREET, 506",2014-04-03,1810000,2017-03-02,3520000,1710000,1064,1607.142857142857
"111 MERCER STREET, 3",2013-10-21,4327562,2015-05-20,5250000,922438,576,1601.454861111111
"2 RIVER TERRACE, 14J",2012-12-05,4000000,2016-09-09,6200000,2200000,1374,1601.1644832605532
"279 CENTRAL PARK WEST, 11B",2007-03-29,4750000,2011-08-08,7300000,2550000,1593,1600.75329566855
"677 WASHINGTON STREET, 2ET",2011-08-01,2200000,2013-12-23,3600000,1400000,875,1600.0
"120 RIVERSIDE BOULEVARD, 403",2012-12-26,585000,2013-11-13,1100000,515000,322,1599.3788819875776
"515 PARK AVENUE, 29",2005-07-28,10875000,2011-10-12,14500000,3625000,2267,1599.0295544772828
"66 ST NICHOLAS AVENUE, 7F",2013-12-12,390000,2014-04-07,575000,185000,116,1594.8275862068965
"900 PARK AVENUE, 3E",2003-08-06,1050000,2004-08-10,1640000,590000,370,1594.5945945945946
"610 PARK AVENUE, 6E",2005-06-24,3500000,2006-09-07,4200000,700000,440,1590.909090909091
"2109 BROADWAY, 16-16",2008-12-12,7200000,2015-06-30,11000000,3800000,2391,1589.293182768716
"400 EAST 51 STREET, 21A",2003-05-16,3374481,2006-12-15,5450000,2075519,1309,1585.576012223071
"845 UNITED NATIONS PLAZA, 77B",2008-08-05,6200000,2013-06-06,9000000,2800000,1766,1585.5039637599093
"56 LEONARD STREET, 20BE",2016-05-11,3884990,2017-11-08,4750000,865010,546,1584.2673992673992
"30 EAST 85TH STREET, 10E",2014-07-22,5075000,2016-08-02,6250000,1175000,742,1583.55795148248
"250 WEST STREET, 5E",2013-03-28,3008928,2014-12-17,4000000,991072,629,1575.631160572337
"77 HORATIO STREET, GA",2012-07-03,2086256,2013-02-19,2450000,363744,231,1574.6493506493507
"422 EAST 72ND   STREET, 26B",2007-04-12,760000,2010-02-17,2400000,1640000,1042,1573.8963531669865
"101 WARREN STREET, 2010",2009-10-02,3410842,2014-09-10,6250000,2839158,1804,1573.8126385809312
"2211 BROADWAY, 3L",2014-01-17,5600375,2015-08-12,6500000,899625,572,1572.770979020979
"350 WEST 42 STREET, 24E",2006-07-25,602804,2006-11-02,760000,157196,100,1571.96
"141 EAST 88TH   STREET, 10C",2014-07-17,9039037,2015-07-09,9600000,560963,357,1571.3249299719887
"125 CENTRAL PARK NORTH, 2A",2006-08-29,936790,2007-02-12,1199000,262210,167,1570.1197604790418
"1280 5 AVENUE, 5B",2012-09-05,1600000,2013-06-07,2031408,431408,275,1568.7563636363636
"5 FRANKLIN PLACE, 14B",2016-03-07,1173533,2016-11-02,1550000,376467,240,1568.6125
"1992 BROADWAY, 23-F",2003-08-12,466533,2004-07-22,1007069,540536,345,1566.7710144927537
"200 CHAMBERS STREET, 5C",2007-03-19,1741207,2007-11-19,2125000,383793,245,1566.5020408163266
"1641 THIRD AVENUE, 22F",2005-02-07,765000,2005-08-24,1075000,310000,198,1565.6565656565656
"175 EAST 2ND STREET, 2B",2005-10-25,515000,2006-02-17,695000,180000,115,1565.2173913043478
"15 CENTRAL PARK WEST, 7G",2007-10-30,3309312,2011-10-21,5575000,2265688,1452,1560.3911845730026
"123 WASHINGTON STREET, 36A",2013-09-19,1380672,2014-02-26,1630000,249328,160,1558.3
"157 WEST 74 STREET, 1R",2003-04-30,1624109,2004-09-09,2400000,775891,498,1558.0140562248996
"220, 20D",2003-03-21,666954,2003-08-05,880000,213046,137,1555.0802919708028
"145 EAST 76TH STREET, 2B",2009-08-07,2600000,2014-10-20,5550000,2950000,1900,1552.6315789473683
"505 GREENWICH STREET, 2D",2005-01-25,1680112,2008-01-08,3350000,1669888,1078,1549.061224489796
"1992 BROADWAY, 22-F",2003-08-12,466533,2004-07-19,995221,528688,342,1545.8713450292398
"85 LEONARD STREET, 4",2009-12-08,1289783,2013-04-01,3160000,1870217,1210,1545.6338842975206
"305 EAST 108 STREET, 2G",2006-07-05,575000,2006-12-14,825000,250000,162,1543.20987654321
"60 RIVERSIDE BOULEVARD, 3403",2012-03-26,3937163,2014-10-30,5400000,1462837,948,1543.0770042194092
"240 EAST 41 STREET, 2G",2005-11-21,165000,2006-11-03,700000,535000,347,1541.78674351585
"230 WEST 56 STREET, 66C",2003-06-05,1344090,2007-01-30,3400000,2055910,1335,1540.0074906367042
"120 RIVERSIDE BOULEVARD, 4D",2005-12-20,933531,2006-05-26,1175000,241469,157,1538.0191082802548
"160 CENTRAL PARK SOUTH, 3101",2012-12-27,1943700,2015-01-09,3086000,1142300,743,1537.4158815612382
"534 HUDSON STREET, 5B",2009-07-09,2225000,2014-01-15,4762000,2537000,1651,1536.6444579043005
"333 EAST 34 STREET, 6E",2004-01-27,370110,2004-08-04,661862,291752,190,1535.536842105263
"250 EAST 53RD STREET, 707",2008-05-16,2009858,2008-11-21,2300000,290142,189,1535.142857142857
"56 LEONARD STREET, 41BE",2016-09-15,4238965,2017-08-14,4750000,511035,333,1534.6396396396397
"100 UNITED NATIONS PLAZA, 29C",2004-11-10,1000000,2005-06-07,1320000,320000,209,1531.1004784688996
"62 WEST 62 STREET, PHA",2004-04-14,4495000,2006-01-31,5500000,1005000,657,1529.6803652968038
"111 WEST 67TH   STREET, 21-B",2012-01-27,875000,2014-08-18,2300000,1425000,934,1525.695931477516
"11 VESTRY STREET, 2R",2008-04-24,100000,2013-06-20,2972500,2872500,1883,1525.4912373871482
"200 EAST 69TH STREET, 42A",2005-01-20,4220000,2006-10-03,5165000,945000,621,1521.7391304347825
"1992 BROADWAY, 20-M",2003-08-12,444022,2004-06-07,900439,456417,300,1521.39
"1992 BROADWAY, 21-M",2003-08-12,444022,2004-06-15,912286,468264,308,1520.3376623376623
"475 BROADWAY, 3E",2004-05-13,1578288,2006-05-22,2700000,1121712,739,1517.8782138024358
"200 EAST 58TH STREET, 8G",2004-10-27,340000,2005-02-16,510000,170000,112,1517.857142857143
"502 PARK AVENUE, 17E",2005-02-22,1069162,2005-10-31,1450000,380838,251,1517.2828685258964
"181 HUDSON STREET, 4B",2010-04-02,1350000,2017-04-17,5250000,3900000,2572,1516.329704510109
"1760 SECOND AVENUE, 24C",2004-08-26,1600000,2005-12-09,2312500,712500,470,1515.9574468085107
"15 BROAD ST, 904",2007-05-29,763687,2007-10-22,985000,221313,146,1515.8424657534247
"260 PARK AVENUE SOUTH, 10D",2010-02-08,3275000,2012-12-14,4850000,1575000,1040,1514.423076923077
"305 EAST 51ST   STREET, RU7C",2015-07-29,2332167,2016-06-02,2800000,467833,309,1514.022653721683
"25 COLUMBUS CIRCLE, ST70B",2005-06-16,12129283,2009-10-01,14500000,2370717,1568,1511.936862244898
"130 FULTON STREET, 8B",2006-06-23,2214693,2007-03-05,2600000,385307,255,1511.007843137255
"505 GREENWICH STREET, 2G",2005-01-18,501930,2009-10-05,3100000,2598070,1721,1509.6281231841951
"260 WEST BROADWAY, 11A",2006-03-22,7350000,2013-10-02,11500000,4150000,2751,1508.5423482370047
"151 WEST 17 STREET, PHD",2003-10-30,2700000,2005-04-29,3525000,825000,547,1508.2266910420476
"123 WASHINGTON STREET, 41B",2013-09-19,2030400,2015-01-26,2775000,744600,494,1507.2874493927125
"32 WEST 18TH   STREET, 11A",2007-08-16,4073000,2008-07-31,4600000,527000,350,1505.7142857142858
"20 WEST 53RD   STREET, 23B",2014-09-29,2698362,2016-01-08,3400000,701638,466,1505.6609442060085
"23 WEST 116 STREET, 4B",2014-12-30,721685,2016-01-19,1300000,578315,385,1502.1168831168832
"80 COLUMBUS CIRCLE, NT64D",2004-07-08,4327562,2009-10-06,7200000,2872438,1916,1499.1847599164928
"253 WEST 73RD   STREET, 6B",2009-11-25,827500,2014-02-05,3125000,2297500,1533,1498.6953685583824
"63 DOWNING STREET, 9B",2011-09-15,3200000,2014-10-24,4900000,1700000,1135,1497.7973568281939
"255 HUDSON STREET, 7A",2006-09-29,1929583,2007-12-21,2600000,670417,448,1496.466517857143
"40 MERCER STREET, 32",2007-05-17,5931306,2013-10-25,9450000,3518694,2353,1495.4075648108796
"768 5 AVENUE, 607",2011-12-02,13050000,2015-06-30,15000000,1950000,1306,1493.1087289433385
"143 AVENUE B, 5A",2012-01-17,700000,2013-10-21,1660000,960000,643,1493.0015552099533
"80 COLUMBUS CIRCLE, NT67E",2004-03-18,2367431,2008-04-29,4600000,2232569,1503,1485.408516300732
"300 EAST 62ND   STREET, 31-PH",2014-04-11,1950000,2015-12-15,2860000,910000,613,1484.5024469820555
"25 NORTH MOORE STREET, 17APH",2005-08-17,8250000,2011-02-01,11210000,2960000,1994,1484.4533600802408
"1992 BROADWAY, 24-E",2003-08-12,388263,2004-09-13,978046,589783,398,1481.8668341708542
"641 FIFTH AVENUE, 32H",2006-12-22,3050000,2007-04-12,3214362,164362,111,1480.7387387387387
"325 FIFTH AVENUE, 30B",2007-01-03,1547740,2007-08-29,1900000,352260,238,1480.0840336134454
"52 PARK AVENUE, 17",2013-04-04,1842500,2015-11-12,3250000,1407500,952,1478.4663865546217
"333 RECTOR PLACE, 205",2012-04-26,1895000,2014-07-21,3100000,1205000,816,1476.7156862745098
"150 EAST 86TH   STREET, 8C",2011-03-21,3767525,2015-03-06,5900000,2132475,1446,1474.740663900415
"1 CENTRAL PARK WEST, 30A",2004-05-27,6400000,2012-03-14,10600000,4200000,2848,1474.7191011235955
"225 5 AVENUE, 6T",2007-04-05,799326,2007-07-23,960000,160674,109,1474.073394495413
"345 GRAND STREET, 5",2005-05-25,1374637,2006-04-13,1850000,475363,323,1471.7120743034056
"1 CENTRAL PARK WEST, 31E",2005-11-01,2500000,2006-06-27,2850000,350000,238,1470.5882352941176
"10 WEST STREET, 19E",2003-10-01,787500,2005-10-27,1900000,1112500,757,1469.6169088507265
"80 CHAMBERS STREET, 10A",2014-06-06,2900005,2015-11-12,3670000,769995,524,1469.456106870229
"25 CENTRAL PARK WEST, 3B",2013-07-29,2150000,2014-09-11,2750000,600000,409,1466.992665036675
"151 WEST 17 STREET, 2A",2003-10-30,1578288,2005-02-11,2267500,689212,470,1466.408510638298
"60 RIVERSIDE BOULEVARD, 3702",2012-03-20,6443431,2016-10-11,8885000,2441569,1666,1465.5276110444177
"230 WEST 56 STREET, 51F",2003-04-02,1237174,2003-11-12,1565000,327826,224,1463.5089285714287
"123 WASHINGTON STREET, 44B",2013-09-19,2030400,2015-02-10,2775000,744600,509,1462.86836935167
"2148 BROADWAY, 7F",2011-09-01,4093365,2014-09-30,5739000,1645635,1125,1462.7866666666666
"481 WASHINGTON STREET, 4S",2013-01-03,4280596,2016-03-14,5985000,1704404,1166,1461.7530017152658
"195 HUDSON STREET, 3B",2013-02-01,2725000,2016-09-08,4643225,1918225,1315,1458.726235741445
"500 PARK AVENUE, 30B",2003-11-14,2000000,2009-12-22,5250000,3250000,2230,1457.3991031390135
"1992 BROADWAY, 21-H",2003-08-12,403077,2004-05-24,819691,416614,286,1456.6923076923076
"171 WEST 57TH STREET, 8B",2005-01-10,2995000,2007-05-22,4250000,1255000,862,1455.9164733178654
"15 UNION SQUARE WEST, 32",2011-05-20,8750000,2014-09-03,10500000,1750000,1202,1455.9068219633943
"2770 BROADWAY, 9C",2004-12-16,1985587,2005-07-20,2300000,314413,216,1455.6157407407406
"456 WEST 19TH   STREET, 2/3F",2010-09-20,2749275,2013-01-11,3975000,1225725,844,1452.2808056872038
"147 WAVERLY PLACE, 8",2008-03-24,5753112,2015-07-30,9650000,3896888,2684,1451.8956780923993
"25 COLUMBUS CIRCLE, ST52B",2004-02-13,3468376,2006-04-03,4600000,1131624,780,1450.8
"1992 BROADWAY, 20-H",2003-08-12,403077,2004-05-24,817503,414426,286,1449.041958041958
"220, 3V",2003-02-14,394953,2003-06-30,592000,197047,136,1448.875
"30 WEST 86 STREET, 4A",2003-08-18,1560000,2005-12-21,2800000,1240000,856,1448.5981308411215
"304 SPRING STREET, 6",2007-11-13,2200000,2010-12-27,3850000,1650000,1140,1447.3684210526317
"425 WEST 53RD   STREET, 409",2013-02-08,2700000,2015-07-27,4000000,1300000,899,1446.0511679644048
"99 JOHN STREET, PH04",2011-02-18,689000,2018-05-08,4500000,3811000,2636,1445.751138088012
"15 WEST 53RD   STREET, 32D",2013-05-03,2995000,2015-10-16,4290000,1295000,896,1445.3125
"207 EAST 57TH   STREET, 36PH",2007-03-05,5065793,2012-04-05,7750000,2684207,1858,1444.6754574811625
"505 GREENWICH STREET, 9C",2005-02-02,1120075,2014-01-21,5850000,4729925,3275,1444.2519083969466
"205 WEST 76TH   STREET, PH2D",2009-11-24,2048779,2010-05-17,2300000,251221,174,1443.7988505747126
"150 WEST 56TH   STREET, 6206",2012-05-17,1530000,2014-10-14,2800000,1270000,880,1443.1818181818182
"255 EAST 74TH   STREET, 24B",2015-02-18,3763573,2017-12-15,5250000,1486427,1031,1441.733268671193
"210 LAFAYETTE STREET, PH",2012-03-16,3050000,2013-04-12,3615000,565000,392,1441.3265306122448
"715 PARK AVENUE, 8A",2005-09-15,800000,2006-11-06,1400000,600000,417,1438.8489208633093
"80 COLUMBUS CIRCLE, NT66E",2004-01-27,2749275,2011-03-18,6500000,3750725,2607,1438.7130801687763
"40 MERCER STREET, 39",2007-07-12,5371268,2010-11-30,7150000,1778732,1237,1437.9401778496363
"27 WEST 72ND   STREET, 212",2007-09-19,1451006,2008-05-19,1800000,348994,243,1436.1893004115227
"66 LEONARD STREET, 2A-3A",2013-10-04,4300000,2016-02-22,5550000,1250000,871,1435.1320321469575
"1992 BROADWAY, 24-H",2003-08-12,403076,2004-07-29,907167,504091,352,1432.0767045454545
"1 CENTRAL PARK WEST, 37C",2004-02-12,2867500,2008-05-20,5100000,2232500,1559,1432.0076972418217
"1992 BROADWAY, 22-H",2003-08-12,403076,2004-07-19,892711,489635,342,1431.6812865497077
"120 GREENWICH STREET, 11A",2016-08-31,660000,2016-11-30,790000,130000,91,1428.5714285714287
"120 EAST 87 STREET, R10-F",2003-11-20,740000,2004-10-07,1200000,460000,322,1428.5714285714287
"160 CENTRAL PARK SOUTH, 3007",2005-02-25,1050000,2008-06-23,2781675,1731675,1214,1426.4209225700165
"1992 BROADWAY, 23-G",2003-08-12,438506,2004-07-22,930059,491553,345,1424.791304347826
"212 WARREN STREET, 14G",2016-03-14,2438708,2017-11-09,3300000,861292,605,1423.6231404958678
"1 MORTON SQUARE, 2F W",2004-10-29,2367431,2007-06-28,3750000,1382569,972,1422.3960905349795
"30 WEST 90 STREET, 4B",2004-03-16,623169,2004-07-15,795000,171831,121,1420.090909090909
"5 WEEHAWKEN STREET, 5A",2006-05-30,318903,2006-11-09,550000,231097,163,1417.7730061349694
"310 EAST HOUSTON STREET, PHI",2008-12-29,3000000,2015-06-30,6365000,3365000,2374,1417.4389216512216
"1992 BROADWAY, 25-B",2003-08-12,577736,2005-03-04,1384820,807084,570,1415.9368421052632
"240 RIVERSIDE BOULEVARD, 25 A",2006-06-02,3857538,2009-03-20,5300000,1442462,1022,1411.4109589041095
"1 CENTRAL PARK SOUTH, 503",2012-12-18,7995000,2017-02-24,10150000,2155000,1529,1409.417920209287
"157 WEST 74 STREET, 4",2003-04-30,1084436,2004-07-29,1725000,640564,456,1404.7456140350878
"1992 BROADWAY, 22-G",2003-08-12,438506,2004-07-19,918211,479705,342,1402.6461988304093
"15 CENTRAL PARK WEST, 8L",2007-11-26,2596537,2015-09-25,6600000,4003463,2860,1399.8122377622378
"459 WEST 18TH   STREET, 5",2010-11-12,2250000,2013-05-30,3550000,1300000,930,1397.8494623655913
"345 WEST 13TH STREET, 5D",2004-12-16,3805000,2006-02-15,4400000,595000,426,1396.7136150234742
"177 EAST 77 STREET, 8A",2005-01-25,902678,2006-10-31,1800000,897322,644,1393.357142857143
"56 LEONARD STREET, 27BW",2016-07-07,5977718,2017-11-16,6670000,692282,497,1392.9215291750504
"99 JANE STREET, 10B",2004-11-17,2950000,2014-08-12,7900000,4950000,3555,1392.4050632911392
"704 BROADWAY, 2FL",2004-09-13,3375000,2008-02-04,5100000,1725000,1239,1392.2518159806295
"15 CENTRAL PARK WEST, 14H",2008-04-14,2688180,2010-05-17,3750000,1061820,763,1391.6382699868939
"353 WEST 56 STREET, 7H",2003-04-11,137500,2003-08-06,300000,162500,117,1388.888888888889
"1992 BROADWAY, 20-E",2003-08-12,388263,2004-05-24,784562,396299,286,1385.6608391608393
"27 NORTH MOORE STREET, 9D",2004-12-13,3375000,2007-04-11,4550000,1175000,849,1383.9811542991756
"52 EAST END AVENUE, 10B",2005-03-23,660000,2011-02-28,3660000,3000000,2168,1383.7638376383763
"520 EAST 81 STREET, 12A",2003-05-13,191000,2005-11-08,1450000,1259000,910,1383.5164835164835
"101 WEST 87TH   STREET, 305",2013-10-18,2632176,2015-04-08,3375000,742824,537,1383.2849162011173
"29 WEST 85TH STREET, 5",2010-09-17,4367000,2014-07-18,6300000,1933000,1400,1380.7142857142858
"322 WEST 57TH   STREET, 35S1",2011-02-25,2030000,2014-05-14,3650000,1620000,1174,1379.8977853492333
"1992 BROADWAY, 20-F",2003-08-12,466533,2004-08-12,971525,504992,366,1379.75956284153
"80 RIVERSIDE BOULEVARD, 32C/D",2010-10-13,5273466,2016-12-29,8400000,3126534,2269,1377.9347730277655
"151 WOOSTER STREET, 5B",2011-03-16,3900000,2015-07-30,6100000,2200000,1597,1377.582968065122
"144 WEST 18 STREET, 300E",2003-09-22,1552831,2006-06-29,2937500,1384669,1011,1369.603363006924
"400 WEST 12TH   STREET, 5B",2009-12-17,8782406,2012-04-19,9950000,1167594,854,1367.2060889929742
"102 WOOSTER STREET, 4S",2010-04-29,4300000,2012-06-06,5350000,1050000,769,1365.4096228868661
"400 EAST 54 STREET, 16F",2004-04-06,29438,2006-05-31,1100000,1070562,785,1363.7732484076432
"120 RIVERSIDE BOULEVARD, 11T",2006-09-14,1028432,2007-12-14,1650000,621568,456,1363.0877192982457
"400 5 AVENUE, 46A",2011-12-22,2983472,2014-10-02,4365000,1381528,1015,1361.1113300492611
"200 EAST 32ND   STREET, 29D",2008-02-19,500000,2009-08-12,1235000,735000,540,1361.111111111111
"300 EAST 77TH   STREET, 21B",2013-06-05,2499000,2015-06-11,3500000,1001000,736,1360.054347826087
"93 WORTH STREET, 703",2014-02-21,937503,2015-05-29,1565000,627497,462,1358.2186147186146
"502 PARK AVENUE, 8G",2004-09-01,1600000,2008-02-15,3312500,1712500,1262,1356.973058637084
"470 BROOME STREET, 4S",2009-11-17,2900000,2015-08-18,5749272,2849272,2100,1356.7961904761905
"25 CENTRAL PARK WEST, 19M",2008-07-17,3410076,2012-05-10,5300000,1889924,1393,1356.7293610911702
"322 WEST 57TH   STREET, 20A",2012-03-20,450000,2012-09-13,690000,240000,177,1355.9322033898304
"10 UNION SQUARE EAST, U21I",2003-12-17,99500,2004-08-02,410000,310500,229,1355.8951965065503
"240 WEST 98TH   STREET, 3B",2010-04-02,2228225,2013-04-10,3725000,1496775,1104,1355.7744565217392
"250 WEST STREET, 6D",2013-03-26,4327562,2017-08-17,6500000,2172438,1605,1353.5439252336448
"350 WEST 42ND   STREET, 57G",2014-07-25,2700000,2016-05-05,3579000,879000,650,1352.3076923076924
"635 WEST 42ND STREET, 27E",2013-11-19,1350000,2014-06-03,1615000,265000,196,1352.0408163265306
"151 WEST 21ST STREET, 9D",2014-11-17,1053888,2015-11-19,1550000,496112,367,1351.8038147138964
"46 LISPENARD STREET, 2A",2013-06-07,2698362,2016-01-08,3975000,1276638,945,1350.9396825396825
"415 GREENWICH STREET, 5A",2011-05-06,3025000,2016-02-10,5375000,2350000,1741,1349.7989661114302
"79 LAIGHT STREET, 1A",2013-05-15,1800000,2018-02-01,4125000,2325000,1723,1349.3905977945444
"80 PARK AVENUE, 11N",2015-02-25,865000,2015-09-25,1150000,285000,212,1344.3396226415093
"327 CENTRAL PARK WEST, 11A",2005-05-26,29076,2011-01-11,2790005,2760929,2056,1342.864299610895
"327 CENTRAL PARK WEST, 10A",2005-05-26,28614,2011-01-20,2800187,2771573,2065,1342.1661016949151
"15 CENTRAL PARK WEST, 7K",2007-11-06,2484530,2013-05-30,5205000,2720470,2032,1338.8139763779527
"50 BOND STREET, R5",2004-02-10,2000862,2012-06-29,6100000,4099138,3062,1338.712606139778
"25 CENTRAL PARK WEST, 4G",2012-08-09,750000,2013-07-30,1225000,475000,355,1338.0281690140846
"129 LAFAYETTE STREET, 6A",2004-12-22,1929583,2008-02-05,3454000,1524417,1140,1337.207894736842
"25 COLUMBUS CIRCLE, ST60E",2004-01-28,2143285,2005-11-18,3025000,881715,660,1335.9318181818182
"545 WEST 110TH STREET, 7A",2007-07-12,2840917,2008-10-10,3450000,609083,456,1335.7083333333333
"1992 BROADWAY, 23-M",2003-08-12,444022,2004-08-30,956020,511998,384,1333.328125
"101 WEST 24TH   STREET, PH3C",2008-10-24,4590271,2011-08-29,5975000,1384729,1039,1332.7516843118383
"40 EAST 20TH   STREET, 4",2015-07-23,2500000,2016-04-11,2850000,350000,263,1330.7984790874525
"10 WEST STREET, 37E",2004-01-14,2698363,2006-06-28,3890000,1191637,896,1329.9520089285713
"1 CENTRAL PARK WEST, 25F",2006-02-15,2000000,2007-06-19,2650000,650000,489,1329.243353783231
"151 WOOSTER STREET, 7A",2009-10-29,4734862,2016-12-20,8200000,3465138,2609,1328.1479494059026
"1031 6 AVENUE, 41J",2006-09-13,621132,2007-04-11,900000,278868,210,1327.942857142857
"43 WEST 64TH   STREET, 7C",2008-03-28,4268000,2013-11-18,7000000,2732000,2061,1325.5701115963125
"40 MERCER STREET, 25",2007-06-12,3411137,2009-03-06,4250000,838863,633,1325.218009478673
"151 WEST 17 STREET, PHE",2003-10-30,2200000,2005-01-25,2800000,600000,453,1324.5033112582782
"400 EAST 90TH   STREET, 5D",2007-06-27,359970,2007-10-10,499000,139030,105,1324.095238095238
"15 BROAD STREET, 1520",2006-05-16,1461188,2008-06-02,2450000,988812,748,1321.9411764705883
"540 WEST 28TH   STREET, 8D",2012-08-10,963630,2014-04-09,1765000,801370,607,1320.2141680395387
"25 COLUMBUS CIRCLE, ST68C",2004-04-02,5608752,2006-02-07,6500000,891248,676,1318.414201183432
"768 FIFTH AVENUE, 1101",2007-09-12,10251342,2016-07-13,14500000,4248658,3227,1316.5968391695073
"57 WEST 58TH STREET, 6H",2012-07-19,725000,2012-12-18,925000,200000,152,1315.7894736842106
"414 WEST 54TH   STREET, 1A",2015-06-23,273194,2018-04-17,1625000,1351806,1029,1313.7084548104956
"100 RIVERSIDE BOULEVARD, 26ABC",2008-08-26,4780989,2012-03-27,6500000,1719011,1309,1313.2245989304813
"1992 BROADWAY, 22-M",2003-08-12,444022,2004-08-12,924134,480112,366,1311.7814207650274
"40 BOND STREET, 10A",2007-09-05,10437062,2016-02-29,14500000,4062938,3099,1311.0480800258147
"425 FIFTH AVENUE, 34B/C",2004-10-01,695418,2006-10-03,1655000,959582,732,1310.9043715846994
"200 EAST 66TH   STREET, D0406",2008-10-24,1323725,2015-03-25,4395000,3071275,2343,1310.8301323090056
"27 NORTH MOORE STREET, TOW-A",2003-03-04,3000000,2006-04-06,4478000,1478000,1129,1309.1231178033659
"219 WEST 81ST   STREET, 8B",2011-01-01,134640,2016-07-22,2788000,2653360,2029,1307.7180877279447
"140 EAST 63RD   STREET, 18PH2",2013-03-15,10182500,2018-01-24,12500000,2317500,1776,1304.8986486486488
"15 CHARLES STREET, 8D",2012-10-09,972428,2013-10-10,1450000,477572,366,1304.8415300546449
"706 RIVERSIDE DRIVE, 10E",2012-04-17,255000,2013-04-18,732500,477500,366,1304.6448087431695
"25 COLUMBUS CIRCLE, ST54C",2004-02-09,4130979,2012-02-16,7950000,3819021,2929,1303.8651416865825
"225 FIFTH AVENUE, 3M",2010-09-30,2475000,2014-06-24,4250000,1775000,1363,1302.274394717535
"80 COLUMBUS CIRCLE, NT69F",2004-02-25,1909219,2006-06-12,3000000,1090781,838,1301.647971360382
"260 PARK AVENUE SOUTH, 2C",2006-03-20,1680112,2006-07-21,1840000,159888,123,1299.9024390243903
"60 RIVERSIDE BOULEVARD, 1111",2011-12-01,4035270,2014-08-01,5300000,1264730,974,1298.4907597535935
"279 CENTRAL PARK WEST, PH1B",2010-01-20,4200000,2010-08-20,4475000,275000,212,1297.1698113207547
"422 EAST 72ND STREET, 5B",2006-11-09,423000,2007-05-03,650000,227000,175,1297.142857142857
"48 BEACH STREET, 1D",2009-07-22,4600000,2011-05-09,5450000,850000,656,1295.7317073170732
"243 WEST 134 STREET, 243B",2013-12-03,600000,2014-08-13,927500,327500,253,1294.4664031620553
"250 WEST STREET, 7H",2013-03-14,2469256,2017-04-20,4407500,1938244,1498,1293.8878504672898
"15 CENTRAL PARK WEST, 7J",2007-11-01,2545625,2016-09-27,6750000,4204375,3253,1292.4608054103903
"101 WARREN STREET, 5B",2008-04-18,4454843,2014-02-13,7200000,2745157,2127,1290.6238834038552
"1 CENTRAL PARK WEST, 33E",2003-12-17,1562500,2008-06-26,3695000,2132500,1653,1290.0786448880822
"230 WEST 56 STREET, 50F",2003-03-17,1369546,2005-08-10,2500000,1130454,877,1289.001140250855
"540 WEST 28TH   STREET, 6B",2012-08-10,979049,2014-05-09,1800000,820951,637,1288.7770800627943
"80 COLUMBUS CIRCLE, NT68C",2004-03-25,3512963,2012-10-22,7550000,4037037,3133,1288.5531439514841
"55 WHITE STREET, 5B",2004-06-29,2030000,2007-11-02,3600000,1570000,1221,1285.8312858312859
"5 EAST 22ND   STREET, 8-J",2011-04-07,2600000,2014-06-26,4110000,1510000,1176,1284.0136054421769
"56 LEONARD STREET, 22BE",2016-05-26,3834081,2017-10-27,4500000,665919,519,1283.0809248554913
"2081 BROADWAY, 6D",2004-10-25,980000,2005-06-20,1285000,305000,238,1281.5126050420167
"525 WEST 22ND   STREET, 4B",2013-11-15,1830000,2014-12-11,2330000,500000,391,1278.772378516624
"25 COLUMBUS CIRCLE, ST56E",2004-02-05,2092369,2008-01-30,3950000,1857631,1455,1276.7223367697595
"25 COLUMBUS CIRCLE, ST62B",2005-05-02,4384812,2012-03-27,7600000,3215188,2521,1275.3621578738596
"220, 23D",2003-03-18,1527375,2004-01-05,1900000,372625,293,1271.7576791808874
"43 WEST 64 STREET, 3C",2003-10-10,1690295,2005-10-14,2625000,934705,735,1271.7074829931973
"360 EAST 88 STREET, 20D",2003-10-10,925000,2004-03-31,1145000,220000,173,1271.6763005780347
"27 WEST 72ND STREET, 1010",2011-12-09,6500000,2015-06-12,8125000,1625000,1281,1268.5402029664324
"80 COLUMBUS CIRCLE, NT64F",2004-07-06,1400000,2006-10-12,2450000,1050000,828,1268.1159420289855
"28 EAST 10TH   STREET, 7A",2010-08-04,3850000,2012-02-07,4550000,700000,552,1268.1159420289855
"147 WAVERLY PLACE, 7",2008-03-26,5753112,2018-07-02,10500000,4746888,3750,1265.8368
"2628 BROADWAY, PH",2008-05-22,6109500,2013-07-24,8500000,2390500,1889,1265.4843832715724
"1992 BROADWAY, 24-G",2003-08-12,438506,2004-09-13,941907,503401,398,1264.8266331658292
"1965 BROADWAY, 27A",2004-02-26,1770000,2006-06-29,2850000,1080000,854,1264.6370023419204
"79 WORTH STREET, 5C",2010-02-25,1415367,2012-08-31,2575000,1159633,918,1263.2167755991286
"123 SULLIVAN STREET, 1",2003-09-22,1500000,2008-09-16,3800000,2300000,1821,1263.0422844590885
"101 WARREN STREET, 1620",2008-10-23,3064932,2012-08-09,4815000,1750068,1386,1262.6753246753246
"250 WEST STREET, 3L",2013-04-04,1522283,2015-09-08,2640000,1117717,887,1260.1093573844419
"40 DELANCEY STREET, 6C",2012-07-19,338272,2013-10-08,900000,561728,446,1259.4798206278026
"400 CENTRAL PARK WEST, 6X",2004-08-20,405600,2005-04-11,700000,294400,234,1258.1196581196582
"144 WEST 27TH   STREET, 5R",2009-10-07,1650000,2013-06-20,3350000,1700000,1352,1257.396449704142
"27 WEST 72ND   STREET, PHB",2009-09-15,5526877,2012-08-07,6855000,1328123,1057,1256.5023651844845
"1 MORTON SQUARE, 8C W",2004-11-22,2392887,2008-08-13,4100000,1707113,1360,1255.2301470588236
"1992 BROADWAY, 24-M",2003-08-12,444022,2004-10-12,979530,535508,427,1254.1170960187353
"641 5 AVENUE, 645",2010-09-01,11500000,2018-08-22,15150000,3650000,2912,1253.434065934066
"150 EAST 85 STREET, 10D",2003-10-07,717103,2004-05-19,999000,281897,225,1252.8755555555556
"350 WEST 42ND STREET, 49H",2006-10-19,832419,2007-03-01,999000,166581,133,1252.4887218045112
"1 MORTON SQUARE, 3C E",2004-10-05,1374712,2013-09-12,5460000,4085288,3264,1251.6200980392157
"350 EAST 62 STREET, 4L",2003-10-03,417500,2004-02-02,570000,152500,122,1250.0
"25 NORTH MOORE STREET, 7A",2003-08-28,1860000,2012-12-18,6100000,4240000,3400,1247.0588235294117
"1992 BROADWAY, 20-G",2003-08-12,438506,2004-08-12,894515,456009,366,1245.9262295081967
"36 EAST 22ND STREET, 3A",2012-04-09,2932560,2013-09-27,3600000,667440,536,1245.2238805970148
"845 UNITED NATIONS PLAZA, 81A",2005-05-24,3869350,2009-04-23,5650000,1780650,1430,1245.2097902097903
"607 HUDSON STREET, 4",2013-05-03,9164250,2018-01-04,11288400,2124150,1707,1244.3760984182777
"101 WARREN STREET, 1220",2008-08-28,3182031,2015-01-29,6100000,2917969,2345,1244.3364605543711
"540 WEST 28TH   STREET, 7D",2012-08-10,963630,2014-05-09,1755000,791370,637,1242.3390894819465
"825 7 AVENUE, 11A",2004-04-27,446253,2005-02-18,815000,368747,297,1241.5723905723905
"721 5 AVENUE, 41A",2005-08-31,2075000,2008-09-12,3450000,1375000,1108,1240.9747292418772
"220, 11R",2003-01-16,541073,2003-04-30,670000,128927,104,1239.6826923076924
"57 WEST 58TH   STREET, 6G",2013-04-18,675000,2014-05-07,1151000,476000,384,1239.5833333333333
"215 WEST 95TH   STREET, 11C",2014-10-24,600000,2015-05-14,850000,250000,202,1237.6237623762377
"8 UNION SQUARE SOUTH, 1112A",2014-01-02,7753973,2017-03-16,9200000,1446027,1169,1236.9777587681779
"65 WEST 13 STREET, 10F",2003-06-24,2596538,2005-12-20,3720000,1123462,910,1234.5736263736264
"71 PARK AVENUE, 12C",2006-09-12,901152,2007-09-27,1370000,468848,380,1233.8105263157895
"220, 10K",2003-03-24,686810,2003-09-29,920000,233190,189,1233.8095238095239
"170 EAST 87 STREET, E4A",2003-07-24,1500000,2006-08-28,2895000,1395000,1131,1233.42175066313
"481 WASHINGTON STREET, 3S",2013-01-10,4238325,2015-10-30,5500000,1261675,1023,1233.3088954056695
"425 FIFTH AVENUE, 32B",2004-10-04,666953,2005-04-07,895000,228047,185,1232.6864864864865
"350 WEST 42ND   STREET, 45F",2006-12-08,722957,2007-07-20,999000,276043,224,1232.3348214285713
"21 ASTOR PLACE, 8H",2004-02-20,1094619,2005-05-06,1638000,543381,441,1232.156462585034
"1 CENTRAL PARK WEST, 46D",2011-09-16,6400000,2014-02-27,7500000,1100000,895,1229.0502793296089
"25 CENTRAL PARK WEST, 28O",2004-12-23,1423004,2008-08-13,3054750,1631746,1329,1227.7998495109105
"540 WEST 28TH   STREET, 5D",2012-08-10,963630,2014-03-21,1685000,721370,588,1226.8197278911564
"2101 BROADWAY, 16129",2003-09-23,430000,2005-10-19,1358450,928450,757,1226.4861294583884
"25 COLUMBUS CIRCLE, ST54G",2003-12-22,2500227,2004-07-13,2750000,249773,204,1224.3774509803923
"2211 BROADWAY, 4J",2010-11-04,3375900,2015-08-07,5500000,2124100,1737,1222.8554979850317
"28 LAIGHT STREET, PH-N",2004-05-24,5750000,2006-12-21,6900000,1150000,941,1222.104144527099
"28 LAIGHT STREET, 5E",2003-01-30,1850000,2006-11-01,3525000,1675000,1371,1221.7359591539023
"105 WOOSTER STREET, 6E",2004-09-09,2031408,2014-10-31,6550000,4518592,3704,1219.9222462203024
"21 ASTOR PLACE, 2E",2004-05-03,1756481,2006-11-27,2900000,1143519,938,1219.1034115138593
"1641 3 AVENUE, 10F",2003-02-20,367220,2004-11-03,1125000,757780,622,1218.2958199356913
"25 COLUMBUS CIRCLE, ST52A",2004-02-23,3883599,2010-08-06,6751000,2867401,2356,1217.0632427843802
"120 RIVERSIDE BOULEVARD, PH2M",2006-05-03,1598132,2006-10-16,1800000,201868,166,1216.0722891566265
"1600 BROADWAY, 12D",2006-07-13,773870,2006-11-21,933000,159130,131,1214.7328244274809
"56 PINE STREET, 7B",2005-06-30,400530,2005-11-29,585000,184470,152,1213.6184210526317
"50 ORCHARD STREET, 5-D",2012-03-16,170000,2015-11-20,1800000,1630000,1344,1212.797619047619
"147 WAVERLY PLACE, 9",2008-07-15,5956762,2017-03-21,9800000,3843238,3171,1211.9955849889625
"40 MERCER STREET, 37",2007-05-24,5432363,2015-06-15,9000000,3567637,2944,1211.8332201086957
"392 CENTRAL PARK WEST, 5M",2018-01-18,905000,2018-06-28,1100000,195000,161,1211.1801242236024
"250 WEST STREET, 7E",2013-05-23,2932560,2015-10-01,3975000,1042440,861,1210.7317073170732
"310 WEST 52ND   STREET, 12A",2007-03-05,773870,2007-08-14,970000,196130,162,1210.679012345679
"401 EAST 84TH   STREET, 25C",2008-10-03,1050000,2011-08-23,2325000,1275000,1054,1209.6774193548388
"333 RECTOR PLACE, 904",2013-08-23,2545625,2015-10-01,3475000,929375,769,1208.5500650195058
"350 WEST 42ND   STREET, 20L",2006-12-28,960000,2007-08-17,1240000,280000,232,1206.896551724138
"166 PERRY STREET, 2C",2010-05-21,2214693,2012-03-02,3000000,785307,651,1206.3087557603687
"246 WEST 17TH   STREET, 4B",2009-02-20,1680112,2013-04-08,3495000,1814888,1508,1203.5066312997346
"225 FIFTH AVENUE, 6R",2007-06-26,1043706,2008-01-25,1300000,256294,213,1203.2582159624412
"50 BAYARD STREET, 4S",2003-10-03,260000,2004-02-13,420000,160000,133,1203.0075187969924
"1992 BROADWAY, 25-M",2003-08-12,444022,2005-02-01,1092065,648043,539,1202.3061224489795
"7 HUBERT STREET, M5C",2004-12-09,2666796,2011-12-19,5750000,3083204,2566,1201.560405300078
"350 WEST 42ND   STREET, 4C",2006-12-27,579384,2007-04-19,715000,135616,113,1200.141592920354
"145 EAST 76TH STREET, 9B",2009-12-02,3300000,2016-05-12,6122500,2822500,2353,1199.5325116872077
"160 WOOSTER STREET, PH-A",2005-03-23,5345812,2015-01-28,9650000,4304188,3598,1196.272373540856
"845 UNITED NATIONS PLAZA, 32B",2005-07-06,791128,2013-04-25,4200000,3408872,2850,1196.0954385964912
"169 HUDSON STREET, 5S",2003-11-18,1527375,2014-11-17,6325000,4797625,4017,1194.330346029375
"129 DUANE STREET, 4-5D",2005-02-17,3050000,2007-09-28,4187500,1137500,953,1193.5991605456454
"170 5 AVENUE, 2",2013-07-10,3875000,2014-11-04,4450000,575000,482,1192.9460580912862
"80 COLUMBUS CIRCLE, NT70C",2004-10-15,8756950,2009-12-11,11000000,2243050,1883,1191.2108337758896
"25 COLUMBUS CIRCLE, ST53B",2003-12-08,3504014,2012-10-31,7375000,3870986,3250,1191.0726153846153
"100 UNITED NATIONS PLAZA, 45A",2004-11-16,2450000,2006-06-27,3150000,700000,588,1190.4761904761904
"170 EAST END AVENUE, 9A",2009-12-02,4276650,2012-02-28,5250000,973350,818,1189.9144254278729
"327 CENTRAL PARK WEST, 12A",2005-05-27,141771,2015-06-08,4500000,4358229,3664,1189.4729803493449
"30 LITTLE WEST STREET, PH3A",2013-09-18,2350000,2015-08-26,3190000,840000,707,1188.118811881188
"56-62 COOPER SQUARE, 8A-T",2003-04-28,2291063,2013-06-25,6700000,4408937,3711,1188.0724872002156
"111 WEST 67TH   STREET, 31-A",2007-04-25,5625000,2014-07-08,8750000,3125000,2631,1187.7613074876472
"325 5 AVENUE, 8B",2007-04-06,1920000,2009-04-16,2800000,880000,741,1187.5843454790822
"571 ACADEMY STREET, 4F",2013-11-19,235000,2014-04-07,400000,165000,139,1187.0503597122301
"450 WEST 17TH   STREET, 2009",2009-01-29,2698362,2013-05-08,4550000,1851638,1560,1186.947435897436
"1 CENTRAL PARK WEST, 40C",2004-06-16,3195000,2007-06-22,4500000,1305000,1101,1185.2861035422343
"540 WEST 28TH   STREET, 6D",2012-08-10,963630,2014-06-26,1775000,811370,685,1184.4817518248176
"7 HUBERT STREET, 10A",2004-08-17,3385681,2012-03-28,6675000,3289319,2780,1183.208273381295
"1 BOND STREET, 3A",2008-06-06,5030000,2013-06-14,7200000,2170000,1834,1183.206106870229
"279 CENTRAL PARK WEST, PH5A",2004-01-20,4250000,2013-01-31,8150000,3900000,3299,1182.1764170960898
"56 PINE STREET, 10D",2005-09-09,430950,2006-01-26,595000,164050,139,1180.2158273381294
"170 WEST 23RD   STREET, 3P",2008-10-03,368000,2009-04-01,580000,212000,180,1177.7777777777778
"93 WORTH STREET, 303",2014-03-20,1573196,2016-07-27,2585000,1011804,860,1176.5162790697675
"25 COLUMBUS CIRCLE, ST68E",2004-03-12,2448769,2015-12-15,7500000,5051231,4295,1176.0724097788125
"101 WARREN STREET, 1650",2008-10-10,5620740,2012-06-14,7200000,1579260,1343,1175.9195830230826
"530 PARK AVENUE, 15H",2013-12-19,2100000,2015-02-18,2600000,500000,426,1173.7089201877934
"1437 3 AVENUE, 23",2004-09-22,3250000,2005-07-13,3595000,345000,294,1173.469387755102
"333 RECTOR PLACE, 1408",2013-04-30,2494712,2016-01-14,3650000,1155288,989,1168.1375126390294
"250 EAST 40 STREET, 21B",2005-03-15,625000,2005-11-14,910000,285000,244,1168.032786885246
"1 CENTRAL PARK WEST, 28C",2009-10-21,3900000,2017-10-10,7300000,3400000,2911,1167.9835108210236
"80 RIVERSIDE BOULEVARD, 9P",2012-06-12,2359306,2014-07-15,3250000,890694,763,1167.3577981651376
"120 EAST 87TH STREET, P6-A",2011-09-13,3125222,2014-06-16,4300000,1174778,1007,1166.6117179741807
"220, 20F",2003-02-14,509125,2003-08-01,705000,195875,168,1165.922619047619
"245 SEVENTH AVENUE, 3B",2011-08-16,2800000,2013-04-08,3500000,700000,601,1164.7254575707154
"500 PARK AVENUE, 35B",2005-04-06,3250000,2009-05-21,5000000,1750000,1506,1162.0185922974767
"241 5 AVENUE, 7C",2013-11-05,1043706,2014-07-18,1340000,296294,255,1161.9372549019608
"373 WEST 49 STREET, 1A",2003-12-29,485000,2004-05-27,659000,174000,150,1160.0
"450 WEST 17TH   STREET, 1212",2008-12-22,672045,2009-04-07,795000,122955,106,1159.9528301886792
"345 WEST 13 STREET, 2C",2003-03-28,1985000,2006-01-17,3175000,1190000,1026,1159.8440545808967
"80 RIVERSIDE BOULEVARD, 1D/E",2011-02-03,3451867,2014-09-30,5000000,1548133,1335,1159.6501872659176
"333 EAST 45TH   STREET, PHC",2008-10-13,129204,2014-04-29,2475000,2345796,2024,1158.990118577075
"10 WEST STREET, 34E",2003-08-19,2545625,2004-12-10,3100000,554375,479,1157.3590814196243
"101 WARREN STREET, 2410",2008-12-17,3445758,2013-04-04,5257500,1811742,1569,1154.7112810707456
"215 WEST 88TH   STREET, 6FG",2009-07-01,3985200,2017-02-17,7195000,3209800,2788,1151.2912482065997
"48 BEACH STREET, 4D",2010-12-21,1438003,2016-05-11,3700000,2261997,1968,1149.3887195121952
"25 NORTH MOORE STREET, 15B",2004-11-02,5350000,2012-10-29,8702500,3352500,2918,1148.9033584647018
"166 PERRY STREET, 5A",2009-12-07,9202434,2016-08-10,12000000,2797566,2438,1147.4840032813781
"300 EAST 77TH STREET, 28A",2004-09-14,3309312,2007-06-06,4451000,1141688,995,1147.4251256281407
"90 EAST END AVENUE, 8A",2014-07-09,4073000,2015-06-09,4457150,384150,335,1146.7164179104477
"46 LISPENARD STREET, 4A",2013-06-12,2800187,2015-11-02,3800000,999813,873,1145.2611683848797
"111 WEST 67TH   STREET, 39-D",2010-03-02,2958500,2014-03-18,4650000,1691500,1477,1145.2268111035883
"2211 BROADWAY, 4G",2010-09-13,2211995,2016-08-25,4700000,2488005,2173,1144.9631845375056
"16 WEST 19TH   STREET, 7-D",2008-01-31,554946,2008-05-15,675100,120154,105,1144.3238095238096
"120 RIVERSIDE BOULEVARD, 11L",2006-02-08,1296000,2006-10-23,1590000,294000,257,1143.9688715953307
"59 WEST 12TH   STREET, 7E",2010-01-15,3275000,2013-08-06,4760154,1485154,1299,1143.3056197074673
"1 MORTON SQUARE, 10B W",2004-12-02,2265606,2011-11-21,5175000,2909394,2545,1143.1803536345776
"203 WEST 81 STREET, 6A",2004-08-19,995000,2005-05-13,1300000,305000,267,1142.3220973782772
"220, 18U",2003-03-12,501930,2003-06-30,627500,125570,110,1141.5454545454545
"40 MERCER STREET, 9",2010-03-03,1750000,2012-12-05,2900000,1150000,1008,1140.873015873016
"129 LAFAYETTE STREET, 3C",2005-01-18,1298268,2007-07-29,2350000,1051732,922,1140.70715835141
"1 CENTRAL PARK WEST, 26B",2005-06-28,3000000,2015-02-05,7000000,4000000,3509,1139.9259048161869
"205 EAST 85TH   STREET, PH1D",2011-07-26,6069509,2016-03-17,8000000,1930491,1696,1138.2612028301887
"220 EAST 65 STREET, 8E",2004-10-14,270000,2005-02-14,410000,140000,123,1138.2113821138212
"471 WASHINGTON STREET, 3",2012-01-05,4913056,2014-11-14,6100000,1186944,1044,1136.9195402298851
"90 EAST END AVENUE, 7A",2010-06-15,3398357,2017-01-31,6150000,2751643,2422,1136.1036333608588
"120 RIVERSIDE BOULEVARD, 16HM",2006-03-20,1710660,2012-07-12,4325000,2614340,2306,1133.712055507372
"333 EAST 30TH   STREET, 5-L",2011-03-22,482500,2012-10-22,1139900,657400,580,1133.448275862069
"310 WEST 52ND   STREET, 22A",2007-03-08,896060,2007-09-26,1125000,228940,202,1133.3663366336634
"90 EAST END AVENUE, 17B",2004-08-06,3185000,2007-04-17,4300000,1115000,984,1133.1300813008131
"220 EAST 65 STREET, 11B",2004-01-13,760000,2005-01-31,1195000,435000,384,1132.8125
"1 MORTON SQUARE, 6E W",2004-11-03,1501918,2008-01-15,2825000,1323082,1168,1132.775684931507
"80 COLUMBUS CIRCLE, NT72E",2004-04-20,2723819,2014-02-26,6800000,4076181,3599,1132.5871075298694
"151 EAST 58TH   STREET, 38B",2009-03-26,4425000,2015-12-11,7200000,2775000,2451,1132.1909424724602
"2551 8 AVENUE, 2551B",2003-03-20,136000,2003-07-21,275000,139000,123,1130.081300813008
"350 WEST 42ND   STREET, 22L",2006-12-28,970000,2007-08-24,1240000,270000,239,1129.7071129707113
"120 RIVERSIDE BOULEVARD, PH4A",2006-05-09,1603132,2007-09-14,2160000,556868,493,1129.5496957403652
"15 CENTRAL PARK WEST, 3F",2008-01-22,4989425,2012-10-26,6950000,1960575,1739,1127.4151811385855
"225 5 AVENUE, PHS",2007-11-15,4887600,2015-03-11,7900000,3012400,2673,1126.9734380845491
"200 EAST 66TH   STREET, B0405",2013-01-24,2150544,2014-05-27,2700000,549456,488,1125.9344262295083
"555 LENOX AVENUE, 2C",2016-08-17,62000,2017-08-28,485300,423300,376,1125.7978723404256
"124 WEST 23RD   STREET, PH1",2013-06-13,5449275,2015-12-29,6495000,1045725,929,1125.6458557588805
"846 2 AVENUE, 7A",2004-10-21,340000,2005-03-30,520000,180000,160,1125.0
"345 EAST 80TH   STREET, 8E",2016-05-11,216550,2017-09-15,770000,553450,492,1124.89837398374
"321 WEST 110TH STREET, 6C",2014-10-21,636406,2015-01-30,750000,113594,101,1124.6930693069307
"275 GREENWICH STREET, 7ES",2007-05-30,1115000,2010-06-04,2353000,1238000,1101,1124.4323342415985
"845 WEST END AVENUE, 2A",2015-02-25,2214694,2017-02-28,3040000,825306,734,1124.3950953678475
"250 WEST STREET, 2E",2013-04-09,2805278,2015-09-11,3800000,994722,885,1123.9796610169492
"581 ACADEMY STREET, 3B",2016-02-25,260000,2016-07-12,415000,155000,138,1123.1884057971015
"80 COLUMBUS CIRCLE, NT68F",2004-03-08,1832850,2005-04-28,2300000,467150,416,1122.9567307692307
"230 WEST 56 STREET, 59B",2003-05-02,1481554,2005-07-06,2375000,893446,796,1122.4195979899498
"322 WEST 57TH   STREET, 42U1",2011-05-05,2545625,2014-10-10,3950000,1404375,1254,1119.9162679425838
"900 PARK AVENUE, 15C",2010-11-18,637500,2013-11-27,1875000,1237500,1105,1119.9095022624435
"25 COLUMBUS CIRCLE, ST54B",2004-01-28,3539655,2013-08-27,7450000,3910345,3499,1117.5607316376108
"450 WEST 17TH   STREET, PH04",2009-03-11,1373619,2013-03-06,3000000,1626381,1456,1117.0199175824175
"15 BROAD ST, 828",2007-04-02,605858,2007-11-20,865000,259142,232,1116.9913793103449
"200 EAST 69 STREET, 30C",2003-03-17,2300000,2005-05-31,3200000,900000,806,1116.6253101736972
"205 WEST 76TH STREET, PH4B",2012-04-19,3600000,2017-03-17,5600000,2000000,1793,1115.4489682097044
"521 PARK AVENUE, 10B",2003-11-20,2050000,2007-07-27,3550000,1500000,1345,1115.2416356877322
"1 MORTON SQUARE, 3A W",2004-10-12,1323725,2016-01-07,5900000,4576275,4104,1115.076754385965
"25 NORTH MOORE STREET, 15A",2003-07-09,2672906,2004-09-09,3150000,477094,428,1114.7056074766356
"35 WEST 15TH   STREET, 11E",2015-07-01,1682512,2016-02-26,1950000,267488,240,1114.5333333333333
"330 EAST 38 STREET, 7K",2004-06-11,735000,2005-07-11,1175000,440000,395,1113.9240506329113
"220, 17L",2003-06-05,1200000,2003-12-02,1400000,200000,180,1111.111111111111
"203 WEST 90 STREET, 4B",2003-02-14,390000,2004-01-22,770000,380000,342,1111.111111111111
"50 BOND STREET, R4",2004-03-12,2087413,2012-12-26,5650000,3562587,3211,1109.4945499844284
"701 MADISON AVENUE, 10A",2004-04-27,2350000,2013-10-30,6200000,3850000,3473,1108.5516844226893
"80 COLUMBUS CIRCLE, NT75E",2004-05-18,2952925,2014-12-29,7250000,4297075,3877,1108.35052875935
"40 EAST 61ST   STREET, 6C",2009-10-14,1802500,2014-08-07,3750000,1947500,1758,1107.792946530148
"130 WEST 12TH   STREET, PH11A",2012-09-05,8095087,2014-12-01,9000000,904913,817,1107.6046511627908
"366 WEST 15 STREET, 4N",2003-11-14,636406,2005-07-01,1295000,658594,595,1106.8806722689076
"101 WARREN STREET, 2260",2008-10-29,3033366,2010-08-12,3755000,721634,652,1106.8006134969326
"22 MERCER STREET, PHA",2007-01-19,4429387,2010-12-09,6000000,1570613,1420,1106.0654929577465
"246 WEST 17TH   STREET, 1C",2009-06-04,1350000,2012-05-25,2550000,1200000,1086,1104.9723756906078
"322 WEST 57TH   STREET, 52B3",2011-08-24,3131118,2016-07-12,5100000,1968882,1784,1103.6334080717488
"41 WEST 72ND   STREET, 10B",2012-12-14,196563,2014-05-12,763688,567125,514,1103.3560311284048
"90 EAST END AVENUE, 16B",2005-11-29,1235000,2010-12-22,3275000,2040000,1849,1103.2990805840996
"80 RIVERSIDE BOULEVARD, 3U",2012-04-04,3487500,2013-08-27,4050000,562500,510,1102.9411764705883
"147 WAVERLY PLACE, 3E",2008-05-19,2647450,2014-06-23,5100000,2452550,2226,1101.774483378257
"80 JOHN STREET, 3A",2007-09-05,556982,2008-01-31,720000,163018,148,1101.472972972973
"540 WEST 28TH   STREET, 9B",2012-08-10,968420,2014-12-04,1900000,931580,846,1101.1583924349882
"211 EAST 46TH   STREET, 6D",2009-01-27,430519,2009-06-30,600000,169481,154,1100.525974025974
"140 EAST 63RD   STREET, 7F",2007-11-28,1084436,2008-05-01,1255000,170564,155,1100.4129032258065
"422 EAST 72 STREET, 3C",2004-04-09,745000,2005-05-05,1175000,430000,391,1099.7442455242967
"25 NORTH MOORE STREET, 3A/4A",2004-02-26,3875000,2012-07-23,7250000,3375000,3070,1099.3485342019544
"150 EAST 86TH   STREET, 11A",2011-03-31,7636875,2016-06-16,9725000,2088125,1904,1096.7043067226891
"230 WEST 56 STREET, 51C",2003-07-15,1354273,2005-02-23,2000000,645727,589,1096.3106960950763
"225 LAFAYETTE STREET, 10D",2005-03-24,2051773,2007-03-23,2850000,798227,729,1094.9615912208506
"25 COLUMBUS CIRCLE, ST57D",2003-12-26,4130355,2016-09-01,9200000,5069645,4633,1094.2467083962874
"18 LEONARD STREET, 1D",2007-07-25,3125000,2015-11-05,6435000,3310000,3025,1094.2148760330579
"40 DELANCEY STREET, 9B",2012-07-31,839340,2014-08-11,1650000,810660,741,1094.008097165992
"59 WEST 12TH   STREET, 11A-T",2010-05-21,3151000,2016-07-26,5619000,2468000,2258,1093.0026572187776
"327 CENTRAL PARK WEST, 15B",2005-05-27,26996,2012-06-22,2850000,2823004,2583,1092.9167634533487
"350 WEST 42ND   STREET, 4L",2007-02-13,528471,2007-05-16,629000,100529,92,1092.7065217391305
"1 CENTRAL PARK WEST, 36C",2004-07-07,3195000,2013-04-15,6695000,3500000,3204,1092.3845193508114
"161 WEST 61 STREET, 20G",2004-01-09,925000,2005-08-18,1565000,640000,587,1090.289608177172
"400 EAST 67TH   STREET, 28A",2012-04-10,4887600,2013-07-24,5400000,512400,470,1090.212765957447
"176 PERRY STREET, 2S",2003-07-15,2494713,2014-07-17,6875000,4380287,4020,1089.623631840796
"58 WEST 58TH STREET, 27F1",2007-04-11,550000,2008-05-19,990000,440000,404,1089.1089108910892
"944 PARK AVENUE, 16",2003-11-05,6500000,2005-08-09,7200000,700000,643,1088.646967340591
"80 COLUMBUS CIRCLE, NT69A",2004-02-27,3920263,2016-10-24,8950000,5029737,4623,1087.9811810512654
"1992 BROADWAY, 25-DH",2003-08-12,360722,2004-11-18,865410,504688,464,1087.6896551724137
"305 EAST 85TH   STREET, 4A",2010-05-06,1883762,2013-05-29,3100000,1216238,1119,1086.8972296693476
"1 CENTRAL PARK WEST, 38B",2006-02-06,3900000,2012-11-28,6600000,2700000,2487,1085.6453558504222
"166 PERRY STREET, 1A",2010-02-03,3054750,2012-03-23,3900000,845250,779,1085.0449293966624
"250 WEST STREET, 3D",2013-05-14,5142162,2015-07-14,6000000,857838,791,1084.4981036662452
"25 COLUMBUS CIRCLE, ST73E",2006-04-20,3426293,2014-04-25,6600000,3173707,2927,1084.2866416125726
"15 EAST 26TH STREET, 11E",2008-08-07,2698362,2015-03-18,5315000,2616638,2414,1083.9428334714166
"140 WEST 22ND   STREET, PHA",2009-03-30,3920262,2012-06-14,5190000,1269738,1172,1083.3941979522185
"66 LEONARD STREET, 12D",2012-07-11,2275000,2016-02-18,3700000,1425000,1317,1082.004555808656
"131 WEST 82 STREET, 2",2004-06-30,1050000,2005-07-27,1474000,424000,392,1081.6326530612246
"160 EAST 22ND   STREET, 20A",2014-12-16,3054739,2015-07-31,3300000,245261,227,1080.444933920705
"1992 BROADWAY, 22-D",2003-08-12,360722,2004-06-18,696739,336017,311,1080.4405144694533
"21 ASTOR PLACE, 3E",2004-06-18,1705569,2007-03-28,2800000,1094431,1013,1080.3859822309971
"610 PARK AVENUE, 8A",2003-10-24,4200000,2006-08-08,5300000,1100000,1019,1079.4896957801766
"40 BOND STREET, TH1",2007-08-06,10691625,2014-09-23,13500000,2808375,2605,1078.071017274472
"160 CENTRAL PARK SOUTH, 1901",2008-01-25,3000000,2010-08-10,4000000,1000000,928,1077.5862068965516
"1 CENTRAL PARK WEST, 32G",2006-06-13,3900000,2014-07-31,7100000,3200000,2970,1077.4410774410774
"255 CABRINI BOULEVARD, 1F",2008-03-05,92500,2008-09-29,316000,223500,208,1074.5192307692307
"640 WEST END AVENUE, 2B",2011-06-01,2701417,2014-09-08,3985000,1283583,1195,1074.1280334728033
"721 FIFTH AVENUE, 42B",2004-09-27,1575000,2008-11-18,3200000,1625000,1513,1074.0251156642432
"845 UNITED NATIONS PLAZA, 48C",2003-06-04,1250000,2006-09-29,2550000,1300000,1213,1071.7230008244023
"15 BROAD STREET, 2208",2006-11-16,621132,2007-04-03,769000,147868,138,1071.5072463768115
"845 UNITED NATIONS PLAZA, 50B",2003-03-14,3054750,2008-03-03,5000000,1945250,1816,1071.1729074889868
"240 RIVERSIDE BOULEVARD, 11 OT",2005-11-18,1080750,2007-05-18,1665000,584250,546,1070.0549450549452
"78 LAIGHT STREET, PH",2009-12-31,6007675,2016-10-07,8650000,2642325,2472,1068.9016990291261
"45 WALKER STREET, 6",2003-10-21,6313150,2011-12-21,9500000,3186850,2983,1068.3372443848475
"220 RIVERSIDE BOULEVARD, 12G",2003-10-09,2900000,2005-10-27,3700000,800000,749,1068.090787716956
"322 WEST 57TH   STREET, 52M1",2011-01-11,1975000,2014-04-17,3245000,1270000,1192,1065.4362416107383
"44 EAST 67 STREET, 3B",2003-07-31,1110000,2005-11-15,2000000,890000,838,1062.0525059665872
"300 EAST 93 STREET, 17D",2003-12-29,200000,2004-04-20,320000,120000,113,1061.9469026548672
"120 WEST 72ND   STREET, PH-1",2014-02-19,8962500,2017-10-30,10395000,1432500,1349,1061.8977020014827
"459 WASHINGTON STREET, 4S",2005-10-21,751836,2010-07-28,2600000,1848164,1741,1061.5531303848363
"31 EAST 28TH   STREET, 7EW",2007-05-29,2543079,2010-04-07,3650000,1106921,1044,1060.2691570881227
"345 WEST 13TH STREET, 2B",2004-08-16,1900000,2007-01-29,2850000,950000,896,1060.267857142857
"136 WEST 22 STREET, 6",2004-01-27,2195000,2006-07-17,3150000,955000,902,1058.7583148558758
"470 BROOME STREET, 4N",2010-02-08,2774731,2012-07-02,3700000,925269,875,1057.4502857142857
"304 EAST 65TH STREET, 35B",2010-10-04,450000,2011-10-13,845000,395000,374,1056.149732620321
"1992 BROADWAY, 20-D",2003-08-12,360722,2004-06-03,673319,312597,296,1056.070945945946
"151 WOOSTER STREET, 6A",2009-06-19,5500000,2014-08-26,7500000,2000000,1894,1055.9662090813094
"220 3 AVENUE, 4B",2012-01-17,1350000,2012-09-10,1600000,250000,237,1054.8523206751054
"7 EAST 17TH   STREET, 3S",2011-05-18,2100000,2014-06-30,3300000,1200000,1139,1053.5557506584723
"78 LAIGHT STREET, 1A",2009-10-27,1629200,2010-10-14,2000000,370800,352,1053.409090909091
"31 VESTRY STREET, 2 (TH2)",2012-03-27,10000000,2013-07-15,10500000,500000,475,1052.6315789473683
"21 ASTOR PLACE, 10C",2004-02-11,2647450,2005-01-11,3000000,352550,335,1052.3880597014925
"340 EAST 64 STREET, 6S",2003-11-14,825000,2005-11-15,1595000,770000,732,1051.9125683060108
"15 BROAD STREET, 1204",2006-06-20,677136,2007-10-26,1195000,517864,493,1050.4340770791075
"1 MORTON SQUARE, 9B E",2004-11-30,1970313,2006-12-13,2750000,779687,743,1049.3768506056529
"101 WARREN STREET, 2510",2008-12-18,3640243,2012-05-21,4950000,1309757,1250,1047.8056
"333 RECTOR PLACE, 1205",2012-06-15,2577400,2015-04-29,3675000,1097600,1048,1047.328244274809
"721 5 AVENUE, 39E",2004-07-01,1150000,2005-08-11,1575000,425000,406,1046.7980295566501
"36 GRAMERCY PARK EAST, 12N",2010-12-06,2056865,2014-01-06,3235000,1178135,1127,1045.3726708074535
"55 WHITE STREET, PHB",2009-08-11,2520000,2015-09-18,4850000,2330000,2229,1045.3117990130104
"322 WEST 57TH   STREET, 20S",2011-01-12,999921,2013-07-10,1950000,950079,910,1044.0428571428572
"252 7 AVENUE, 14G",2003-02-26,1175000,2005-12-22,2250000,1075000,1030,1043.6893203883494
"317 WEST 89TH STREET, 6W",2007-05-23,2205000,2010-11-03,3520000,1315000,1260,1043.6507936507937
"425 WEST 50TH   STREET, 10D",2015-01-20,1934675,2016-07-15,2500000,565325,542,1043.0350553505534
"372 CENTRAL PARK WEST, 3Y",2016-07-15,755000,2017-01-19,951000,196000,188,1042.5531914893618
"310 EAST 53RD STREET, 6C",2006-10-19,1389911,2018-07-11,5855000,4465089,4283,1042.514359094093
"210 WEST 19TH STREET, 3J",2013-05-24,575000,2014-09-09,1068000,493000,473,1042.2832980972516
"400 WEST 12TH   STREET, 3B",2010-03-02,997885,2012-01-05,1700000,702115,674,1041.713649851632
"22 WEST 15 STREET, 3B",2004-04-27,795000,2005-05-16,1195000,400000,384,1041.6666666666667
"200-10 EAST 65 STREET, 35E",2003-06-18,1650000,2004-01-14,1868750,218750,210,1041.6666666666667
"106 CENTRAL PARK SOUTH, 23E",2007-01-11,2650000,2008-11-14,3350000,700000,673,1040.1188707280833
"15 EAST 26TH   STREET, 12B",2008-07-31,4403931,2011-09-01,5575000,1171069,1127,1039.1029281277729
"272 WATER STREET, 5R/6R",2012-03-15,1221900,2014-04-04,2000000,778100,750,1037.4666666666667
"9 MURRAY STREET, 8SE",2005-11-22,2800000,2008-06-19,3775000,975000,940,1037.2340425531916
"20 GREENE STREET, 6B",2008-03-05,10000000,2018-05-18,13860000,3860000,3726,1035.9634997316157
"124 WEST 93 STREET, 6C",2003-12-08,650000,2004-05-04,803250,153250,148,1035.472972972973
"65 EAST 96TH STREET, 8B",2005-04-25,1919675,2006-08-02,2400000,480325,464,1035.1831896551723
"1992 BROADWAY, 23-H",2003-08-12,403077,2004-11-29,894741,491664,475,1035.082105263158
"170 EAST 87 STREET, E7G",2004-12-15,485000,2005-05-11,637000,152000,147,1034.0136054421769
"10 WEST STREET, 32E",2003-05-06,2494713,2005-06-23,3300000,805287,779,1033.7445442875483
"77 WHITE STREET, 2",2007-01-22,822500,2013-08-15,3300000,2477500,2397,1033.5836462244472
"150 NASSAU STREET, 4H",2003-03-21,334620,2003-11-04,570000,235380,228,1032.3684210526317
"310 EAST 53RD   STREET, 4/5F",2013-06-03,1650000,2015-08-31,2495000,845000,819,1031.7460317460318
"144 WEST 18TH STREET, 500W",2005-09-12,2700000,2007-06-04,3350000,650000,630,1031.7460317460318
"327 CENTRAL PARK WEST, 4A",2005-05-27,25209,2013-03-01,2950000,2924791,2835,1031.6723104056437
"102 WOOSTER STREET, PHN",2003-07-31,5200000,2011-07-18,8200000,3000000,2909,1031.2822275696115
"211 EAST 13TH   STREET, PH F",2014-12-12,3256759,2017-06-14,4200000,943241,915,1030.864480874317
"100 UNITED NATIONS PLAZA, 31C",2004-06-16,999000,2005-04-04,1300000,301000,292,1030.8219178082193
"53 NORTH MOORE STREET, 2B",2004-02-17,1100000,2011-04-21,3800000,2700000,2620,1030.5343511450383
"25 CENTRAL PARK WEST, 23J",2005-10-17,1261634,2017-03-10,5550187,4288553,4162,1030.4067755886592
"324 EAST 112 STREET, 4B",2017-07-12,610000,2018-05-04,915000,305000,296,1030.4054054054054
"299 WEST 12TH STREET, PHD",2005-01-28,1900000,2007-03-16,2700000,800000,777,1029.6010296010295
"1-2 RIVER TERRACE, 8S",2008-05-30,132372,2014-01-17,2250000,2117628,2058,1028.9737609329445
"25 NORTH MOORE STREET, 12C",2011-05-26,2500000,2014-01-22,3500000,1000000,972,1028.80658436214
"43 WEST 64TH STREET, 4A",2009-08-07,4200000,2017-08-30,7229575,3029575,2945,1028.7181663837011
"60 RIVERSIDE BOULEVARD, 3802",2012-03-20,6541013,2017-09-18,8604500,2063487,2008,1027.6329681274901
"225 5 AVENUE, 7H",2007-01-24,1094618,2007-08-07,1295000,200382,195,1027.6
"223 WEST 80TH   STREET, 10",2012-09-27,1975000,2014-05-29,2600000,625000,609,1026.2725779967159
"502 PARK AVENUE, 9G",2004-03-04,2011044,2008-02-25,3500000,1488956,1453,1024.7460426703371
"73 WOOSTER STREET, 3B",2004-09-22,4429387,2017-09-29,9300000,4870613,4755,1024.313985278654
"1235 PARK AVENUE, 5C",2007-01-11,350000,2009-06-30,1272812,922812,901,1024.2086570477247
"845 UNITED NATIONS PLAZA, 90B",2006-06-28,13500000,2013-03-04,16000000,2500000,2441,1024.1704219582139
"175 WEST 12TH STREET, 14D",2011-03-04,1576500,2014-08-05,2855000,1278500,1250,1022.8
"157 HUDSON STREET, 3D",2012-04-13,1802937,2018-03-21,4020000,2217063,2168,1022.6305350553506
"21 ASTOR PLACE, 6C",2004-03-10,1648400,2008-11-17,3400000,1751600,1713,1022.533566841798
"350 WEST 42ND   STREET, PH G",2006-12-11,1934675,2008-04-04,2425000,490325,480,1021.5104166666666
"340 WEST 57TH STREET, 3A",2005-04-15,775000,2014-08-08,4250000,3475000,3402,1021.4579659024104
"1212 5 AVENUE, 6B",2012-11-15,3080206,2018-07-24,5200000,2119794,2077,1020.603755416466
"1992 BROADWAY, 27-G",2004-02-13,1225000,2005-05-24,1700000,475000,466,1019.31330472103
"400 EAST 70TH STREET, 508",2005-04-11,429000,2005-09-16,590000,161000,158,1018.9873417721519
"220, 18F",2003-02-13,496860,2003-08-12,680000,183140,180,1017.4444444444445
"80 COLUMBUS CIRCLE, NT74E",2004-04-07,2952925,2013-10-24,6500000,3547075,3487,1017.2282764554058
"150 EAST 86TH   STREET, 14A",2011-04-18,7550000,2013-09-19,8450000,900000,885,1016.9491525423729
"230 WEST 56 STREET, 62C",2003-06-18,2545625,2004-01-05,2750000,204375,201,1016.7910447761194
"400 5 AVENUE, 42E",2012-02-09,2520168,2014-06-24,3400000,879832,866,1015.972286374134
"450 WEST 17TH STREET, 2404",2011-07-12,1975000,2014-04-16,3000000,1025000,1009,1015.8572844400396
"50 BOND STREET, R3",2004-02-03,1832850,2013-06-10,5300000,3467150,3415,1015.2708638360176
"120 RIVERSIDE BOULEVARD, 3M",2006-12-06,770000,2008-01-24,1190000,420000,414,1014.4927536231884
"101 WARREN STREET, 3020",2009-02-11,3889715,2013-09-24,5600000,1710285,1686,1014.4039145907474
"1992 BROADWAY, 23-D",2003-08-12,360722,2004-07-20,708448,347726,343,1013.7784256559767
"450 WEST 17TH   STREET, 2408",2009-04-06,2341975,2011-08-01,3200000,858025,847,1013.0165289256198
"322 WEST 57TH   STREET, 40H2",2011-11-30,2875000,2015-10-07,4300000,1425000,1407,1012.7931769722815
"151 HUDSON STREET, 3",2010-04-08,68165,2015-11-24,2150000,2081835,2056,1012.5656614785992
"28 EAST 10TH   STREET, 7F",2010-11-10,433700,2017-07-13,2900000,2466300,2437,1012.0229790726303
"295 GREENWICH STREET, 9BN",2003-01-31,1160000,2005-08-17,2100000,940000,929,1011.8406889128095
"42 WOOSTER STREET, 5 NO",2005-09-12,5800000,2010-03-01,7450000,1650000,1631,1011.6492949110975
"127 EAST 79TH   STREET, 10E",2014-01-07,9622462,2016-05-24,10500000,877538,868,1010.9884792626729
"70 BATTERY PLACE, 26F",2012-05-15,1410276,2014-11-17,2335000,924724,916,1009.5240174672489
"231 10TH   AVENUE, 10A",2007-03-02,658000,2009-07-28,1545000,887000,879,1009.1012514220705
"101 WARREN STREET, 1560",2008-09-23,2728910,2012-12-28,4300000,1571090,1557,1009.0494540783558
"310 EAST 53RD STREET, 11B",2006-11-22,2382705,2007-09-18,2685000,302295,300,1007.65
"350 WEST 50 STREET, 4ZZ",2003-10-09,251866,2004-03-29,425000,173134,172,1006.5930232558139
"144 COLUMBUS AVENUE, 21A",2003-06-18,1655000,2005-06-28,2400000,745000,741,1005.3981106612686
"505 GREENWICH STREET, 14H",2005-04-27,2367431,2006-11-03,2925000,557569,555,1004.6288288288288
"2101 BROADWAY, 12144",2004-06-04,2100000,2008-03-24,3495000,1395000,1389,1004.3196544276458
"42 EAST 20TH   STREET, 8APHA",2011-03-03,6700000,2016-08-15,8700000,2000000,1992,1004.0160642570281
"300 EAST 55 STREET, 10D",2005-01-27,1445915,2006-07-11,1978000,532085,530,1003.933962264151
"540 WEST 28TH   STREET, 7B",2012-08-10,979049,2015-02-24,1910000,930951,928,1003.1799568965517
"80 RIVERSIDE BOULEVARD, 7C",2010-12-21,2500000,2012-10-24,3175000,675000,673,1002.9717682020803
"215 WEST 95 STREET, 17H",2003-07-14,692500,2005-03-07,1295000,602500,602,1000.8305647840532
"2 COLUMBUS AVENUE, 16A",2005-02-17,2295000,2006-03-29,2700000,405000,405,1000.0
"340 EAST 23RD   STREET, 14D",2009-04-21,975068,2009-08-24,1100000,124932,125,999.456
"150 EAST 85 STREET, 14/15",2004-07-29,1934675,2006-11-17,2775000,840325,841,999.1973840665873
"181 EAST 90TH   STREET, PH32A",2010-01-22,6925000,2013-04-12,8100000,1175000,1176,999.1496598639455
"117 EAST 57TH   STREET, 45C",2012-05-31,4375000,2014-10-24,5250000,875000,876,998.8584474885845
"80 COLUMBUS CIRCLE, NT64E",2004-07-09,2367431,2013-08-28,5700000,3332569,3337,998.6721606233143
"640 WEST END AVENUE, 7B",2011-02-16,2100000,2015-05-19,3650000,1550000,1553,998.0682549903413
"1992 BROADWAY, 20-N",2003-08-12,303028,2004-06-02,597204,294176,295,997.206779661017
"151 WOOSTER STREET, 4B",2013-05-13,4700000,2015-04-15,5400000,700000,702,997.1509971509971
"25 CENTRAL PARK WEST, 14J",2007-11-26,6337000,2014-12-05,8895000,2558000,2566,996.8823070927514
"422 EAST 72 STREET, 3A",2003-03-17,630000,2004-01-22,940000,310000,311,996.7845659163987
"15 BROAD STREET, 2104",2006-06-15,803595,2006-12-14,985000,181405,182,996.7307692307693
"200 CHAMBERS STREET, 17E",2007-05-21,987702,2007-12-20,1200000,212298,213,996.7042253521126
"450 WEST 17TH   STREET, 1222",2008-11-14,992793,2015-05-08,3350000,2357207,2366,996.2836010143702
"27 WEST 72ND   STREET, 1509",2010-03-17,110437,2012-03-16,837573,727136,730,996.0767123287671
"45 GREENE STREET, 5",2007-01-12,2100000,2009-05-19,2952925,852925,858,994.0850815850816
"37 GREENE STREET, 5",2004-09-20,2580000,2014-12-23,6300000,3720000,3746,993.059263214095
"99 JANE STREET, 6D",2005-10-26,2965000,2007-04-18,3500000,535000,539,992.5788497217069
"2101 BROADWAY, 40970",2004-04-16,443000,2005-02-16,746116,303116,306,990.5751633986928
"157 CHAMBERS STREET, 3A",2009-07-06,3630000,2016-11-22,6300000,2670000,2696,990.3560830860534
"1992 BROADWAY, 21-N",2003-08-12,303028,2004-06-10,603060,300032,303,990.2046204620463
"1 CENTRAL PARK WEST, 30C",2004-02-20,2610000,2010-02-16,4775000,2165000,2188,989.4881170018282
"354 BROOME STREET, 5G",2007-06-27,1400000,2008-09-24,1850000,450000,455,989.010989010989
"77 PARK AVENUE, 7D",2012-08-29,1200000,2015-04-17,2150000,950000,961,988.5535900104059
"120 EAST 87TH STREET, R6-A",2013-10-25,1839000,2016-04-19,2735000,896000,907,987.87210584344
"1992 BROADWAY, 24-D",2003-08-12,360722,2004-08-10,720158,359436,364,987.4615384615385
"447 WEST 18TH   STREET, P910A",2009-03-25,7331400,2014-12-08,9388888,2057488,2084,987.2783109404991
"635 WEST 42ND   STREET, 9G",2016-12-21,1007002,2017-08-09,1235000,227998,231,987.004329004329
"181 EAST 90 STREET, 4B",2004-06-10,1203064,2005-01-26,1430000,226936,230,986.6782608695652
"250 EAST 54 STREET, 35D",2003-08-01,1450000,2006-11-30,2650000,1200000,1217,986.0312243221035
"1965 BROADWAY, 22D",2003-06-30,1090000,2005-07-12,1822500,732500,743,985.8681022880215
"250 EAST 54 STREET, 17C",2003-06-18,265000,2004-10-07,735000,470000,477,985.3249475890985
"195 HUDSON STREET, 1B",2004-06-24,1380000,2015-12-01,5495000,4115000,4177,985.156811108451
"1965 BROADWAY, 24D",2013-12-04,2306000,2015-06-10,2850000,544000,553,983.7251356238698
"333 RECTOR PLACE, 509",2011-08-31,1980000,2014-11-07,3125000,1145000,1164,983.6769759450171
"65 EAST 96TH STREET, 9B",2012-10-26,2320000,2014-07-29,2950000,630000,641,982.8393135725429
"260 WEST BROADWAY, 5D",2003-02-21,1300000,2004-06-30,1786000,486000,495,981.8181818181819
"77 READE STREET, 3B",2012-06-11,2225894,2014-01-17,2800000,574106,585,981.3777777777777
"80 COLUMBUS CIRCLE, NT64A",2004-07-19,3843893,2017-04-06,8400000,4556107,4644,981.0738587424634
"201 EAST 80TH   STREET, 17C",2012-01-12,1315000,2015-05-06,2501863,1186863,1210,980.8785123966942
"62 BEACH STREET, 5D",2010-07-02,3375000,2014-03-14,4700000,1325000,1351,980.7549962990378
"101 WARREN STREET, 3060",2009-03-03,3477984,2012-12-31,4850000,1372016,1399,980.711937097927
"50 EAST 72ND   STREET, 2C",2013-05-30,1600000,2014-10-22,2100000,500000,510,980.3921568627451
"415 GREENWICH STREET, 8B",2010-08-12,3400000,2016-06-23,5500000,2100000,2142,980.3921568627451
"343 EAST 30TH   STREET, 7-L",2014-07-09,1300000,2015-01-29,1500000,200000,204,980.3921568627451
"30 EAST 85TH   STREET, 4E",2013-09-24,2260000,2014-12-17,2700000,440000,449,979.9554565701559
"610 PARK AVENUE, 9C",2004-05-17,2850000,2008-09-15,4400000,1550000,1582,979.7724399494311
"147 WAVERLY PLACE, 4E",2008-05-12,2647450,2012-12-26,4300000,1652550,1689,978.4191829484902
"250 WEST STREET, 10C",2013-05-06,4765410,2016-05-17,5845000,1079590,1107,975.2393857271906
"433 EAST 74TH STREET, PH",2009-05-15,3207487,2015-09-03,5449000,2241513,2302,973.7241529105125
"250 WEST STREET, 11D",2013-07-08,2800187,2016-05-26,3825000,1024813,1053,973.2317188983856
"45 EAST 80TH STREET, 22A",2005-11-30,4600000,2011-06-01,6555000,1955000,2009,973.1209556993529
"923 5 AVENUE, 11E",2005-03-15,3820000,2009-05-14,5300000,1480000,1521,973.0440499671269
"15 CENTRAL PARK WEST, S709",2008-04-24,875695,2011-10-05,2100000,1224305,1259,972.4424146147736
"322 WEST 57TH   STREET, 49B",2013-02-07,818000,2015-08-24,1720000,902000,928,971.9827586206897
"300 EAST 77 STREET, 11A",2003-10-01,2226913,2007-08-14,3600000,1373087,1413,971.753007784855
"16 WEST 19TH   STREET, 12-B",2011-01-20,5600375,2014-04-18,6750000,1149625,1184,970.9670608108108
"456 WEST 19TH   STREET, 4/5A",2011-02-28,2419362,2014-03-17,3500000,1080638,1113,970.9236298292902
"108 DUANE STREET, PH3N",2012-10-09,3309312,2015-06-05,4250000,940688,969,970.782249742002
"25 COLUMBUS CIRCLE, ST52G",2004-06-25,2551137,2013-10-15,5850000,3298863,3399,970.5392762577228
"155 WEST 70TH STREET, 12C",2005-04-22,999975,2010-09-03,2900000,1900025,1960,969.4005102040817
"421 HUDSON STREET, 523",2013-07-29,1900000,2015-04-10,2500000,600000,620,967.741935483871
"220, 11F",2003-03-24,481650,2003-11-05,700000,218350,226,966.1504424778761
"165 EAST 104 STREET, 5A",2015-02-12,240000,2015-07-07,380000,140000,145,965.5172413793103
"1 CENTRAL PARK WEST, 41AB",2004-04-27,6000000,2008-07-31,7500000,1500000,1556,964.0102827763496
"360 EAST 88 STREET, 23B",2004-06-03,726316,2004-09-29,840000,113684,118,963.4237288135594
"610 PARK AVENUE, 8E",2003-07-18,2442500,2013-12-10,6100000,3657500,3798,963.0068457082675
"315 WEST 36TH STREET, 14D",2012-11-30,1235000,2014-05-19,1750000,515000,535,962.6168224299065
"203 WEST 81 STREET, 4B",2004-07-28,995000,2005-06-10,1300000,305000,317,962.1451104100946
"155 EAST 38TH STREET, 21D",2004-12-23,855000,2005-06-23,1030000,175000,182,961.5384615384615
"40 EAST 94 STREET, 29B",2005-07-06,218333,2008-04-23,1200000,981667,1022,960.5352250489237
"119 EAST 23RD STREET, 8D",2005-08-15,816634,2006-10-30,1240000,423366,441,960.0136054421769
"15 WEST 63RD STREET, 22A",2007-06-14,6800000,2010-11-15,8000000,1200000,1250,960.0
"1600 BROADWAY, PH2A",2006-11-28,1109892,2008-03-27,1575000,465108,485,958.9855670103093
"1049 FIFTH AVENUE, 19A",2005-05-19,3800000,2009-12-15,5400000,1600000,1671,957.5104727707959
"372 BROOME STREET, 3B",2012-07-18,2545000,2013-07-24,2900000,355000,371,956.8733153638814
"30 EAST 37TH STREET, 2C",2007-02-20,179550,2008-03-13,549855,370305,387,956.8604651162791
"135 DIVISION STREET, 6B",2007-11-20,460000,2008-03-14,570000,110000,115,956.5217391304348
"340 EAST 64 STREET, 5N",2003-02-05,985000,2005-06-01,1795000,810000,847,956.3164108618654
"43 WEST 64 STREET, 7B",2003-10-03,2341975,2006-01-25,3150000,808025,845,956.2426035502958
"374 WEST 11TH   STREET, 2",2010-05-17,1684123,2014-07-28,3150000,1465877,1533,956.2146118721461
"240 WEST END AVENUE, 11A/B",2010-03-18,2033000,2012-09-10,2900000,867000,907,955.8985667034178
"845 UNITED NATIONS PLAZA, 58A",2003-12-31,2036500,2007-08-14,3300000,1263500,1322,955.748865355522
"28 EAST 10TH   STREET, PH12B",2011-02-16,5040337,2016-04-25,6850000,1809663,1895,954.9672823218997
"1 BOND STREET, 6A",2012-12-12,3600000,2017-09-06,5250000,1650000,1729,954.3088490456912
"50 WARREN STREET, 3FL",2005-02-16,3500000,2014-11-19,6900000,3400000,3563,954.252034802133
"7 HARRISON STREET, 6S",2015-01-12,5854937,2016-11-18,6500000,645063,676,954.2352071005918
"120 EAST 87TH   STREET, R24-A",2009-09-02,2600000,2014-10-28,4395000,1795000,1882,953.7725823591924
"350 EAST 72ND   STREET, 14A/B",2010-03-18,1200000,2017-10-27,3850000,2650000,2780,953.2374100719425
"120 WEST 72ND STREET, 7A",2008-03-31,5065793,2010-07-28,5875000,809207,849,953.1295641931684
"200 RIVERSIDE BOULEVARD, 12K",2008-01-08,2495000,2018-08-23,6191503,3696503,3880,952.7069587628866
"250 MANHATTAN AVENUE, 4B",2016-05-26,740000,2017-02-10,987702,247702,260,952.7
"220, 29E",2003-06-02,554946,2003-12-08,735000,180054,189,952.6666666666666
"20 WEST 64TH   STREET, 32H",2008-03-18,900000,2015-02-11,3300000,2400000,2521,952.0031733439112
"58 WEST 58 STREET, 7C",2003-04-21,760000,2005-07-14,1535000,775000,815,950.920245398773
"515 WEST 23RD   STREET, RU10",2012-04-13,5324900,2015-09-02,6500000,1175100,1237,949.9595796281326
"39 VESTRY STREET, 5B",2006-05-05,1750000,2017-02-28,5500000,3750000,3952,948.8866396761133
"10 UNION SQUARE EAST, P24B",2004-04-06,1115000,2005-07-19,1560000,445000,469,948.8272921108742
"1 CENTRAL PARK WEST, 28A",2004-04-05,4500000,2009-11-09,6437500,1937500,2044,947.8962818003914
"260 PARK AVENUE SOUTH, 6B",2009-08-12,2750000,2016-03-16,5030000,2280000,2408,946.843853820598
"455 WEST 20TH   STREET, 4C",2014-01-14,2260000,2015-06-16,2750000,490000,518,945.9459459459459
"1992 BROADWAY, 21-D",2003-08-12,360722,2004-07-20,685028,324306,343,945.4985422740525
"400 EAST 51 STREET, 19B",2003-11-13,1563014,2005-10-14,2225000,661986,701,944.3452211126961
"350 EAST 82ND   STREET, 6N",2010-07-21,98000,2012-05-15,725000,627000,664,944.277108433735
"50 MADISON AVENUE, RU 3",2005-10-25,3003837,2013-12-09,5800000,2796163,2967,942.4209639366363
"65 WEST 13 STREET, 5G",2003-12-03,1670000,2006-03-10,2450000,780000,828,942.0289855072464
"900 PARK AVENUE, 6B",2014-09-09,940000,2016-11-03,1680000,740000,786,941.4758269720102
"170 EAST 87TH   STREET, E16G",2014-02-11,658333,2014-06-12,772000,113667,121,939.396694214876
"144 COLUMBUS AVENUE, 9D",2003-06-05,1450000,2005-09-07,2225000,775000,825,939.3939393939394
"52 EAST 72 STREET, 3A",2006-02-08,1900000,2011-10-17,3850000,1950000,2077,938.8541165142032
"1 RIVER TERRACE, 16A",2010-12-27,1580000,2014-10-08,2875000,1295000,1381,937.7262853005069
"240 RIVERSIDE BOULEVARD, 21 A",2006-03-29,3972940,2013-08-15,6500000,2527060,2696,937.3367952522256
"56 LEONARD STREET, 25BE",2016-07-07,4317066,2017-07-24,4675000,357934,382,937.0
"250 WEST STREET, 4B",2013-04-11,3258400,2017-08-31,4760250,1501850,1603,936.8995633187773
"250 WEST STREET, 9K",2013-03-27,2362340,2016-03-29,3390000,1027660,1098,935.9380692167578
"161 GRAND STREET, 6A",2005-02-16,261885,2012-05-30,2750000,2488115,2660,935.3815789473684
"441 EAST 57TH   STREET, 6",2010-10-28,4658493,2013-04-15,5500000,841507,900,935.0077777777777
"148 CHAMBERS STREET, 3",2011-07-18,1797211,2014-06-25,2800000,1002789,1073,934.5657036346691
"630 FIRST AVENUE, 9K",2008-05-30,224112,2010-06-14,920000,695888,745,934.0778523489932
"200 EAST 61 STREET, 30F",2004-03-08,585000,2006-06-05,1350000,765000,819,934.065934065934
"7 HUBERT STREET, 4A",2004-09-13,2291062,2011-03-07,4500000,2208938,2366,933.6170752324598
"15 CENTRAL PARK WEST, 14J",2007-12-20,2688180,2011-06-20,3880000,1191820,1278,932.5665101721439
"1619 3 AVENUE, 23H",2003-02-20,459597,2003-06-24,575000,115403,124,930.6693548387096
"200 CHAMBERS STREET, 15D",2013-09-17,3000000,2015-08-06,3640000,640000,688,930.2325581395348
"309 WEST 118 STREET, 1ETPL",2005-03-16,689355,2007-11-20,1600000,910645,979,930.1787538304392
"30 CROSBY STREET, 4A",2006-03-15,5000000,2012-04-24,7075000,2075000,2232,929.6594982078853
"250 EAST 30TH STREET, 15A",2006-06-19,571486,2009-10-15,1700000,1128514,1214,929.5831960461285
"845 WEST END AVENUE, 8E",2012-02-07,3100000,2013-07-29,3600000,500000,538,929.368029739777
"15 CENTRAL PARK WEST, 12H",2008-07-24,2586355,2010-11-15,3370000,783645,844,928.489336492891
"1619 3 AVENUE, 9A",2003-02-20,484084,2003-11-10,728000,243916,263,927.4372623574144
"1 RIVER TERRACE, 26D",2008-12-03,7409601,2016-07-28,10000000,2590399,2794,927.129205440229
"40 MERCER STREET, 30",2007-06-12,9927937,2014-09-19,12390000,2462063,2656,926.9815512048193
"120 RIVERSIDE BOULEVARD, 12S",2006-10-30,1402741,2007-12-06,1775000,372259,402,926.0174129353234
"456 WEST 19TH   STREET, 6/7F",2010-09-30,3200000,2015-06-24,4800000,1600000,1728,925.925925925926
"340 EAST 64TH STREET, 11B",2014-12-15,1250000,2016-05-11,1725000,475000,513,925.925925925926
"165 CHARLES STREET, RU2",2005-10-05,3003837,2008-05-30,3900000,896163,968,925.7882231404959
"401 EAST 60 STREET, 21D",2004-07-12,1580000,2006-08-02,2275000,695000,751,925.4327563249001
"340 EAST 64TH STREET, 8L",2013-03-13,1845000,2015-04-15,2550000,705000,763,923.9842726081258
"333 EAST 45 STREET, 25C",2004-10-18,380000,2005-04-20,550000,170000,184,923.9130434782609
"200 EAST 66TH   STREET, D1806",2008-11-24,1528393,2017-10-16,4525000,2996607,3248,922.6006773399015
"583 BROADWAY, 5M",2004-08-02,6100000,2015-06-04,9750000,3650000,3958,922.1829206670035
"350 WEST 42 STREET, 18J",2006-06-29,467454,2006-11-09,590000,122546,133,921.3984962406015
"41 BOND STREET, 6",2011-12-07,6160412,2017-10-31,8145334,1984922,2155,921.077494199536
"224 WEST 18 STREET, 4A",2003-07-02,1099710,2004-09-08,1499000,399290,434,920.0230414746544
"230 WEST 56 STREET, 67D",2003-06-06,2998746,2004-04-29,3300000,301254,328,918.4573170731708
"160 WEST 66TH   STREET, 34H",2013-11-22,2695000,2016-08-04,3600000,905000,986,917.8498985801217
"415 GREENWICH STREET, 8A",2012-02-01,3350000,2017-06-16,5150000,1800000,1962,917.4311926605504
"500 PARK AVENUE, 19B",2011-02-16,3880000,2015-12-18,5500000,1620000,1766,917.3272933182333
"372 BROOME STREET, 2B",2012-08-07,2494712,2016-10-20,3900000,1405288,1535,915.4970684039088
"245 7 AVENUE, 4B",2013-02-12,3250000,2015-01-23,3900000,650000,710,915.4929577464789
"260 PARK AVENUE SOUTH, 9G",2006-04-06,1507010,2008-07-23,2275000,767990,839,915.3635280095351
"224 WEST 18TH   STREET, 5A",2014-02-06,2480000,2016-03-07,3175000,695000,760,914.4736842105264
"40 EAST 66TH   STREET, 9C",2011-02-24,5800000,2016-03-30,7500000,1700000,1861,913.4873723804407
"311 WEST BROADWAY, 7F",2010-07-01,2189237,2014-06-05,3500000,1310763,1435,913.423693379791
"200 CHAMBERS STREET, 21D",2012-05-17,2775000,2015-02-24,3700000,925000,1013,913.1293188548865
"22 WEST 66TH STREET, 24",2006-07-13,3830000,2008-11-06,4600000,770000,847,909.0909090909091
"2 SOUTH END AVENUE, TH2",2004-04-27,525000,2004-10-20,685000,160000,176,909.0909090909091
"195 PRINCE STREET, 5W",2004-02-24,235000,2004-06-02,325000,90000,99,909.0909090909091
"155 EAST 38 STREET, 16K",2005-01-11,1350000,2006-03-27,1750000,400000,440,909.0909090909091
"309 WEST 118 STREET, 4GDPL",2005-03-25,840056,2006-04-03,1180000,339944,374,908.9411764705883
"1641 3 AVENUE, 9K",2003-04-03,363418,2004-01-05,615000,251582,277,908.2382671480144
"188 EAST 76TH STREET, 18A",2005-08-12,3560000,2006-10-16,3950000,390000,430,906.9767441860465
"101 WARREN STREET, 1110",2009-01-15,3221615,2012-05-22,4330000,1108385,1223,906.283728536386
"62 BEACH STREET, 3E",2009-10-16,2650000,2016-08-01,4898040,2248040,2481,906.1023780733575
"167 EAST 82ND   STREET, 9B",2011-03-14,2075000,2013-09-04,2895000,820000,905,906.0773480662983
"211 EAST 13TH   STREET, 3F",2014-07-10,1391911,2015-07-13,1725000,333089,368,905.133152173913
"500 PARK AVENUE, 20A",2005-10-03,3384000,2012-01-06,5450000,2066000,2286,903.7620297462818
"220 RIVERSIDE BOULEVARD, 12P/R",2006-09-05,680000,2016-04-13,3850000,3170000,3508,903.6488027366021
"322 WEST 57TH STREET, 40M1",2012-02-02,2000000,2016-01-11,3300000,1300000,1439,903.4051424600417
"255 EAST 74TH   STREET, 14A",2010-05-20,3869350,2014-01-14,5075000,1205650,1335,903.1086142322098
"123 WASHINGTON STREET, 52B",2012-09-11,1675021,2015-12-16,2750000,1074979,1191,902.5852225020991
"250 WEST STREET, 5C",2013-03-01,3325604,2018-08-01,5110993,1785389,1979,902.167256189995
"190 RIVERSIDE DRIVE, 2B",2014-07-24,595888,2017-09-18,1634782,1038894,1152,901.8177083333334
"60 RIVERSIDE BOULEVARD, 1412",2012-09-14,2695297,2016-08-31,4000000,1304703,1447,901.6606772633033
"166 PERRY STREET, 3A",2010-01-11,1635818,2011-06-10,2100000,464182,515,901.3242718446602
"459 WASHINGTON STREET, 4N",2005-10-21,481946,2011-01-10,2200000,1718054,1907,900.9197692711065
"225 5 AVENUE, 7L",2007-01-16,3105662,2016-06-13,6200000,3094338,3436,900.5640279394645
"79 LAIGHT STREET, 3F",2003-08-01,2138325,2014-04-16,5660000,3521675,3911,900.4538481206853
"845 UNITED NATIONS PLAZA, 47A",2004-02-20,2011044,2007-09-06,3175000,1163956,1294,899.5023183925812
"157 CHAMBERS STREET, 6C",2009-05-15,2240150,2014-05-08,3875000,1634850,1819,898.763056624519
"415 GREENWICH STREET, 6D",2010-07-20,2350000,2013-08-28,3370000,1020000,1135,898.6784140969163
"195 HUDSON STREET, 5B",2005-08-17,3265000,2016-11-11,6950000,3685000,4104,897.9044834307992
"15 BROAD STREET, 1404",2006-06-15,666953,2008-01-02,1175000,508047,566,897.6095406360424
"224 EAST 60TH   STREET, 6K",2013-04-18,615000,2013-11-08,798000,183000,204,897.0588235294117
"540 WEST 28TH STREET, 5J",2012-10-25,619708,2014-08-20,1215000,595292,664,896.5240963855422
"200 RIVERSIDE BOULEVARD, 28D",2009-09-10,1500000,2012-07-26,2440000,940000,1050,895.2380952380952
"505 GREENWICH STREET, 2C",2005-01-13,921516,2018-08-01,5350000,4428484,4948,895.0048504446241
"212 EAST 57TH   STREET, 12A",2011-08-18,2450000,2015-02-23,3600000,1150000,1285,894.9416342412451
"502 PARK AVENUE, 12B",2005-03-02,2545625,2012-05-15,4900000,2354375,2631,894.8593690611934
"84 BEDFORD STREET, 1N",2012-09-18,1733775,2017-01-18,3150000,1416225,1583,894.6462413139608
"25 CENTRAL PARK WEST, 11E",2005-03-28,1400000,2010-08-12,3155000,1755000,1963,894.0397350993378
"521 PARK AVENUE, 4B",2016-12-28,3900000,2018-03-21,4300000,400000,448,892.8571428571429
"200 CHAMBERS STREET, 6A",2007-06-19,2459073,2017-06-26,5726000,3266927,3660,892.6030054644809
"230 WEST 56 STREET, 48E",2003-11-03,1415368,2004-05-28,1600000,184632,207,891.9420289855072
"44 MORTON STREET, 1W",2010-12-07,915000,2017-10-17,3150000,2235000,2506,891.8595371109337
"8 GREENE STREET, 6",2011-03-31,1550000,2015-07-01,2935000,1385000,1553,891.8222794591114
"1 MORTON SQUARE, L6A E",2004-09-23,1949948,2012-12-19,4630000,2680052,3009,890.6786307743437
"270 BROADWAY, 17B",2009-10-22,2225000,2014-07-01,3750000,1525000,1713,890.251021599533
"345 WEST 14TH   STREET, 5A",2013-05-31,2418343,2015-08-31,3150000,731657,822,890.0936739659368
"350 WEST 42ND STREET, 49D",2012-04-20,1394250,2015-09-09,2495000,1100750,1237,889.8544866612773
"203 WEST 81ST STREET, 3D",2005-07-26,1365000,2007-09-04,2050000,685000,770,889.6103896103896
"80 RIVERSIDE BOULEVARD, 20C",2011-03-02,3234022,2012-09-04,3725000,490978,552,889.4528985507246
"403 EAST 62ND STREET, 11A",2013-09-16,608750,2015-06-15,1175000,566250,637,888.9324960753532
"240 RIVERSIDE BOULEVARD, 19 A",2006-02-09,4215555,2011-11-30,6100000,1884445,2120,888.8891509433962
"130 WEST 30TH STREET, 7B",2007-08-29,1850000,2008-11-21,2250000,400000,450,888.8888888888889
"203 WEST 90 STREET, 2D",2003-05-09,555507,2005-09-30,1333000,777493,875,888.5634285714285
"45 CHRISTOPHER STREET, 8B",2004-02-27,2725000,2005-08-15,3200000,475000,535,887.8504672897196
"28 LAIGHT STREET, 2D",2003-11-19,1410000,2013-08-29,4580000,3170000,3571,887.7065247829739
"985 PARK AVENUE, PT",2007-12-10,7382312,2012-12-06,9000000,1617688,1823,887.3768513439386
"15 BROAD STREET, 1512",2006-05-17,1053888,2008-09-04,1800000,746112,841,887.1724137931035
"1992 BROADWAY, 20-A",2003-08-12,340041,2004-05-21,591094,251053,283,887.113074204947
"120 WEST 58TH   STREET, PH",2007-11-23,661935,2013-03-13,2380000,1718065,1937,886.9721218378936
"15 CENTRAL PARK WEST, 8H",2008-04-09,1818594,2013-05-22,3475000,1656406,1869,886.2525414660246
"212 WARREN STREET, 5J",2015-07-10,2466710,2016-07-19,2799000,332290,375,886.1066666666667
"146 WEST 57 STREET, 60B",2005-06-07,925000,2007-05-25,1560000,635000,717,885.6345885634588
"81 SPRING STREET, 2A",2005-08-22,2550000,2010-02-09,3995000,1445000,1632,885.4166666666666
"1 MORTON SQUARE, 10D E",2004-12-01,1781937,2007-11-30,2750000,968063,1094,884.8839122486289
"224 EAST 60 STREET, 6F",2004-12-23,250000,2005-06-22,410000,160000,181,883.9779005524862
"220 RIVERSIDE BOULEVARD, 20J",2004-04-21,1876250,2008-04-24,3170000,1293750,1464,883.7090163934427
"56 CROSBY STREET, 3B",2007-05-24,5200000,2015-12-01,7950000,2750000,3113,883.3922261484099
"25 COLUMBUS CIRCLE, ST57G",2004-01-21,2729337,2005-10-28,3300000,570663,646,883.3792569659443
"155 WEST 70TH STREET, 5B",2005-05-12,1365000,2014-06-20,4300000,2935000,3326,882.4413710162357
"80 RIVERSIDE BOULEVARD, 12L",2010-12-14,3186359,2013-07-22,4025000,838641,951,881.8517350157729
"157 EAST 84TH   STREET, 4",2009-08-20,6650000,2016-07-28,8884231,2234231,2534,881.7012628255723
"200 CHAMBERS STREET, 28D",2007-06-29,2443800,2008-08-06,2800000,356200,404,881.6831683168317
"100 READE STREET, 3-A",2009-04-01,995000,2014-03-27,2600000,1605000,1821,881.3838550247117
"150 EAST 85 STREET, 9B",2004-03-04,425880,2004-06-29,529000,103120,117,881.3675213675214
"101 WEST 24TH   STREET, 35C",2009-01-29,2341975,2012-09-05,3500000,1158025,1315,880.6273764258555
"124 8 AVENUE, 14G",2003-08-07,925000,2004-10-06,1300000,375000,426,880.2816901408451
"200 EAST 66TH   STREET, C1105",2011-05-23,2163781,2014-09-10,3225000,1061219,1206,879.9494195688226
"60 RIVERSIDE BOULEVARD, 1802",2011-08-31,1835850,2015-04-16,3000000,1164150,1324,879.2673716012084
"496 LA GUARDIA PLACE, 4B",2004-08-13,370000,2004-11-12,450000,80000,91,879.1208791208791
"322 WEST 57TH   STREET, 15K1",2011-12-06,1527375,2017-04-18,3250000,1722625,1960,878.890306122449
"473 BROADWAY, PH-8W",2004-07-19,2952925,2013-06-03,5800000,2847075,3241,878.4557235421166
"44 WEST 22ND   STREET, PH",2007-08-16,2698362,2009-07-01,3300000,601638,685,878.3036496350365
"170 EAST END AVENUE, M2DUP",2011-11-21,4887600,2017-03-24,6600000,1712400,1950,878.1538461538462
"220 RIVERSIDE BOULEVARD, 12M",2004-08-23,1400000,2006-09-08,2055000,655000,746,878.0160857908847
"184 THOMPSON STREET, 4G",2007-05-23,524398,2007-10-12,649000,124602,142,877.4788732394367
"845 UNITED NATIONS PLAZA, 38C",2003-02-21,1868489,2006-03-27,2860000,991511,1130,877.4433628318584
"25 NORTH MOORE STREET, 11A",2003-01-31,2515078,2015-04-24,6425000,3909922,4466,875.486341244962
"372 BROOME STREET, PH-A",2012-06-07,7127750,2018-05-09,9020000,1892250,2162,875.2312673450509
"79 WORTH STREET, 5B",2010-03-23,1211717,2013-04-26,2200000,988283,1130,874.5867256637168
"43 WEST 64 STREET, 8C",2004-01-12,2255429,2004-12-14,2550000,294571,337,874.0979228486647
"1992 BROADWAY, 22-A",2003-08-12,341499,2004-06-18,612987,271488,311,872.951768488746
"211 EAST 13TH   STREET, 3I",2014-08-20,1570105,2015-11-10,1960000,389895,447,872.248322147651
"101 WEST 67TH   STREET, 45-D",2012-09-06,13625000,2017-02-15,15040000,1415000,1623,871.8422674060382
"100 11TH   AVENUE, 5D",2011-06-30,2850000,2014-04-28,3750000,900000,1033,871.2487899322361
"25 BOND STREET, 4W",2013-12-11,9064425,2018-02-21,10400000,1335575,1533,871.2165688193086
"70 BATTERY PLACE, 28E",2011-06-13,2036500,2014-01-02,2850000,813500,934,870.9850107066381
"1992 BROADWAY, 24-A",2003-08-12,341499,2004-07-14,634878,293379,337,870.5608308605341
"505 GREENWICH STREET, 4D",2010-06-16,2600000,2012-12-21,3400000,800000,919,870.5114254624592
"333 RECTOR PLACE, 404",2011-05-13,1500000,2017-12-20,3600000,2100000,2413,870.285951098218
"120 EAST 87 STREET, P4-D",2003-03-05,620000,2005-10-14,1450000,830000,954,870.020964360587
"200 EAST 65 STREET, 22C",2004-07-29,875000,2005-11-01,1275000,400000,460,869.5652173913044
"311 GREENWICH STREET, 6A",2005-06-21,335000,2005-10-17,437500,102500,118,868.6440677966102
"155 PERRY STREET, 4A",2004-11-19,1225000,2007-12-17,2200000,975000,1123,868.2101513802315
"180 EAST 93RD   STREET, 4",2011-02-16,5060568,2015-08-04,6475000,1414432,1630,867.7496932515337
"60 RIVERSIDE BOULEVARD, 2502",2011-06-23,1998770,2014-05-20,2920000,921230,1062,867.4482109227872
"345 GREENWICH STREET, PHA",2009-12-29,3725000,2017-06-28,6100000,2375000,2738,867.4214755295836
"80 RIVERSIDE BOULEVARD, 9C",2011-01-07,2621993,2014-05-05,3675000,1053007,1214,867.3863261943986
"350 WEST 42ND   STREET, 32D",2006-12-28,1410000,2008-10-10,1975000,565000,652,866.5644171779142
"301 WEST 57TH   STREET, 31C",2009-12-02,2023944,2011-06-28,2520168,496224,573,866.0104712041884
"540 WEST 28TH   STREET, 5B",2012-08-10,979049,2015-03-16,1800000,820951,948,865.9820675105485
"535 WEST END AVENUE, 7B",2010-02-16,7243424,2013-03-25,8224368,980944,1133,865.7934686672551
"101 WARREN STREET, 3110",2009-02-18,3976266,2013-12-16,5500000,1523734,1762,864.7752553916005
"155 PERRY STREET, 8A",2007-11-21,1276824,2016-11-01,4100000,2823176,3268,863.8849449204406
"61 NORTH MOORE STREET, 1E",2004-02-04,219880,2016-04-25,4075000,3855120,4464,863.6021505376344
"230 RIVERSIDE DRIVE, 5D",2008-06-30,529000,2009-10-27,946972,417972,484,863.5785123966942
"25 COLUMBUS CIRCLE, ST61E",2004-01-27,2255294,2015-04-01,5780000,3524706,4082,863.4752572268496
"200 EAST 66TH   STREET, A1002",2013-01-17,1323725,2014-02-28,1675000,351275,407,863.0835380835381
"93 WORTH STREET, 211",2014-04-25,2206548,2017-08-17,3250000,1043452,1210,862.3570247933884
"817 WEST END AVENUE, 7E",2007-12-12,650135,2008-12-23,975000,324865,377,861.710875331565
"279 CENTRAL PARK WEST, 10B",2003-08-12,3325000,2016-07-08,7385000,4060000,4714,861.2643190496394
"31 EAST 28TH   STREET, 3E",2013-07-03,2450000,2015-07-28,3100000,650000,755,860.9271523178808
"25 COLUMBUS CIRCLE, ST63E",2004-02-05,2357121,2006-02-15,2995000,637879,741,860.8353576248313
"80 COLUMBUS CIRCLE, NT65E",2004-04-07,2240150,2014-12-15,5600000,3359850,3904,860.6173155737705
"15 WEST 53RD   STREET, 49E",2007-03-09,1950000,2016-05-31,4850000,2900000,3371,860.2788490062296
"38 DELANCEY STREET, 10D",2012-12-31,800000,2016-06-07,1875000,1075000,1254,857.2567783094099
"1965 BROADWAY, 22H",2003-11-10,1595000,2004-11-12,1910000,315000,368,855.9782608695652
"1992 BROADWAY, 23-A",2003-08-12,341499,2004-07-07,623933,282434,330,855.8606060606061
"1992 BROADWAY, 22-N",2003-08-12,303028,2004-08-12,616089,313061,366,855.3579234972677
"1623 3 AVENUE, 18A",2003-02-20,491538,2004-04-20,855000,363462,425,855.204705882353
"5 EAST 22 STREET, 25M",2004-08-19,1061000,2005-11-17,1450000,389000,455,854.945054945055
"203 WEST 90TH   STREET, 4E",2011-08-19,1344000,2012-11-07,1725000,381000,446,854.2600896860987
"80 RIVERSIDE BOULEVARD, 26B",2011-05-20,2675406,2014-09-04,3700000,1024594,1203,851.6990856192851
"165 CHARLES STREET, RU30",2005-11-23,7314775,2007-01-26,7680000,365225,429,851.3403263403263
"88 LAIGHT STREET, 8",2007-03-08,2215712,2012-08-10,3900000,1684288,1982,849.7921291624622
"372 CENTRAL PARK WEST, 8C",2005-06-29,800000,2008-02-12,1614000,814000,958,849.6868475991649
"415 GREENWICH STREET, 3C",2008-05-20,3054750,2014-06-05,4930000,1875250,2207,849.6828273674671
"416 WASHINGTON STREET, 4G",2005-11-30,2056865,2013-07-15,4420000,2363135,2784,848.8272270114943
"350 WEST 50 STREET, 18F",2003-11-24,680191,2004-10-01,945000,264809,312,848.7467948717949
"212 WARREN STREET, 5E",2015-07-14,1985587,2016-07-19,2300000,314413,371,847.4743935309973
"22 MERCER STREET, PHD",2007-03-09,4582125,2011-08-10,5950000,1367875,1615,846.9814241486068
"1 BOND STREET, 2B",2004-08-04,31000,2009-08-20,1591000,1560000,1842,846.9055374592834
"200 CHAMBERS STREET, 29C",2011-05-20,2400000,2015-11-23,3795000,1395000,1648,846.4805825242719
"145 EAST 48 STREET, 30D",2004-12-29,685000,2005-07-12,850000,165000,195,846.1538461538462
"845 UNITED NATIONS PLAZA, 77A",2005-01-03,3275000,2017-05-24,7100000,3825000,4524,845.4907161803714
"225 LAFAYETTE STREET, 6D",2005-01-19,1949948,2008-01-30,2885000,935052,1106,845.4358047016275
"220 RIVERSIDE BOULEVARD, 5S",2004-08-16,645000,2005-01-05,765000,120000,142,845.0704225352113
"106 CENTRAL PARK SOUTH, 21O",2015-07-22,710000,2016-06-28,999000,289000,342,845.0292397660819
"701 MADISON AVENUE, 7F",2003-06-16,1300000,2005-05-25,1899000,599000,709,844.851904090268
"1965 BROADWAY, 25D",2003-12-23,3000000,2012-01-30,5500000,2500000,2960,844.5945945945946
"300 EAST 77 STREET, 4B",2003-12-30,1145531,2004-06-30,1300000,154469,183,844.0928961748634
"122 GREENWICH AVENUE, PH-C",2011-08-26,4582125,2014-04-21,5400000,817875,969,844.0402476780185
"1 CENTRAL PARK WEST, 47D",2003-06-02,2900000,2016-05-26,6900000,4000000,4742,843.5259384226065
"15 MERCER STREET, 5A",2006-12-15,4350000,2016-11-09,7400000,3050000,3617,843.2402543544374
"217 EAST 7 STREET, 1A",2003-07-17,270000,2005-08-01,899000,629000,746,843.1635388739946
"15 CENTRAL PARK WEST, S706",2008-06-17,794235,2012-02-27,1930000,1135765,1350,841.3074074074074
"101 WARREN STREET, 1520",2008-09-18,3416228,2013-07-18,4900000,1483772,1764,841.140589569161
"900 PARK AVENUE, 15A",2004-01-14,2175000,2007-05-17,3200000,1025000,1219,840.8531583264971
"130 WATTS STREET, 1S",2012-01-30,1375000,2015-01-29,2295000,920000,1095,840.1826484018264
"48 ORCHARD STREET, 2-B",2005-05-26,845197,2006-06-05,1160000,314803,375,839.4746666666666
"57 BOND STREET, 4EAST",2003-10-21,1537558,2008-04-23,2918000,1380442,1646,838.6646415552856
"77 8 AVENUE, 301",2004-01-09,915000,2006-10-31,1775000,860000,1026,838.2066276803118
"200 CHAMBERS STREET, 17D",2007-05-15,2229967,2008-05-01,2525000,295033,352,838.1619318181819
"50 FRANKLIN STREET, 3C",2013-02-25,1125000,2014-10-21,1630000,505000,603,837.4792703150912
"220, 4W",2003-01-15,317889,2003-05-05,410000,92111,110,837.3727272727273
"211 EAST 13TH   STREET, PH E",2014-08-21,1707568,2015-03-09,1875000,167432,200,837.16
"275 WEST 96TH   STREET, 32A",2012-08-13,1525000,2013-05-21,1760000,235000,281,836.2989323843416
"220, 18A",2003-03-13,570220,2003-10-14,750000,179780,215,836.1860465116279
"225 FIFTH AVENUE, 2L",2007-06-26,3322040,2017-07-26,6400000,3077960,3683,835.7208797176215
"130 BARROW STREET, 218",2013-10-07,912500,2014-10-16,1225000,312500,374,835.5614973262032
"275 WEST 96 STREET, 30A",2004-05-21,995000,2006-01-18,1502000,507000,607,835.2553542009884
"240 RIVERSIDE BOULEVARD, 18 A",2006-05-15,4162096,2009-12-08,5250000,1087904,1303,834.9224865694551
"200 CHAMBERS STREET, 18D",2007-05-15,2250332,2008-04-08,2525000,274668,329,834.8571428571429
"15 CENTRAL PARK WEST, 8G",2007-11-20,3665700,2018-02-02,6775000,3109300,3727,834.2634826938556
"260 PARK AVENUE SOUTH, 11B",2006-08-28,2825643,2007-06-29,3080000,254357,305,833.9573770491803
"381 BROOME STREET, 3",2004-01-30,860421,2005-07-26,1313000,452579,543,833.4788213627993
"300 EAST 93RD STREET, 12A",2005-01-11,515000,2005-08-03,685000,170000,204,833.3333333333334
"120 EAST 87 STREET, R10-E",2003-02-26,1955000,2006-08-03,3000000,1045000,1254,833.3333333333334
"476 BROADWAY, 2F",2004-10-27,1578287,2010-06-25,3300000,1721713,2067,832.952588292211
"25 NORTH MOORE STREET, 2B",2005-07-19,2352500,2007-09-05,3000000,647500,778,832.2622107969152
"166 DUANE STREET, 11B",2005-02-25,5100000,2010-11-29,6850000,1750000,2103,832.1445553970518
"173 PERRY STREET, 7N",2003-12-03,2150000,2004-12-16,2465000,315000,379,831.1345646437994
"610 PARK AVENUE, 7F",2004-05-21,2300000,2010-04-26,4100000,1800000,2166,831.0249307479224
"1641 3 AVENUE, 34H",2003-02-20,457468,2003-08-28,614500,157032,189,830.8571428571429
"200 EAST 61ST   STREET, 38F",2010-10-12,895000,2013-05-09,1675000,780000,940,829.7872340425532
"905 WEST END AVENUE, 72",2009-07-23,1771755,2014-06-10,3250000,1478245,1783,829.0773976444195
"583 BROADWAY, 2B",2004-09-29,2850000,2005-09-30,3153334,303334,366,828.7814207650273
"161 HUDSON STREET, 2B",2009-06-30,2410000,2017-05-24,4800000,2390000,2885,828.42287694974
"1 CENTRAL PARK WEST, 28E",2003-02-06,1450000,2010-12-14,3825000,2375000,2868,828.1032078103208
"205 WEST 76TH   STREET, 1202",2012-07-09,2100000,2014-03-05,2600000,500000,604,827.8145695364238
"88 LAIGHT STREET, 2",2007-03-07,1731025,2014-09-09,4000000,2268975,2743,827.187386073642
"225 FIFTH AVENUE, 2B",2007-06-25,1272812,2007-12-20,1420000,147188,178,826.8988764044943
"40 MERCER STREET, 1",2012-04-24,4050000,2014-06-20,4700000,650000,787,825.9212198221093
"5 EAST 22 STREET, 26-C",2004-02-11,999000,2006-02-08,1600000,601000,728,825.5494505494505
"2148 BROADWAY, 6A",2011-08-30,6282602,2012-07-10,6542500,259898,315,825.0730158730158
"2109 BROADWAY, 16-65",2017-10-17,889667,2018-01-26,972937,83270,101,824.4554455445544
"43 EAST 25 STREET, 33BB",2003-05-28,749000,2004-07-27,1100000,351000,426,823.943661971831
"40 BOND STREET, 9B",2007-09-18,5447637,2017-11-09,8500000,3052363,3705,823.8496626180837
"321 WEST 13 STREET, 5C",2003-01-17,675000,2004-06-16,1100000,425000,516,823.6434108527131
"30 CROSBY STREET, 5B",2007-09-21,6200000,2014-06-16,8225000,2025000,2460,823.170731707317
"54 BLEECKER STREET, 6B",2005-02-11,1860000,2013-01-24,4250000,2390000,2904,823.0027548209366
"21 ASTOR PLACE, 7F",2004-03-11,1756481,2011-05-17,3915000,2158519,2623,822.9199390011437
"50 FRANKLIN STREET, 15A",2010-08-09,1967793,2014-02-14,3025000,1057207,1285,822.7291828793774
"825 7 AVENUE, 22B",2003-01-20,85000,2005-01-11,679000,594000,722,822.7146814404432
"444 EAST 57TH   STREET, PHE/F",2007-04-30,3850000,2016-07-25,6625000,2775000,3374,822.4659158269117
"28 EAST 10TH   STREET, 11D",2011-07-06,2189237,2015-11-16,3500000,1310763,1594,822.310539523212
"240 RIVERSIDE BOULEVARD, 27 A",2005-12-22,3951624,2017-05-04,7365000,3413376,4151,822.3020958805107
"845 UNITED NATIONS PLAZA, 62B",2005-04-01,4378475,2008-06-26,5350000,971525,1182,821.9331641285956
"404 EAST 79 STREET, 19F",2004-12-02,520000,2005-04-27,640000,120000,146,821.917808219178
"1992 BROADWAY, 21-A",2003-08-12,341499,2004-06-24,602041,260542,317,821.8990536277603
"353 CENTRAL PARK WEST, 15",2007-02-14,5600000,2013-08-15,7550000,1950000,2374,821.3984835720303
"92 LAIGHT ST, 6D",2005-07-27,2204511,2013-12-04,4710000,2505489,3052,820.933486238532
"220 RIVERSIDE BOULEVARD, 11D",2003-03-25,594912,2005-05-31,1250000,655088,798,820.9122807017544
"181 EAST 90TH   STREET, 17B",2012-02-10,1965000,2014-08-05,2709000,744000,907,820.2866593164277
"15 BROAD STREET, 2310",2006-08-21,1593561,2007-10-30,1950000,356439,435,819.4
"38 DELANCEY STREET, 12B",2012-12-31,780000,2016-07-12,1835000,1055000,1289,818.4639255236617
"220, 8V",2003-02-24,417383,2003-09-11,580000,162617,199,817.1708542713568
"255 EAST 74TH   STREET, 16C",2011-05-03,3518053,2012-05-25,3835000,316947,388,816.8737113402062
"50 MADISON AVENUE, RU 2",2005-09-23,2800187,2011-02-03,4400000,1599813,1959,816.6477794793262
"27 NORTH MOORE STREET, 5B",2004-10-29,1750000,2006-12-28,2395000,645000,790,816.4556962025316
"517 WEST 46TH STREET, 406",2007-11-26,504217,2008-09-16,745000,240783,295,816.2135593220339
"455 MAIN STREET, 12B",2006-04-26,595676,2006-10-26,745000,149324,183,815.9781420765028
"151 EAST 58TH STREET, 43F",2006-03-02,3750000,2013-01-17,5800000,2050000,2513,815.758058097891
"250 WEST STREET, 5B",2013-04-17,3512962,2018-08-01,5089006,1576044,1932,815.7577639751553
"28 EAST 10TH   STREET, 8E",2010-07-14,5200000,2016-08-30,7025000,1825000,2239,815.0960250111657
"56 PINE STREET, 3D",2005-12-19,661862,2006-09-25,890000,228138,280,814.7785714285715
"22 RIVERSIDE DRIVE, 14B",2009-09-16,3200000,2014-08-01,4650000,1450000,1780,814.6067415730337
"1800 ADAM C POWELL BLVD, 1D",2012-07-18,175000,2014-06-12,740000,565000,694,814.1210374639769
"350 WEST 50 STREET, 12E",2003-08-05,622354,2005-10-03,1265500,643146,790,814.1088607594937
"715 PARK AVENUE, 10B",2003-01-22,995000,2007-07-20,2330000,1335000,1640,814.0243902439024
"1992 BROADWAY, 25-A",2003-08-12,341499,2005-01-18,768778,427279,525,813.8647619047618
"15 BROAD STREET, 2520",2006-06-23,1680112,2007-04-20,1925000,244888,301,813.5813953488372
"706 RIVERSIDE DRIVE, 6D",2012-04-17,132000,2014-12-18,925000,793000,975,813.3333333333334
"80 RIVERSIDE BOULEVARD, 16M",2012-04-17,4406431,2014-04-17,5000000,593569,730,813.1082191780822
"144 COLUMBUS AVENUE, 19A",2003-12-19,1750000,2008-09-11,3155000,1405000,1728,813.0787037037037
"170 EAST END AVENUE, 6B/CD",2011-04-27,7891437,2013-11-15,8650000,758563,933,813.0364415862808
"65 WEST 13TH STREET, 11D",2005-11-15,3995000,2018-02-05,7625000,3630000,4465,812.989921612542
"207 EAST 57TH   STREET, 24B",2007-05-23,2341975,2008-06-05,2650000,308025,379,812.730870712401
"1212 5 AVENUE, 12B",2012-01-09,2713636,2016-05-05,3995000,1281364,1578,812.0177439797212
"475 BROADWAY, 4E",2003-07-29,250000,2012-11-20,3010000,2760000,3402,811.2874779541446
"15 WEST 20TH   STREET, 2B",2011-04-11,2200000,2014-06-26,3150000,950000,1172,810.5802047781569
"450 WEST 17TH   STREET, 1508",2008-10-14,1512101,2011-08-15,2350000,837899,1035,809.5642512077295
"330 EAST 38 STREET, 23H",2004-04-29,350000,2004-08-12,435000,85000,105,809.5238095238095
"65 EAST 96TH   STREET, 11B",2013-12-16,2775000,2014-05-23,2902625,127625,158,807.753164556962
"257 WEST 17TH STREET, 5B",2006-08-22,1225000,2007-12-18,1615000,390000,483,807.4534161490683
"330 SPRING STREET, 3D",2013-11-19,1300000,2016-10-07,2150000,850000,1053,807.2174738841405
"188 EAST 76TH   STREET, 9A",2011-06-21,3125000,2015-11-19,4425000,1300000,1612,806.4516129032259
"15 BROAD STREET, 1230",2006-11-15,590585,2008-07-14,1080000,489415,607,806.2850082372323
"40 MERCER STREET, 35",2007-05-31,5243987,2015-01-28,7500000,2256013,2799,806.0067881386209
"350 WEST 50 STREET, 18E",2003-09-30,778961,2004-06-18,990000,211039,262,805.4923664122138
"58 WEST 58TH STREET, 2200",2013-05-13,1925000,2014-10-23,2350000,425000,528,804.9242424242424
"115 4 AVENUE, 7E",2003-08-07,740000,2005-11-04,1400000,660000,820,804.8780487804878
"220, 44D",2003-05-09,2021227,2003-09-19,2128143,106916,133,803.8796992481203
"195 HUDSON STREET, 4A",2003-09-16,1750000,2007-08-17,2900000,1150000,1431,803.633822501747
"516 WEST 47TH STREET, S5M",2006-05-22,510000,2006-09-21,608000,98000,122,803.2786885245902
"301 EAST 79 STREET, 0.7083333333333334",2005-03-22,290000,2006-04-12,600000,310000,386,803.1088082901555
"1 MORTON SQUARE, 9A W",2004-11-22,1919401,2007-01-17,2550000,630599,786,802.2888040712468
"58 WALKER STREET, 5",2004-09-29,925000,2016-12-12,4500000,3575000,4457,802.109041956473
"25 CENTRAL PARK WEST, 7U",2005-02-25,61482,2007-09-20,813000,751518,937,802.0469583778015
"147 WAVERLY PLACE, 1W",2008-06-13,1476462,2013-08-20,2995000,1518538,1894,801.7624076029567
"415 GREENWICH STREET, 6F",2010-07-30,3350000,2017-05-31,5350000,2000000,2497,800.9611533840608
"845 UNITED NATIONS PLAZA, 41A",2003-08-26,1900000,2008-04-07,3250000,1350000,1686,800.711743772242
"181 EAST 65TH   STREET, 5A",2010-04-13,4150000,2015-12-04,5800000,1650000,2061,800.5822416302766
"101 WARREN STREET, 1850",2008-10-31,2683088,2014-07-15,4350000,1666912,2083,800.2457993278924
"1760 2 AVENUE, 23C",2004-01-06,845148,2005-02-15,1170000,324852,406,800.128078817734
"23 WEST 116TH STREET, 5C",2015-01-30,725503,2016-11-22,1255000,529497,662,799.8444108761329
"311 WEST BROADWAY, 6G",2011-01-05,2150000,2014-01-10,3030000,880000,1101,799.2733878292462
"415 GREENWICH STREET, TH-C",2009-04-15,3314403,2015-10-01,5200000,1885597,2360,798.981779661017
"340 EAST 64 STREET, 9L",2004-10-19,1412500,2006-10-25,2000000,587500,736,798.2336956521739
"252 7 AVENUE, 15H",2003-06-10,1350000,2006-06-29,2240000,890000,1115,798.2062780269058
"300 EAST 23RD STREET, 10D",2011-07-01,1577905,2013-07-19,2175000,597095,749,797.1895861148198
"103 WEST 89TH   STREET, 3/GA",2012-02-28,1850000,2017-10-23,3495000,1645000,2064,796.9961240310078
"350 WEST 42ND   STREET, 48H",2011-05-31,900000,2011-09-21,990000,90000,113,796.4601769911504
"1619 3 AVENUE, 9H",2003-02-20,399619,2003-12-29,648000,248381,312,796.0929487179487
"230 WEST 56 STREET, 52F",2003-04-04,1237174,2004-12-07,1725000,487826,613,795.8009787928222
"188 EAST 64TH STREET, 2602",2011-08-15,585000,2015-08-18,1750000,1165000,1464,795.7650273224044
"207 EAST 57TH   STREET, 3435B",2007-01-18,4047543,2013-08-05,5950000,1902457,2391,795.6741948975324
"27 WEST 72ND   STREET, 1502",2007-06-18,4582125,2011-10-06,5831517,1249392,1571,795.2845321451305
"200 EAST 32ND STREET, 25B",2004-09-27,800000,2008-01-24,1765000,965000,1214,794.8929159802307
"51 WALKER STREET, 3B",2007-05-23,1149427,2015-06-30,3500000,2350573,2960,794.1125
"1 MORTON SQUARE, L4B E",2004-09-24,2336883,2007-11-19,3250000,913117,1151,793.3249348392702
"147 WAVERLY PLACE, 2E",2008-06-17,2596537,2010-09-03,3237500,640963,808,793.2710396039604
"240 RIVERSIDE BOULEVARD, 28 A",2006-02-27,3998667,2017-06-27,7280724,3282057,4138,793.1505558240696
"60 ORCHARD STREET, 3",2011-10-17,1018250,2013-04-01,1440000,421750,532,792.7631578947369
"768 5 AVENUE, 1613",2007-06-18,7221392,2013-08-12,9000000,1778608,2247,791.5478415665332
"56 PINE STREET, 9D",2006-01-09,430950,2006-07-10,575000,144050,182,791.4835164835165
"1623 3 AVENUE, 7A",2003-02-20,454983,2005-03-18,1054000,599017,757,791.3038309114927
"161 GRAND STREET, 7B",2005-01-07,1950000,2006-08-31,2425000,475000,601,790.3494176372712
"50 WEST 15TH   STREET, 5D",2009-06-30,1688810,2011-08-06,2295000,606190,767,790.3389830508474
"502 PARK AVENUE, 15G",2004-11-15,2219785,2011-01-10,3995000,1775215,2247,790.0378282153983
"53 WARREN STREET, 3",2009-08-19,1600000,2014-06-27,3000000,1400000,1773,789.6221094190637
"823 PARK AVENUE, 4",2007-12-21,11200750,2015-06-05,13350000,2149250,2723,789.2948953360265
"157 EAST 32 STREET, 10B",2004-01-27,695000,2005-08-26,1150000,455000,577,788.5615251299827
"173 PERRY STREET, 12N",2004-08-25,3054750,2013-02-21,5500000,2445250,3102,788.2817537072856
"101 WARREN STREET, 2460",2008-12-11,3066816,2016-07-14,5250000,2183184,2772,787.5844155844156
"101 WARREN STREET, 2250",2008-11-14,2947833,2012-07-12,4000000,1052167,1336,787.5501497005988
"350 WEST 42ND   STREET, 34A",2012-10-05,1045000,2014-05-06,1500000,455000,578,787.19723183391
"1641 3 AVENUE, 2A",2003-02-20,401037,2005-07-27,1100000,698963,888,787.1204954954954
"5 EAST 17TH STREET, 5",2005-04-29,4000000,2006-08-07,4366000,366000,465,787.0967741935484
"157 CHAMBERS STREET, 15A",2010-04-06,3500000,2016-05-09,5250000,1750000,2225,786.5168539325842
"555 WEST 59TH STREET, 32A",2011-10-21,2465000,2015-05-29,3500000,1035000,1316,786.4741641337386
"400 EAST 51 STREET, 19A",2003-07-21,1921113,2006-11-15,2875000,953887,1213,786.3866446826052
"25 COLUMBUS CIRCLE, ST65B",2005-03-15,4384816,2018-06-28,8200000,3815184,4853,786.1495981866886
"340 WEST 57TH   STREET, 14B",2014-12-05,1400000,2016-09-21,1915000,515000,656,785.060975609756
"845 UNITED NATIONS PLAZA, 75B",2004-04-12,3600000,2015-08-14,6850000,3250000,4141,784.8345810190775
"641 FIFTH AVENUE, 27E",2007-03-29,2400000,2017-09-13,5395000,2995000,3821,783.8262235017012
"455 CENTRAL PARK WEST, 15",2005-01-24,5880393,2012-09-20,8070000,2189607,2796,783.1212446351931
"1641 3 AVENUE, 25F",2003-02-20,418782,2003-11-04,620000,201218,257,782.9494163424124
"311 GREENWICH STREET, 2D",2011-02-18,2160000,2014-07-31,3145000,985000,1259,782.3669579030977
"393 WEST 49 STREET, 4P",2003-12-29,258000,2004-04-08,337000,79000,101,782.1782178217821
"845 UNITED NATIONS PLAZA, 80B",2005-09-15,4818422,2007-01-16,5200000,381578,488,781.922131147541
"845 UNITED NATIONS PLAZA, 77C",2005-04-05,4000000,2010-07-07,5500000,1500000,1919,781.657113079729
"220 EAST 65TH   STREET, 21A",2013-08-12,780000,2014-04-25,980000,200000,256,781.25
"300 EAST 23RD   STREET, 3A/B",2012-12-03,2145000,2014-12-22,2730000,585000,749,781.0413885180241
"72 MERCER STREET, 2W",2008-01-03,3000000,2011-06-30,3995000,995000,1274,781.0047095761381
"120 RIVERSIDE BOULEVARD, 6F",2006-05-08,945954,2008-03-03,1465000,519046,665,780.5203007518797
"450 EAST 83RD STREET, 9E",2006-06-09,1583378,2008-01-28,2050000,466622,598,780.304347826087
"63 WEST 17 STREET, 4A",2003-12-05,1257539,2005-04-21,1650000,392461,503,780.2405566600397
"305 EAST 51ST STREET, RU20C",2016-07-05,1197351,2017-08-29,1525000,327649,420,780.1166666666667
"1 RIVER TERRACE, 24D",2010-04-12,2366413,2017-03-29,4350000,1983587,2543,780.0184821077468
"429 GREENWICH STREET, 2A",2005-07-21,1475000,2008-12-22,2450000,975000,1250,780.0
"80 RIVERSIDE BOULEVARD, 36B",2010-11-30,2774731,2015-01-15,3950000,1175269,1507,779.8732581287326
"15 BROAD STREET, 2528",2006-12-06,539672,2007-09-21,765000,225328,289,779.6816608996539
"53 GREENE STREET, 3",2014-11-04,6000000,2017-06-23,6750000,750000,962,779.6257796257796
"10 WEST STREET, 32G",2005-06-27,5100000,2014-02-03,7550000,2450000,3143,779.5100222717149
"120 EAST 87 STREET, P16-D",2003-07-31,2150000,2006-07-27,3000000,850000,1092,778.3882783882784
"900 PARK AVENUE, 25A/B",2003-04-01,2400000,2015-06-24,5875000,3475000,4467,777.927020371614
"400 FIFTH AVENUE, 33H",2012-05-08,1389911,2013-08-21,1755000,365089,470,776.7851063829787
"54 WEST 74 STREET, 503",2003-01-10,200000,2004-07-30,640000,440000,567,776.0141093474426
"25 CENTRAL PARK WEST, 4E",2003-11-18,336272,2015-05-27,3600000,3263728,4208,775.6007604562737
"421 HUDSON STREET, 812",2003-02-13,104634,2013-09-10,3100000,2995366,3862,775.5996892801658
"333 WEST 56 STREET, 7B",2005-05-05,680000,2006-01-31,890000,210000,271,774.9077490774907
"21 EAST 96TH   STREET, 2",2006-02-06,2350000,2014-10-06,4800000,2450000,3164,774.3362831858407
"1 MORTON SQUARE, 14A W",2004-12-16,2224876,2007-05-07,2899250,674374,872,773.3646788990826
"540 WEST 28TH   STREET, 4F",2012-08-10,685260,2014-01-29,1100000,414740,537,772.3277467411546
"137 READE STREET, 3B",2008-12-12,2500000,2015-09-03,4395000,1895000,2456,771.5798045602606
"15 CENTRAL PARK WEST, 7M",2007-12-03,3462050,2017-10-25,6250000,2787950,3614,771.4305478693968
"47 MURRAY STREET, 4",2011-09-15,2412000,2013-11-19,3025000,613000,796,770.1005025125628
"101 WARREN STREET, 11G",2008-09-02,2586355,2015-06-23,4500000,1913645,2485,770.0784708249497
"57 BOND STREET, 5WEST",2003-11-05,1359364,2012-12-20,3925000,2565636,3333,769.7677767776778
"2101 BROADWAY, 13-79",2003-01-22,1305000,2005-07-13,2000000,695000,903,769.656699889258
"70 LITTLE WEST STREET, 28A",2012-04-25,1995000,2016-08-09,3200000,1205000,1567,768.9853222718571
"155 PERRY STREET, 6A",2009-04-30,1725000,2014-08-01,3200000,1475000,1919,768.6294945284002
"22 MERCER STREET, PHB",2011-11-01,5200000,2017-06-12,6775000,1575000,2050,768.2926829268292
"321 CATHEDRAL PARKWAY, 14B",2014-12-08,1482572,2015-07-01,1640000,157428,205,767.9414634146342
"704 BROADWAY, 9FL",2004-06-23,5750000,2012-12-12,8125000,2375000,3094,767.6147382029735
"530 EAST 76 STREET, 25H",2004-03-01,880000,2006-02-09,1425000,545000,710,767.6056338028169
"10 WEST END AVENUE, 28A",2007-12-20,1615724,2017-07-17,4300000,2684276,3497,767.5939376608521
"2109 BROADWAY, 10142",2010-05-20,2565000,2011-12-08,3000000,435000,567,767.1957671957672
"1 CENTRAL PARK WEST, 33B",2003-12-23,2400000,2009-08-07,3975000,1575000,2054,766.7964946445959
"160 WEST 86 STREET, 16A",2003-05-09,1850000,2006-05-15,2695000,845000,1102,766.7876588021778
"322 WEST 57TH   STREET, 49U1",2010-03-31,1918800,2017-12-11,4075000,2156200,2812,766.7852062588905
"252 SEVENTH AVENUE, 15J",2010-09-29,1710000,2012-04-25,2150000,440000,574,766.5505226480836
"36 GRAMERCY PARK EAST, 6W",2010-11-16,2497869,2013-05-01,3185000,687131,897,766.0323299888518
"715 PARK AVENUE, 7A",2006-06-29,2500000,2011-04-07,3835000,1335000,1743,765.92082616179
"101 WEST 87TH   STREET, 210",2014-02-06,224672,2015-07-27,635000,410328,536,765.5373134328358
"1641 3 AVENUE, 11A",2003-02-20,426608,2005-05-23,1056586,629978,823,765.4653705953828
"322 WEST 57TH   STREET, 43F2",2011-12-02,1642000,2013-09-26,2150000,508000,664,765.0602409638554
"58 WEST 58 STREET, 2200",2004-02-09,712775,2006-11-21,1490000,777225,1016,764.9852362204724
"101 WEST 24TH   STREET, 35E",2008-10-03,2469256,2014-03-28,4000000,1530744,2002,764.6073926073926
"425 5 AVENUE, 19A",2004-05-28,615000,2005-01-25,800000,185000,242,764.4628099173553
"165 CHARLES STREET, RU27",2005-09-29,7300852,2015-06-01,10000000,2699148,3532,764.19818799547
"225 LAFAYETTE STREET, 6B",2005-01-12,1094618,2007-06-28,1780000,685382,897,764.082497212932
"150 NASSAU STREET, 3H",2003-03-14,329550,2004-04-30,645000,315450,413,763.8014527845037
"400 EAST 51 STREET, 17A",2003-04-14,1756481,2006-03-01,2560000,803519,1052,763.8013307984791
"160 CENTRAL PARK SOUTH, 809",2007-05-14,3512962,2016-04-06,5995000,2482038,3250,763.704
"45 WEST 67TH   STREET, 15ABC",2011-12-09,8300000,2015-03-02,9200000,900000,1179,763.3587786259542
"85 LEONARD STREET, 3",2010-03-01,2000000,2017-07-28,4065000,2065000,2706,763.1189948263119
"200 EAST 58TH STREET, 16D",2004-09-14,365000,2005-03-22,509000,144000,189,761.9047619047619
"500 PARK AVENUE, 12",2004-11-15,3900000,2007-01-12,4500000,600000,788,761.4213197969543
"220 RIVERSIDE BOULEVARD, 31AT",2004-12-15,2900000,2007-08-27,3650000,750000,985,761.4213197969543
"50 BAYARD STREET, 8E",2016-03-29,600000,2017-05-30,925000,325000,427,761.1241217798595
"1992 BROADWAY, 24-N",2003-08-12,303028,2004-10-12,627937,324909,427,760.9110070257611
"151 WEST 17 STREET, PHB",2003-09-16,2036500,2006-06-16,2800000,763500,1004,760.4581673306773
"583 BROADWAY, 2M",2007-08-08,5950000,2016-01-28,8300000,2350000,3095,759.2891760904685
"1992 BROADWAY, 25-N",2003-08-12,303028,2004-12-29,686300,383272,505,758.9544554455446
"160 CENTRAL PARK SOUTH, 1903",2004-11-18,2462500,2016-06-28,5680000,3217500,4240,758.8443396226415
"1641 3 AVENUE, 20A",2003-02-20,479471,2005-05-18,1100000,620529,818,758.5929095354523
"200 EAST 66TH   STREET, B1405",2012-09-07,2336883,2015-09-17,3175000,838117,1105,758.4769230769231
"285 LAFAYETTE STREET, 4E",2004-04-14,2540000,2018-08-01,6500000,3960000,5222,758.3301417081578
"382 CENTRAL PARK WEST, 19K",2003-10-03,572000,2015-03-26,3750000,3178000,4192,758.1106870229007
"1641 3 AVENUE, 20K",2003-02-20,403877,2004-01-20,657000,253123,334,757.8532934131737
"1 LEROY STREET, 5B",2004-03-02,2600000,2010-09-03,4400000,1800000,2376,757.5757575757576
"10 WEST STREET, PH1B",2003-04-18,4276650,2009-03-25,5918000,1641350,2168,757.080258302583
"250 EAST 40 STREET, 37B",2003-03-17,420000,2004-10-05,850000,430000,568,757.0422535211268
"330 EAST 38TH   STREET, 20A",2013-10-17,999500,2014-08-11,1225000,225500,298,756.7114093959732
"1992 BROADWAY, 23-N",2003-08-12,303028,2004-09-27,614769,311741,412,756.6529126213592
"333 EAST 34 STREET, 15J",2004-01-09,441090,2004-06-01,550000,108910,144,756.3194444444445
"15 CENTRAL PARK WEST, 2E",2008-07-25,4022087,2018-08-15,6800000,2777913,3673,756.3062891369452
"140 7 AVENUE, 4E",2003-01-31,495000,2004-07-13,895000,400000,529,756.1436672967864
"1 RIVER TERRACE, 11R",2010-08-16,3054750,2015-05-29,4375000,1320250,1747,755.7240984544934
"21 SOUTH END AVENUE, 637",2015-10-08,708702,2017-01-25,1067500,358798,475,755.3642105263158
"360 EAST 88 STREET, 31A",2003-02-21,902000,2004-09-03,1325000,423000,560,755.3571428571429
"400 WEST 12TH   STREET, 3A",2010-04-30,2024790,2014-09-05,3225000,1200210,1589,755.3241032095658
"303 EAST 43RD   STREET, 25A",2015-10-01,1298268,2017-02-28,1688000,389732,516,755.2945736434109
"30 WEST 63RD STREET, 8C",2009-12-10,840056,2014-08-28,2140000,1299944,1722,754.9036004645761
"1 MT MORRIS PARK WEST, 5D",2006-03-06,291600,2008-06-30,931000,639400,847,754.8996458087368
"111 WEST 67TH   STREET, 25-DH",2007-01-24,10700000,2013-08-07,12500000,1800000,2387,754.084625052367
"250 WEST STREET, 7F",2013-04-10,2835826,2018-01-17,4150000,1314174,1743,753.9724612736661
"123 WASHINGTON STREET, 35A",2013-09-19,1380671,2014-07-07,1600000,219329,291,753.7079037800687
"15 CHARLES STREET, 6C",2004-07-02,735000,2005-08-24,1050000,315000,418,753.5885167464115
"944 PARK AVENUE, 14",2006-11-03,8750000,2016-11-01,11500000,2750000,3651,753.2182963571624
"15 WEST 53RD   STREET, 23A",2009-07-07,3200000,2016-01-22,5000000,1800000,2390,753.1380753138076
"1 IRVING PLACE, V12B",2008-02-27,950000,2015-08-13,3000000,2050000,2724,752.5697503671072
"43 WEST 64TH STREET, 8D",2006-06-23,2200000,2015-03-19,4600000,2400000,3191,752.1153243497337
"103 GREENE STREET, 2A",2007-05-17,3500000,2010-04-15,4300000,800000,1064,751.8796992481203
"106 CENTRAL PARK SOUTH, 19O",2013-09-04,432500,2014-06-27,655000,222500,296,751.6891891891892
"322 WEST 57TH   STREET, 53S",2014-01-24,1221900,2018-03-19,2360000,1138100,1515,751.2211221122112
"2 CORNELIA STREET, 41064",2003-10-14,960625,2011-06-29,3075000,2114375,2815,751.1101243339255
"2 COLUMBUS AVENUE, PHA",2005-05-18,3450000,2008-09-15,4362500,912500,1216,750.4111842105264
"170 EAST 87TH STREET, W12C",2012-05-22,2275000,2014-11-21,2960000,685000,913,750.2738225629791
"1 CENTRAL PARK WEST, 26A",2006-05-15,6300000,2016-12-15,9200000,2900000,3867,749.9353504008275
"500 WEST END AVENUE, 11D",2011-03-18,2851100,2014-04-23,3700000,848900,1132,749.9116607773851
"322 WEST 57TH   STREET, 15P3",2012-10-17,2621993,2015-06-15,3350000,728007,971,749.7497425334707
"135 WEST 70TH   STREET, 10C",2009-01-06,978295,2016-12-14,3150000,2171705,2899,749.1221110727837
"325 WEST 13TH STREET, 1",2009-07-20,1527375,2012-05-17,2300000,772625,1032,748.6676356589147
"199 MOTT STREET, 5A",2015-09-17,2978837,2017-01-25,3350000,371163,496,748.3125
"15 WILLIAM STREET, PH-3",2009-09-03,2670207,2016-05-16,4500000,1829793,2447,747.7699223539028
"155 WEST 70TH STREET, 12D",2008-09-04,1265000,2010-02-01,1650000,385000,515,747.5728155339806
"330 SPRING STREET, 8A",2013-04-04,2650000,2014-07-10,2995000,345000,462,746.7532467532468
"1992 BROADWAY, 21-J",2003-08-12,223869,2004-05-24,437289,213420,286,746.2237762237762
"768 FIFTH AVENUE, 1303",2007-08-06,8365963,2010-11-04,9250000,884037,1186,745.393760539629
"181 SEVENTH AVENUE, 16B",2008-12-31,228150,2015-11-17,2100000,1871850,2512,745.1632165605096
"77 READE STREET, 5A/5C",2012-07-24,3800000,2018-06-11,5400000,1600000,2148,744.8789571694599
"478 CENTRAL PARK WEST, 6C",2016-09-22,570220,2017-10-23,865000,294780,396,744.3939393939394
"610 PARK AVENUE, 6B",2006-05-31,4900000,2012-04-20,6500000,1600000,2151,743.8400743840075
"408 EAST 79TH   STREET, 3A",2015-09-18,1875000,2017-03-09,2275000,400000,538,743.4944237918215
"39 NORTH MOORE STREET, 3B",2003-08-29,498000,2013-12-23,3300000,2802000,3769,743.4332714247811
"1601 3 AVENUE, 20A",2003-02-20,522109,2005-07-14,1172500,650391,875,743.304
"1623 3 AVENUE, 8A",2003-02-20,457821,2005-02-04,989000,531179,715,742.9076923076923
"15 RENWICK STREET, 201",2016-02-22,2599592,2017-08-21,3005000,405408,546,742.5054945054945
"252 7 AVENUE, 17D",2003-07-02,1850000,2013-09-09,4612000,2762000,3722,742.0741536808167
"300 EAST 77 STREET, 18C",2005-09-16,1741207,2006-04-18,1900000,158793,214,742.0233644859813
"111 WEST 67TH   STREET, 34-C",2010-12-08,1737500,2013-05-20,2400000,662500,894,741.0514541387024
"168 DUANE STREET, 2S",2003-01-30,860000,2018-05-11,4995000,4135000,5580,741.0394265232975
"150 EAST 86TH   STREET, 17J",2010-06-21,5880393,2015-07-15,7250000,1369607,1850,740.3281081081082
"34 GREENE STREET, 3S",2011-04-06,3525690,2016-02-08,4835000,1309310,1769,740.1413227812324
"421 WEST 54TH   STREET, PHC",2008-12-18,4403931,2015-08-14,6200000,1796069,2430,739.1230452674897
"415 GREENWICH STREET, 3G",2008-06-06,3360225,2016-05-13,5500000,2139775,2898,738.3626639061422
"200 EAST 66TH   STREET, D0203",2013-07-12,2392887,2015-11-12,3022500,629613,853,738.116060961313
"80 PARK AVENUE, 3M",2003-06-30,295000,2004-01-26,450000,155000,210,738.0952380952381
"50 FRANKLIN STREET, 9C",2011-10-24,1215000,2013-11-08,1765000,550000,746,737.2654155495978
"65 WEST 13TH   STREET, 8D",2009-04-21,2200000,2016-08-22,4175000,1975000,2680,736.9402985074627
"200 EAST 69TH STREET, 15B",2010-03-09,1400000,2014-07-21,2575000,1175000,1595,736.6771159874609
"415 GREENWICH STREET, 7D",2011-02-18,2400000,2017-07-06,4115000,1715000,2330,736.0515021459228
"224 WEST 18 STREET, 4B",2003-07-02,748414,2005-07-15,1295000,546586,744,734.6586021505376
"225 WEST 60TH STREET, 15A",2017-10-18,900000,2018-05-10,1049850,149850,204,734.5588235294117
"114 LIBERTY STREET, 9",2006-01-20,4335000,2018-05-31,7650000,3315000,4514,734.3819229065131
"15 WEST 63RD STREET, 25A",2006-04-04,5400000,2018-07-25,8700000,3300000,4495,734.1490545050056
"1641 3 AVENUE, 20G",2003-02-20,261917,2003-09-03,405000,143083,195,733.7589743589743
"80 RIVERSIDE BOULEVARD, 26A",2009-10-07,3053987,2014-03-25,4250000,1196013,1630,733.7503067484663
"220 RIVERSIDE BOULEVARD, 19L",2011-01-12,2000000,2014-10-07,3000000,1000000,1364,733.1378299120234
"471 WASHINGTON STREET, 4A",2011-11-23,2031408,2014-02-28,2638000,606592,828,732.5990338164252
"173 PERRY STREET, 8N",2003-09-04,2600000,2016-10-04,6100000,3500000,4779,732.370788867964
"5 EAST 22ND   STREET, 8-F",2012-01-31,900000,2015-04-21,1760000,860000,1176,731.2925170068028
"1080 MADISON AVENUE, 15B",2005-01-26,1400000,2006-07-27,1800000,400000,547,731.2614259597806
"610 PARK AVENUE, 8C",2010-03-25,3875000,2016-02-18,5450000,1575000,2156,730.5194805194806
"610 CATHEDRAL PARKWAY, 7A",2011-05-10,610950,2015-07-15,1725000,1114050,1527,729.5677799607073
"160 WOOSTER STREET, 5A",2005-02-08,2571081,2015-11-12,5435625,2864544,3929,729.0771188597607
"175 WEST 12TH STREET, 19C",2009-07-29,950000,2015-06-15,2515000,1565000,2147,728.9240801117838
"1 MORTON SQUARE, 12B W",2004-12-10,2520168,2017-06-14,5850000,3329832,4569,728.7879185817466
"165 CHAMBERS STREET, 8C",2004-06-18,340000,2005-01-10,490000,150000,206,728.1553398058253
"220 RIVERSIDE BOULEVARD, 12D",2004-09-20,995000,2005-11-14,1300000,305000,420,726.1904761904761
"330 EAST 38 STREET, 37E",2003-11-06,900000,2004-12-06,1187500,287500,396,726.010101010101
"150 NASSAU STREET, 15D",2004-01-21,1017232,2005-08-05,1425000,407768,562,725.5658362989324
"7 HUBERT STREET, 3C",2004-09-09,1680112,2014-12-15,4400000,2719888,3749,725.4969325153374
"330 SPRING STREET, 4C",2016-01-19,2000000,2016-10-14,2195000,195000,269,724.907063197026
"1623 THIRD AVENUE, 42K",2005-08-09,905000,2006-11-28,1250000,345000,476,724.7899159663865
"230 WEST 56 STREET, 55F",2003-04-25,1420459,2006-07-24,2280000,859541,1186,724.739460370995
"127 7 AVENUE, 7B",2011-05-12,2150000,2015-07-08,3250000,1100000,1518,724.6376811594203
"80 PARK AVENUE, 16J",2004-06-18,1060000,2009-01-20,2275000,1215000,1677,724.5080500894454
"85 LEONARD STREET, 2",2009-01-21,2225000,2015-07-30,3950000,1725000,2381,724.4855102897942
"201 EAST 36 STREET, 3D",2003-12-11,440000,2004-08-26,627500,187500,259,723.9382239382239
"415 GREENWICH STREET, 2C",2008-08-26,2952925,2014-09-04,4545000,1592075,2200,723.6704545454545
"530 EAST 76TH STREET, 18H",2005-04-29,900000,2007-08-20,1510000,610000,843,723.6061684460261
"392 CENTRAL PARK WEST, 8F",2008-12-23,148786,2010-03-19,475000,326214,451,723.3126385809313
"330 SPRING STREET, 10C",2011-04-08,1700000,2014-09-04,2600000,900000,1245,722.8915662650602
"1485 FIFTH AVENUE, 24E",2012-06-29,1285000,2015-03-09,1995000,710000,983,722.2787385554425
"1641 3 AVENUE, 7F",2003-02-20,363774,2004-02-03,615000,251226,348,721.9137931034483
"21 ASTOR PLACE, 6D",2004-03-10,1751425,2016-11-21,5100000,3348575,4639,721.8312136236258
"1623 3 AVENUE, 19C",2003-02-20,259077,2003-10-01,420000,160923,223,721.6278026905829
"1485 FIFTH AVENUE, 13C",2012-06-19,945000,2015-01-19,1625000,680000,944,720.3389830508474
"166 DUANE STREET, 9A",2004-12-17,3550000,2008-07-28,4500000,950000,1319,720.2426080363912
"330 EAST 38 STREET, PHA",2004-09-28,880000,2006-09-20,1400000,520000,722,720.2216066481994
"15 EAST 26TH STREET, 19A",2008-11-07,4429387,2011-12-22,5250000,820613,1140,719.8359649122807
"505 GREENWICH STREET, 12D",2005-04-12,2952925,2007-06-26,3531937,579012,805,719.2695652173913
"333 RECTOR PLACE, 606",2011-08-08,2130000,2013-10-09,2700000,570000,793,718.7894073139975
"408 EAST 79TH STREET, 14C",2005-12-09,1705568,2006-11-28,1960000,254432,354,718.7344632768362
"215 WEST 90TH   STREET, 9-E",2013-01-25,2189237,2015-06-26,2823063,633826,882,718.6235827664399
"225 FIFTH AVENUE, 10A",2010-03-08,1650000,2013-05-29,2495000,845000,1178,717.3174872665535
"527 BROOME STREET, 7",2003-08-19,1675000,2014-01-14,4400000,2725000,3801,716.9166008945015
"55 WEST 76TH   STREET, 6",2013-06-03,610950,2018-04-30,1895000,1284050,1792,716.5457589285714
"350 WEST 42ND   STREET, 37A",2011-03-30,298000,2015-06-16,1400000,1102000,1539,716.0493827160494
"150 CHARLES STREET, 6DS",2016-12-07,5727656,2018-05-11,6100000,372344,520,716.0461538461539
"123 3 AVENUE, 2A",2011-07-13,1221900,2014-05-30,1975000,753100,1052,715.8745247148289
"146 WEST 57TH STREET, 46C",2012-11-07,1538000,2013-11-08,1800000,262000,366,715.8469945355191
"25 CENTRAL PARK WEST, 2S",2013-12-19,1325000,2015-09-09,1775000,450000,629,715.4213036565977
"32 WEST 18TH   STREET, 11B",2007-08-02,4378475,2015-09-15,6500000,2121525,2966,715.2815239379636
"302 WEST 12TH STREET, 2G",2006-01-11,519367,2010-12-08,1800000,1280633,1792,714.6389508928571
"220, 14A",2003-04-10,585000,2003-09-18,700000,115000,161,714.2857142857143
"382 LAFAYETTE STREET, 2",2004-06-01,1425000,2005-08-31,1750000,325000,456,712.719298245614
"93 WORTH STREET, 210",2014-05-09,1857288,2017-01-05,2550000,692712,972,712.6666666666666
"15 BROAD STREET, 2602",2006-06-15,721175,2007-02-21,900000,178825,251,712.4501992031873
"417 MANHATTAN AVENUE, B-6",2014-02-13,467454,2015-06-30,825000,357546,502,712.2430278884462
"220, 14L",2003-01-22,1111500,2004-01-27,1375000,263500,370,712.1621621621622
"53 WARREN STREET, 1",2012-05-31,2291062,2017-01-20,3498000,1206938,1695,712.0578171091446
"2554 FREDRICK DOUGLASS BL, 2554B",2017-04-06,540000,2018-02-09,760000,220000,309,711.9741100323624
"2101 BROADWAY, 27454",2003-09-03,999500,2007-02-12,1895000,895500,1258,711.8441971383148
"345 WEST 13TH   STREET, 2A",2009-08-06,3400000,2014-01-22,4560000,1160000,1630,711.6564417177914
"203 WEST 90TH STREET, 9H",2013-08-06,1875000,2015-08-14,2400000,525000,738,711.3821138211382
"7 HUBERT STREET, 8A",2007-05-11,6450000,2010-08-18,7300000,850000,1195,711.2970711297071
"112 WEST 56TH STREET, PHN",2009-08-27,1250000,2011-10-10,1800000,550000,774,710.594315245478
"846 2 AVENUE, 3A",2004-09-29,395000,2005-03-17,515000,120000,169,710.0591715976332
"251 WEST 19TH STREET, 3A",2011-03-22,1589371,2013-12-17,2300000,710629,1001,709.9190809190809
"279 CENTRAL PARK WEST, 3B",2004-08-19,3880000,2016-06-22,6950000,3070000,4325,709.8265895953757
"24 WEST 45 STREET, 9",2003-07-15,865000,2006-01-31,1525000,660000,931,708.9151450053706
"151 WEST 21ST STREET, 3E",2014-10-14,1616471,2017-06-30,2318000,701529,990,708.6151515151515
"56 LEONARD STREET, 19AE",2016-07-08,2809868,2018-01-10,3200000,390132,551,708.043557168784
"350 WEST 42ND STREET, 11F",2006-09-18,598731,2007-05-18,770000,171269,242,707.7231404958678
"165 CHARLES STREET, RU31",2005-12-21,20605000,2017-12-12,23700000,3095000,4374,707.5903063557384
"241 5 AVENUE, 6A",2013-09-19,850238,2015-06-24,1305000,454762,643,707.2503888024884
"459 WEST 18TH STREET, 6",2010-09-15,2602500,2015-09-24,3900000,1297500,1835,707.0844686648502
"321 5 AVENUE, 41E",2007-04-26,1282995,2007-08-20,1365000,82005,116,706.9396551724138
"71 MURRAY STREET, 11",2004-01-08,3250000,2018-07-18,7000000,3750000,5305,706.880301602262
"450 WEST 17TH   STREET, 2208",2009-01-26,2291062,2014-02-21,3600000,1308938,1852,706.7699784017278
"60 RIVERSIDE BOULEVARD, 3203",2011-12-01,3833656,2016-10-27,5100000,1266344,1792,706.6651785714286
"240 RIVERSIDE BOULEVARD, 24 B",2006-04-05,3364043,2012-08-07,5000000,1635957,2316,706.3717616580311
"203 WEST 90 STREET, 4D",2003-12-19,850000,2004-04-23,939000,89000,126,706.3492063492064
"360 EAST 88 STREET, 26D",2003-12-18,630000,2006-11-07,1375000,745000,1055,706.1611374407582
"25 CENTRAL PARK WEST, 29R",2003-03-10,1126000,2014-01-09,3920000,2794000,3958,705.9120768064679
"425 WEST 50TH   STREET, 10E",2015-03-10,2851100,2015-10-07,3000000,148900,211,705.6872037914692
"245 10TH   AVENUE, 5(3W)",2012-05-29,2461178,2017-05-30,3750000,1288822,1827,705.4307608100712
"25 COLUMBUS CIRCLE, ST54F",2003-12-10,1720187,2014-05-06,4400000,2679813,3800,705.213947368421
"583 BROADWAY, 4M",2004-07-29,6200000,2015-06-15,9000000,2800000,3973,704.757110495847
"30 WEST 63RD   STREET, 10L",2009-12-23,1008067,2014-07-14,2180637,1172570,1664,704.6694711538462
"269 BROADWAY, 26A",2004-12-16,3029293,2008-09-24,4000000,970707,1378,704.4317851959362
"77 PARK AVENUE, 8F",2009-05-19,1495000,2010-12-01,1890000,395000,561,704.0998217468806
"60 GREENE STREET, 4",2005-01-12,4675000,2013-04-16,6797500,2122500,3016,703.7466843501327
"323 PARK AVENUE SOUTH, 3B",2013-09-12,2036500,2016-06-22,2750000,713500,1014,703.6489151873767
"90 FRANKLIN STREET, 5N",2012-08-01,2000000,2017-03-28,3195000,1195000,1700,702.9411764705883
"571 ACADEMY STREET, 4C",2014-10-23,210000,2015-12-17,505000,295000,420,702.3809523809524
"159 WEST 118 STREET, 4H",2014-05-15,772851,2015-08-24,1100000,327149,466,702.0364806866953
"157 WEST 74 STREET, 2",2003-05-07,829874,2005-09-15,1435000,605126,862,702.0023201856148
"835 BROADWAY, 4E",2005-06-20,1901072,2014-10-29,4300000,2398928,3418,701.8513750731422
"1600 BROADWAY, 7E",2006-06-14,672045,2007-01-18,825000,152955,218,701.6284403669724
"715 PARK AVENUE, 4B",2008-07-24,2250000,2012-10-22,3337500,1087500,1551,701.1605415860735
"2056 5 AVENUE, 2-C",2011-07-06,483668,2012-08-21,772500,288832,412,701.0485436893204
"368 ST NICHOLAS AVENUE, 5A",2004-03-04,182419,2005-09-15,575000,392581,560,701.0375
"150 CHARLES STREET, 3ES",2015-11-30,4294436,2018-01-31,4850000,555564,793,700.5851197982346
"308 WEST 30TH   STREET, 9F",2015-04-30,148000,2018-05-14,925000,777000,1110,700.0
"62 EAST 1ST STREET, 1N",2014-10-15,2860000,2018-08-30,3850000,990000,1415,699.6466431095406
"55 WHITE STREET, 2C",2010-07-27,1925000,2016-03-30,3375000,1450000,2073,699.4693680656054
"195 HUDSON STREET, 2A",2015-07-31,3650000,2018-02-15,4300018,650018,930,698.9440860215054
"230 RIVERSIDE DRIVE, 17A",2008-06-30,507000,2015-10-14,2367431,1860431,2662,698.8846731780616
"311 WEST BROADWAY, 6B",2011-06-01,3535000,2013-06-07,4050000,515000,737,698.7788331071913
"101 WEST 87TH   STREET, 815",2014-05-30,2660687,2017-09-06,3495000,834313,1195,698.1698744769875
"25 CENTRAL PARK WEST, 8E",2004-05-04,1525000,2009-08-19,2873000,1348000,1933,697.3616140713916
"1641 3 AVENUE, 15H",2003-02-20,380454,2003-11-26,575000,194546,279,697.2974910394265
"825 7 AVENUE, 27H",2003-08-08,350000,2004-11-09,670000,320000,459,697.1677559912854
"73 WORTH STREET, PH D",2012-03-14,2425000,2017-10-20,3850000,1425000,2046,696.4809384164223
"101 WEST 24TH STREET, 23B",2010-04-01,1894000,2014-08-07,3000000,1106000,1589,696.0352422907489
"150 CHARLES STREET, 4EN",2015-10-05,5624986,2018-06-01,6300000,675014,970,695.8907216494846
"101 WEST 24TH STREET, 17D",2009-12-29,1695000,2015-02-19,3000000,1305000,1878,694.888178913738
"555 WEST 59TH   STREET, 23G",2009-10-09,2200000,2014-04-21,3350000,1150000,1655,694.8640483383685
"101 WARREN STREET, 2630",2009-10-20,2250000,2014-01-07,3320000,1070000,1540,694.8051948051948
"130 WEST 30, 3A",2007-10-12,775000,2010-10-18,1540000,765000,1102,694.1923774954628
"22 MERCER STREET, 2D",2010-03-04,3050000,2014-09-16,4200000,1150000,1657,694.0253470126735
"16 WEST 21ST   STREET, 6A",2011-01-28,1740000,2014-04-10,2550000,810000,1168,693.4931506849315
"425 WEST 53RD   STREET, 416",2012-06-18,2145000,2015-10-27,2995000,850000,1226,693.3115823817292
"200 RECTOR PLACE, 27C",2004-11-16,250000,2006-01-30,555000,305000,440,693.1818181818181
"715 PARK AVENUE, 15D",2006-03-20,3887500,2013-07-29,5750000,1862500,2688,692.8943452380952
"418 CENTRAL PARK WEST, 63",2007-06-28,745000,2015-08-13,2800000,2055000,2968,692.3854447439353
"230 WEST 56 STREET, 50D",2003-08-07,672045,2004-03-15,825000,152955,221,692.10407239819
"220 EAST 65TH   STREET, PH/C",2007-04-27,2075000,2015-10-01,4200000,2125000,3079,690.1591425787593
"80 RIVERSIDE BOULEVARD, 15E",2012-07-31,2009675,2017-09-13,3300000,1290325,1870,690.0133689839572
"160 WEST 66TH   STREET, 48F",2012-02-07,2000000,2013-09-10,2400000,400000,581,688.4681583476764
"240 PARK AVENUE SOUTH, 12B",2008-04-23,3299130,2014-06-06,4837500,1538370,2235,688.3087248322148
"23 EAST 22ND   STREET, 18B",2009-08-21,3563875,2012-05-15,4250000,686125,998,687.5
"160 EAST 22ND   STREET, 9C",2014-11-07,1766653,2017-06-22,2425000,658347,958,687.2098121085595
"25 MURRAY STREET, 4K",2012-02-10,1323725,2014-10-22,2000000,676275,985,686.5736040609137
"502 PARK AVENUE, 18A",2005-02-16,7127750,2016-08-01,10000000,2872250,4184,686.4842256214149
"48 LAIGHT STREET, 2N",2006-05-23,999921,2008-12-04,1635000,635079,926,685.8304535637149
"540 WEST 28TH   STREET, 6F",2012-08-10,801900,2013-12-31,1150000,348100,508,685.2362204724409
"250 EAST 54TH STREET, 36D",2011-08-22,2280000,2016-02-12,3400000,1120000,1635,685.0152905198777
"230 WEST 56TH STREET, 50D",2009-07-09,930000,2010-09-20,1230000,300000,438,684.931506849315
"25 CENTRAL PARK WEST, 5S",2013-06-11,1425000,2015-12-18,2055000,630000,920,684.7826086956521
"15 CENTRAL PARK WEST, S708",2007-11-30,885877,2012-12-20,2150000,1264123,1847,684.4195993502977
"120 RIVERSIDE BOULEVARD, PH3J",2006-03-21,1211717,2007-06-22,1525000,313283,458,684.0240174672489
"2101 BROADWAY, 5-160",2004-02-17,725000,2006-06-07,1300000,575000,841,683.7098692033294
"429 GREENWICH STREET, 4C",2010-06-29,3400000,2017-11-28,5250000,1850000,2709,682.9088224437062
"15 CENTRAL PARK WEST, S701",2008-09-29,1048391,2011-10-05,1800000,751609,1101,682.6603088101725
"219 WEST 81ST   STREET, 9E",2009-08-31,989000,2013-08-21,1978600,989600,1451,682.0124052377671
"170 EAST END AVENUE, 10C/D",2008-11-18,7127750,2017-05-09,9237500,2109750,3094,681.8842921784099
"350 EAST 62ND STREET, 1N",2005-01-10,345000,2005-06-13,450000,105000,154,681.8181818181819
"1641 3 AVENUE, 8K",2003-02-20,360934,2005-03-07,869000,508066,746,681.0536193029491
"540 WEST 28TH   STREET, 7F",2012-08-10,809190,2014-03-07,1200000,390810,574,680.8536585365854
"48 LAIGHT STREET, PH",2006-04-10,2902012,2012-10-25,4528000,1625988,2390,680.3297071129707
"140 EAST 63RD   STREET, 5A",2007-12-18,2392887,2010-04-22,2975000,582113,856,680.0385514018692
"340 EAST 64 STREET, 4M",2003-12-18,606000,2006-06-30,1235000,629000,925,680.0
"280 PARK AVENUE SOUTH, 24D",2012-04-09,860421,2014-08-25,1450000,589579,868,679.2384792626729
"382 CENTRAL PARK WEST, 9K",2003-02-10,865000,2005-10-17,1530000,665000,980,678.5714285714286
"56 EAST 13TH STREET, 7",2011-03-17,2119462,2016-12-27,3550000,1430538,2112,677.3380681818181
"2148 BROADWAY, 11E",2011-10-18,3320000,2017-07-31,4750000,1430000,2113,676.762896355892
"502 PARK AVENUE, 8A",2004-12-06,4567215,2013-12-19,6800000,2232785,3300,676.6015151515152
"525 BROOME STREET, 3",2008-06-19,2150000,2015-05-07,3850000,1700000,2513,676.4822920811779
"166 EAST 63RD   STREET, 5H",2017-04-05,321801,2018-04-30,585493,263692,390,676.1333333333333
"450 WEST 17TH   STREET, 1408",2008-11-12,1501918,2013-03-19,2575000,1073082,1588,675.7443324937028
"415 GREENWICH STREET, 6E",2009-10-14,2036500,2015-12-03,3550000,1513500,2241,675.3681392235609
"1 CENTRAL PARK WEST, 40E",2004-01-22,1775000,2009-09-29,3175000,1400000,2077,674.0491092922484
"50 RIVERSIDE BOULEVARD, 7B",2015-09-18,2814370,2016-11-15,3100000,285630,424,673.6556603773585
"260 PARK AVENUE SOUTH, 6G",2012-11-19,1925000,2015-06-19,2559375,634375,942,673.4341825902335
"43 WEST 21ST   STREET, 3R",2009-07-24,1500000,2011-10-05,2040000,540000,803,672.478206724782
"8 WEST 65TH   STREET, PHA",2007-01-05,2700000,2014-05-05,4500000,1800000,2677,672.394471423235
"30 LITTLE WEST STREET, 33G",2014-01-13,1700000,2017-04-17,2500000,800000,1190,672.2689075630252
"100 UNITED NATIONS PLAZA, 3B",2012-05-10,1100000,2013-08-29,1420000,320000,476,672.2689075630252
"250 WEST 90 STREET, 12A",2003-03-12,810000,2005-06-30,1375000,565000,841,671.8192627824019
"220 RIVERSIDE BOULEVARD, 18CD",2004-06-15,700000,2010-08-17,2212500,1512500,2254,671.0292812777285
"340 EAST 64TH   STREET, 29B",2013-03-14,1400000,2014-01-21,1610000,210000,313,670.926517571885
"395 BROADWAY, 9A",2012-03-16,1275000,2016-07-29,2345000,1070000,1596,670.4260651629073
"250 WEST STREET, 4K",2013-03-28,1221900,2015-04-10,1720000,498100,743,670.3903095558546
"250 EAST 54 STREET, 21B",2004-04-16,285000,2004-07-22,350000,65000,97,670.1030927835052
"400 EAST 51 STREET, 20C",2003-04-14,1155714,2005-03-15,1625000,469286,701,669.4522111269615
"1 RIVER TERRACE, 27AB",2010-11-22,3920262,2017-11-13,5625000,1704738,2548,669.0494505494505
"455 CENTRAL PARK WEST, 23A",2004-10-06,2105537,2008-06-04,3000000,894463,1337,669.0074794315632
"120 RIVERSIDE BOULEVARD, 5V",2006-05-05,537636,2007-07-31,840000,302364,452,668.9469026548672
"426 WEST BROADWAY, 6E",2003-07-14,1200000,2004-10-05,1500000,300000,449,668.1514476614699
"53 NORTH MOORE STREET, 5D",2003-01-14,1300000,2007-07-11,2395000,1095000,1639,668.0902989627822
"70 BATTERY PLACE, 24D",2012-01-18,2036500,2015-02-19,2790000,753500,1128,667.9964539007092
"230 WEST 56TH   STREET, 51F",2008-04-22,2954000,2014-11-12,4553034,1599034,2395,667.6551148225469
"157 CHAMBERS STREET, 5A",2009-04-03,3660608,2017-06-02,5650000,1989392,2982,667.1334674714957
"73 WORTH STREET, 4B",2009-06-12,2690000,2015-12-29,4284398,1594398,2391,666.8331242158093
"641 5 AVENUE, 27D",2013-06-13,850000,2014-11-20,1200000,350000,525,666.6666666666666
"205 EAST 85TH STREET, 6L",2013-08-02,1500000,2015-12-01,2067000,567000,851,666.2749706227967
"200 EAST 69TH   STREET, 7G",2012-04-03,717800,2014-06-11,1250000,532200,799,666.0826032540676
"100 WEST 58TH STREET, 6D",2010-06-10,2550000,2017-06-13,4255000,1705000,2560,666.015625
"44 EAST 12TH   STREET, 4E",2011-07-07,710000,2014-08-07,1460000,750000,1127,665.4835847382432
"15 BROAD STREET, 2704",2007-03-15,70000,2012-10-26,1435000,1365000,2052,665.2046783625731
"1992 BROADWAY, 21-L",2003-08-12,219448,2004-06-11,421556,202108,304,664.828947368421
"155 FRANKLIN STREET, 3S",2006-06-23,3050000,2017-05-22,5700000,2650000,3986,664.8268941294531
"157 CHAMBERS STREET, 10B",2010-02-16,2065097,2016-03-30,3550000,1484903,2234,664.683527305282
"721 5 AVENUE, 47D",2005-05-07,800000,2010-07-01,2050000,1250000,1881,664.5401382243488
"1 MORTON SQUARE, L6B E",2004-09-23,2541364,2016-06-01,5375000,2833636,4269,663.7704380416959
"14 WEST 14TH   STREET, 10A",2010-09-13,1375000,2016-12-28,2900000,1525000,2298,663.6205395996519
"150 WEST 56TH STREET, 4906",2016-06-13,2100000,2018-05-15,2565000,465000,701,663.3380884450785
"59 JOHN STREET, 4C",2012-08-13,1365000,2015-06-12,2050000,685000,1033,663.1171345595353
"25 CENTRAL PARK WEST, 2R",2012-02-28,2000000,2014-04-30,2525000,525000,792,662.8787878787879
"343 EAST 30TH   STREET, 19-C",2012-11-29,1776000,2015-06-29,2400000,624000,942,662.4203821656051
"220, 20C",2003-02-25,486720,2004-01-13,700000,213280,322,662.360248447205
"210-14 COLUMBUS AVENUE, 3A",2004-01-12,500000,2004-06-11,600000,100000,151,662.2516556291391
"25 CENTRAL PARK WEST, 19I",2004-09-23,1512500,2012-01-10,3275000,1762500,2665,661.3508442776736
"101 WARREN STREET, 1750",2008-10-15,2632176,2015-04-14,4200000,1567824,2372,660.9713322091062
"400 EAST 51 STREET, 3E",2004-04-15,1659748,2006-11-02,2275000,615252,931,660.8506981740064
"25 NORTH MOORE STREET, 9B",2003-11-21,1883763,2015-12-21,4800000,2916237,4413,660.8286879673691
"57 BOND STREET, 3EAST",2003-10-28,1440824,2015-01-09,4142500,2701676,4091,660.3950134441457
"433 EAST 74TH STREET, 4A",2009-10-01,3767525,2015-09-10,5200000,1432475,2170,660.1267281105991
"310 EAST 53RD STREET, 11A",2006-11-06,2071375,2008-09-24,2525000,453625,688,659.3386627906976
"1992 BROADWAY, 24-J",2003-08-12,222732,2004-07-29,454779,232047,352,659.2244318181819
"780 WEST END AVENUE, 12C",2003-09-10,930000,2005-11-07,1450000,520000,789,659.062103929024
"146 WEST 57 STREET, 51B",2003-03-31,812500,2004-04-02,1055000,242500,368,658.9673913043479
"10 WEST STREET, 24C",2003-10-03,1206500,2006-01-05,1750000,543500,825,658.7878787878788
"52 EAST END AVENUE, 15A",2009-07-13,1850000,2016-06-21,3520000,1670000,2535,658.7771203155819
"170 EAST 87TH   STREET, E19C",2013-02-21,2325000,2015-04-29,2850000,525000,797,658.7202007528231
"15 CHARLES STREET, 2G",2006-08-15,442000,2007-03-05,575000,133000,202,658.4158415841584
"101 WARREN STREET, 2450",2009-01-07,2779822,2014-02-27,4015000,1235178,1877,658.0596696856686
"15 WEST 53RD   STREET, 23F",2010-12-16,1600000,2015-12-14,2800000,1200000,1824,657.8947368421053
"151 EAST 58TH STREET, 43C",2010-12-06,3800000,2017-10-19,5450000,1650000,2509,657.632522917497
"421 WEST 22ND   STREET, ONE",2015-05-01,2851100,2017-12-21,3485000,633900,965,656.8911917098445
"845 WEST END AVENUE, 4C",2011-10-13,2295000,2014-08-06,2970000,675000,1028,656.6147859922179
"250 EAST 54 STREET, 23F",2003-04-09,920000,2005-09-09,1500000,580000,884,656.1085972850678
"212 WARREN STREET, 10C",2015-10-02,4449752,2018-01-18,5000000,550248,839,655.8379022646008
"680 RIVERSIDE DRIVE, 4C",2010-06-21,427665,2014-11-12,1480000,1052335,1605,655.6604361370717
"350 EAST 82ND   STREET, PH-A",2010-02-26,933915,2012-02-07,1400000,466085,711,655.534458509142
"8 WEST 19TH STREET, R11",2006-12-15,6500000,2015-04-23,8500000,2000000,3051,655.5227794165847
"45 WEST 67TH   STREET, 14J",2011-04-05,477000,2014-09-11,1299000,822000,1255,654.9800796812749
"333 WEST 14TH STREET, 2",2009-11-18,1870000,2012-08-07,2520000,650000,993,654.5820745216515
"2101 BROADWAY, 19906",2007-03-23,975000,2008-04-08,1225000,250000,382,654.4502617801047
"1965 BROADWAY, 26D",2004-07-01,3625000,2008-02-28,4500000,875000,1337,654.4502617801047
"1992 BROADWAY, 20-L",2003-08-12,219448,2004-06-07,415702,196254,300,654.18
"40 MERCER STREET, 4",2009-09-03,3812500,2014-05-01,4925000,1112500,1701,654.0270429159318
"46 LISPENARD STREET, 2B",2013-07-11,2800187,2018-07-20,4000000,1199813,1835,653.8490463215259
"65 EAST 96TH STREET, 7D",2010-12-28,1300000,2015-08-31,2415000,1115000,1707,653.1927357937902
"200 EAST 89 STREET, 23G",2004-06-10,495000,2005-01-18,640000,145000,222,653.1531531531532
"230 WEST 78TH   STREET, 9A",2010-10-12,3106171,2011-05-02,3238035,131864,202,652.7920792079208
"173 PERRY STREET, 3N",2003-04-21,1675000,2015-07-28,4600000,2925000,4481,652.7560812318679
"301 WEST 57TH   STREET, 52C",2008-03-19,3600000,2012-05-30,4600000,1000000,1533,652.3157208088714
"171 EAST 84 STREET, 36E",2003-09-26,1400000,2005-08-16,1850000,450000,690,652.1739130434783
"256 BOWERY, 5A",2014-05-12,1920000,2015-12-16,2300000,380000,583,651.8010291595198
"50 MADISON AVENUE, RU 7",2005-09-21,3207487,2012-03-16,4750000,1542513,2368,651.3990709459459
"1965 BROADWAY, 20H",2003-09-03,570000,2012-04-23,2625000,2055000,3155,651.3470681458003
"95 FRANKLIN STREET, 2A",2005-01-05,2423435,2018-05-17,5600000,3176565,4880,650.9354508196722
"172 MADISON AVENUE, 5C",2017-10-02,1308451,2018-04-30,1445000,136549,210,650.2333333333333
"325 FIFTH AVENUE, 24H",2006-12-29,1613926,2007-06-18,1725000,111074,171,649.5555555555555
"301 WEST 110 STREET, 5L",2003-06-24,304200,2004-04-19,499000,194800,300,649.3333333333334
"38 LAIGHT STREET, 5A",2005-02-03,2774731,2012-05-22,4505000,1730269,2665,649.2566604127579
"134 EAST 93 STREET, 7C",2003-12-18,926608,2005-08-15,1320000,393392,606,649.1617161716172
"272 WEST 107 STREET, 11C",2010-02-22,2285000,2014-11-07,3400000,1115000,1719,648.6329261198371
"230 RIVERSIDE DRIVE, 16N",2008-06-30,276000,2010-01-20,645000,369000,569,648.5061511423551
"101 WARREN STREET, 2210",2008-12-01,3782798,2017-09-12,5862500,2079702,3207,648.488306828812
"66 9 AVENUE, 2W",2012-10-24,3225000,2015-03-30,3800000,575000,887,648.2525366403607
"50 FRANKLIN STREET, PHC",2010-08-03,1272812,2013-08-30,2000000,727188,1123,647.540516473731
"422 WEST 20TH   STREET, 2B",2012-12-19,906242,2015-06-24,1500000,593758,917,647.5005452562705
"400 EAST 51 STREET, 12A",2003-07-09,1680113,2007-03-14,2550000,869887,1344,647.2373511904761
"404 EAST 76 STREET, 25A/D",2003-05-15,1929584,2006-08-18,2700000,770416,1191,646.864819479429
"300 EAST 55TH   STREET, 21D",2013-01-03,2200000,2014-12-23,2665000,465000,719,646.7315716272601
"296 WEST 10TH   STREET, 9N",2011-09-28,1975000,2013-12-18,2500000,525000,812,646.551724137931
"350 WEST 50 STREET, 4Q",2003-10-22,219052,2004-06-21,376000,156948,243,645.8765432098766
"120 RIVERSIDE BOULEVARD, 10D",2006-01-17,953082,2008-05-07,1495000,541918,841,644.3733650416171
"393 WEST 49TH   STREET, 1F",2013-06-05,755000,2015-07-21,1255000,500000,776,644.3298969072165
"540 WEST 28TH   STREET, 11D",2012-02-02,1788400,2015-12-18,2700000,911600,1415,644.2402826855124
"25 MURRAY STREET, 2C",2010-10-28,1563013,2014-08-05,2450000,886987,1377,644.1445170660857
"44 EAST 67TH STREET, 3A",2005-06-01,1605000,2008-05-15,2300000,695000,1079,644.1149212233549
"200 EAST 61ST STREET, 4F",2007-06-14,63000,2010-10-19,850000,787000,1223,643.499591169256
"415 EAST 37TH   STREET, 26K",2006-02-07,662000,2013-09-17,2450000,1788000,2779,643.3969053616408
"300 EAST 23RD   STREET, 6A",2012-03-23,1350000,2015-03-16,2050000,700000,1088,643.3823529411765
"845 UNITED NATIONS PLAZA, 60D",2003-10-08,1456098,2008-08-20,2600000,1143902,1778,643.3644544431946
"10 WEST STREET, 15G",2005-05-13,2575000,2008-01-11,3200000,625000,973,642.3432682425488
"201 EAST 80TH   STREET, 9G",2009-08-10,2250000,2013-11-15,3250000,1000000,1558,641.8485237483953
"1623 3 AVENUE, 13F",2003-02-20,374421,2004-03-04,617000,242579,378,641.7433862433862
"400 WEST 12TH   STREET, 3F",2010-06-25,2522812,2015-01-29,3600000,1077188,1679,641.5652173913044
"323 PARK AVENUE SOUTH, 7A",2013-10-22,2316518,2016-09-14,2995000,678482,1058,641.2873345935727
"93 WORTH STREET, 1206",2014-07-02,5630923,2016-01-21,5995000,364077,568,640.9806338028169
"150 EAST 85 STREET, 15A",2003-10-10,728558,2004-06-18,890000,161442,252,640.6428571428571
"1 MORTON SQUARE, 4C E",2004-10-12,1196443,2014-11-04,3550000,2353557,3675,640.4236734693877
"1 CENTRAL PARK WEST, 25A",2004-07-13,4700000,2009-10-08,5925000,1225000,1913,640.3554626241505
"416 WASHINGTON STREET, 4E",2006-02-15,2168872,2015-07-24,4375000,2206128,3446,640.1996517701683
"1 MORTON SQUARE, 11D E",2004-12-06,1934675,2013-06-27,3935000,2000325,3125,640.104
"101 WARREN STREET, 1120",2008-09-03,3136210,2011-07-08,3800000,663790,1038,639.4894026974952
"71 NASSAU ST, 3C",2006-05-31,773870,2006-11-21,885000,111130,174,638.6781609195402
"312 WEST 23 STREET, 1K",2017-01-05,388037,2017-10-25,575000,186963,293,638.0989761092151
"240 RIVERSIDE BOULEVARD, 12C-T",2005-02-16,4700000,2010-09-16,6000000,1300000,2038,637.8802747791952
"131 WATTS STREET, R-4",2010-10-18,2750000,2016-05-18,4050000,1300000,2039,637.5674350171653
"200 RIVERSIDE BOULEVARD, 35D",2013-03-18,1795000,2015-08-06,2350000,555000,871,637.1986222732492
"400 EAST 67TH   STREET, 12B",2010-04-06,2240150,2014-06-30,3225000,984850,1546,637.0310478654593
"1992 BROADWAY, 20-K",2003-08-12,212379,2004-05-27,396474,184095,289,637.006920415225
"304 EAST 65 STREET, 20C",2004-08-20,582500,2005-10-14,850000,267500,420,636.9047619047619
"421 HUDSON STREET, 409",2008-11-06,922500,2016-07-06,2705000,1782500,2799,636.8345837799214
"253-63 WEST 73 STREET, 5O",2003-05-19,375000,2004-04-05,580000,205000,322,636.6459627329192
"80 RIVERSIDE BOULEVARD, 38A",2011-05-23,3464550,2015-11-05,4500000,1035450,1627,636.4167178856792
"200 RIVERSIDE BOULEVARD, 15B",2009-11-21,27750,2013-04-19,820000,792250,1245,636.3453815261045
"415 GREENWICH STREET, 7C",2008-11-20,3334768,2016-09-12,5150000,1815232,2853,636.2537679635471
"301 EAST 79TH   STREET, 31 A",2008-03-10,1575000,2017-07-21,3750000,2175000,3420,635.9649122807018
"456 WEST 19TH   STREET, 2/3A",2010-12-01,2195347,2015-02-11,3170000,974653,1533,635.781474233529
"40 BOND STREET, 6C",2007-08-07,5702200,2015-07-23,7550000,1847800,2907,635.6381148950809
"1 MORTON SQUARE, 3F W",2004-10-06,2443800,2013-02-21,4387500,1943700,3060,635.1960784313726
"2 BLEECKER STREET, 4",2010-11-29,1825000,2018-07-25,3600000,1775000,2795,635.0626118067978
"15 BROAD STREET, 1101",2006-08-23,470742,2008-01-16,795000,324258,511,634.5557729941291
"422 WEST 20TH   STREET, 4H",2013-01-03,1145531,2015-09-30,1780000,634469,1000,634.469
"147 WAVERLY PLACE, 5W",2008-03-18,2036500,2010-03-19,2500000,463500,731,634.0629274965801
"220, 10F",2003-01-21,470000,2004-05-24,780000,310000,489,633.9468302658487
"310 WEST 52ND   STREET, 25H",2007-03-28,1639382,2008-01-15,1825000,185618,293,633.5085324232082
"25 CENTRAL PARK WEST, 16O",2005-03-16,543000,2006-11-09,925000,382000,603,633.4991708126037
"388 WEST BROADWAY, B",2003-04-29,2291063,2010-06-30,3950000,1658937,2619,633.4238258877434
"408 GREENWICH STREET, RES 7",2008-04-17,7636875,2015-04-08,9250000,1613125,2547,633.3431488025128
"108 FIFTH AVENUE, 2B",2006-11-10,298332,2014-12-22,2175000,1876668,2964,633.1538461538462
"322 WEST 57TH   STREET, 16B1",2011-05-13,1858306,2013-04-02,2295000,436694,690,632.8898550724638
"165 CHARLES STREET, RU16",2005-09-08,4836687,2012-11-19,6500000,1663313,2629,632.6789653860784
"640 WEST END AVENUE, 11B",2003-03-13,1650000,2015-07-16,4500000,2850000,4508,632.2094055013309
"450 WEST 17TH   STREET, 2103",2009-02-20,1374637,2013-05-13,2350000,975363,1543,632.1211924821775
"305 EAST 51ST   STREET, RU15B",2015-07-30,2520168,2017-03-22,2900000,379832,601,632.0
"150 EAST 86TH   STREET, 17H",2011-02-17,2647450,2013-07-03,3195000,547550,867,631.5455594002307
"240 RIVERSIDE BOULEVARD, 18 B",2006-02-22,2988750,2010-06-25,3989000,1000250,1584,631.4709595959596
"350 WEST 42ND   STREET, PH F",2006-12-12,941881,2008-04-29,1260000,318119,504,631.188492063492
"269 BROADWAY, 15F",2004-06-08,2295000,2007-04-12,2950000,655000,1038,631.0211946050097
"1992 BROADWAY, 21-K",2003-08-12,212379,2004-06-11,403991,191612,304,630.3026315789474
"540 WEST 28TH   STREET, 3D",2011-09-08,1100000,2012-12-27,1400000,300000,476,630.2521008403361
"240 EAST 46 STREET, 7F",2004-01-14,220000,2004-05-12,295000,75000,119,630.2521008403361
"2000 BROADWAY, 18E",2003-02-13,660000,2005-09-22,1260000,600000,952,630.2521008403361
"1641 3 AVENUE, 26F",2003-02-20,423042,2005-05-03,929000,505958,803,630.0846824408468
"145 LEXINGTON AVENUE, 7",2013-10-01,862500,2018-04-05,1900000,1037500,1647,629.933211900425
"170 JOHN STREET, PH C",2007-06-14,35000,2012-01-30,1100000,1065000,1691,629.8048492016558
"25 CENTRAL PARK WEST, 15T",2003-07-09,1985588,2014-09-02,4550000,2564412,4073,629.6125705867911
"214 EAST 9TH STREET, 4C",2014-05-23,1600000,2018-07-10,2550000,950000,1509,629.5559973492379
"101 WARREN STREET, 2350",2008-11-24,2938414,2015-01-15,4350000,1411586,2243,629.3294694605439
"235 WEST END AVENUE, 10A",2005-04-13,610000,2014-02-27,2650000,2040000,3242,629.2412091301666
"421 HUDSON STREET, 718",2003-07-15,680000,2017-02-15,3800000,3120000,4964,628.5253827558421
"382 CENTRAL PARK WEST, 14C",2011-07-01,993228,2015-01-21,1810000,816772,1300,628.2861538461539
"25 COLUMBUS CIRCLE, ST56F",2003-12-18,1822014,2012-08-01,3800000,1977986,3149,628.1314703080343
"243 WEST 60TH STREET, 5D",2014-04-04,798000,2018-08-02,1791000,993000,1581,628.0834914611006
"387 BLEECKER STREET, 1",2010-04-06,1578287,2016-03-29,2950000,1371713,2184,628.0737179487179
"157-63 EAST 72 STREET, 2G",2003-01-02,160000,2004-03-23,440000,280000,446,627.8026905829596
"50 FRANKLIN STREET, 18B",2010-07-30,1099710,2012-02-08,1450000,350290,558,627.7598566308244
"300 EAST 55TH STREET, 14C",2008-04-03,710000,2014-03-26,2080000,1370000,2183,627.5767292716446
"25 COLUMBUS CIRCLE, ST58F",2004-02-06,1861074,2016-04-08,4650000,2788926,4445,627.4299212598426
"76 MADISON AVENUE, 12A",2007-05-08,3029293,2014-07-29,4685000,1655707,2639,627.3993937097385
"502 PARK AVENUE, 14D",2005-01-25,3054750,2009-12-16,4175000,1120250,1786,627.2396416573348
"450 WEST 17TH   STREET, 1704",2009-01-15,1598652,2013-02-01,2525000,926348,1478,626.7577807848444
"151 WEST 21ST STREET, 6B",2014-11-24,1705568,2017-12-06,2400000,694432,1108,626.7436823104694
"845 UNITED NATIONS PLAZA, 44A",2004-02-25,1934675,2010-07-21,3400000,1465325,2338,626.7429426860565
"160 CENTRAL PARK SOUTH, 756",2004-10-05,825000,2007-01-18,1348300,523300,835,626.7065868263473
"301 EAST 79TH   STREET, PH-AS",2014-06-13,3200000,2017-12-28,4010000,810000,1294,625.9659969088099
"1992 BROADWAY, 23-L",2003-08-12,219448,2004-07-16,431457,212009,339,625.3952802359883
"50 WEST STREET, 46D",2017-04-20,2774731,2018-04-16,3000000,225269,361,624.0138504155125
"721 5 AVENUE, 50J",2007-05-21,5500000,2009-07-31,6000000,500000,802,623.4413965087282
"254 PARK AVENUE SOUTH, 5NO",2012-05-29,1013158,2016-02-01,1850000,836842,1343,623.1139240506329
"321 5 AVENUE, 16C",2006-10-26,1395002,2007-09-04,1590000,194998,313,622.9968051118211
"502 PARK AVENUE, 8F",2004-02-20,967338,2005-06-28,1275000,307662,494,622.7975708502024
"57 BOND STREET, 2WEST",2003-10-23,1822668,2012-12-28,3910170,2087502,3354,622.391771019678
"736 WEST 187 STREET, 302",2005-11-09,499902,2006-03-29,587000,87098,140,622.1285714285714
"123 WASHINGTON STREET, PH53B",2012-09-11,1675021,2017-02-13,2680000,1004979,1616,621.8929455445544
"1992 BROADWAY, 22-L",2003-08-12,219448,2004-07-09,425627,206179,332,621.0210843373494
"333 WEST 14TH   STREET, 3",2009-08-20,1934675,2012-12-19,2690000,755325,1217,620.645028759244
"845 UNITED NATIONS PLAZA, 61D",2004-04-23,1659748,2007-07-30,2400000,740252,1193,620.4962279966471
"542 LAGUARDIA PLACE, 5B",2011-02-28,2461100,2017-12-06,3995000,1533900,2473,620.2587949858472
"25 NORTH MOORE STREET, 9A",2007-04-30,3950000,2016-08-10,6050000,2100000,3390,619.4690265486726
"100 UNITED NATIONS PLAZA, 44D",2003-09-15,1300000,2008-11-24,2475000,1175000,1897,619.3990511333685
"2 RIVER TERRACE, 11N",2012-02-24,1746298,2017-06-22,2950000,1203702,1945,618.8699228791774
"72 MERCER STREET, 2E",2008-04-01,3226642,2013-11-20,4500000,1273358,2059,618.43516270034
"300 CATHEDRAL PARKWAY, 18E",2009-07-21,333000,2010-06-16,537000,204000,330,618.1818181818181
"15 BROAD STREET, 2308",2006-08-02,1410276,2007-11-01,1691875,281599,456,617.5416666666666
"345 GRAND STREET, 2",2006-02-07,1750000,2015-06-03,3850000,2100000,3403,617.1025565677344
"101 WEST 24TH   STREET, 30B",2008-10-16,1807393,2016-08-04,3565000,1757607,2849,616.920673920674
"20 PINE STREET, 3201",2012-06-21,1832850,2015-04-28,2475000,642150,1041,616.8587896253603
"166 PERRY STREET, 4C",2009-11-24,2220075,2015-10-21,3550000,1329925,2157,616.5623551228558
"354 BROOME STREET, 3I",2005-08-24,950000,2007-01-09,1260000,310000,503,616.3021868787276
"300 EAST 55TH STREET, 26A",2005-02-16,3258400,2014-05-19,5340000,2081600,3379,616.0402485942586
"200 CHAMBERS STREET, 5Q",2007-03-29,784052,2008-06-03,1050000,265948,432,615.6203703703703
"1965 BROADWAY, 29E",2003-11-20,4427500,2012-06-08,6350000,1922500,3123,615.5939801472942
"176 PERRY STREET, 11S",2004-09-27,5800000,2007-05-30,6400000,600000,975,615.3846153846154
"240 RIVERSIDE BOULEVARD, 11C-T",2006-04-28,2119000,2010-09-10,3100000,981000,1596,614.6616541353384
"1 MORTON SQUARE, 4C W",2004-10-26,1501793,2007-03-08,2032150,530357,863,614.5504055619931
"35-41 EAST 38 STREET, 4K",2003-03-27,100000,2004-03-09,313500,213500,348,613.5057471264367
"106 CENTRAL PARK SOUTH, 21A-D",2005-04-22,12500000,2013-02-12,14250000,1750000,2853,613.3894146512444
"4260 BROADWAY, 303",2004-06-23,235000,2005-01-21,365000,130000,212,613.2075471698113
"144 COLUMBUS AVENUE, 14E",2005-08-17,3220000,2018-01-19,6000000,2780000,4538,612.6046716615249
"1641 3 AVENUE, 19K",2003-02-20,400328,2005-03-15,862200,461872,754,612.5623342175066
"225 5 AVENUE, 10J",2006-11-30,3238035,2013-09-03,4750000,1511965,2469,612.379505872823
"25 COLUMBUS CIRCLE, ST55F",2003-12-19,1725279,2015-04-16,4258000,2532721,4136,612.3600096711799
"88 GREENWICH STREET, 926",2014-08-04,300000,2015-08-07,525000,225000,368,611.4130434782609
"70 BATTERY PLACE, 8L",2010-09-29,1221900,2014-07-09,2065000,843100,1379,611.3850616388687
"322 WEST 57TH   STREET, 30K1",2010-09-14,1260000,2015-08-19,2360000,1100000,1800,611.1111111111111
"240 PARK AVENUE SOUTH, 6B",2008-04-10,3353097,2015-08-20,4995000,1641903,2688,610.8270089285714
"57 BOND STREET, 6EAST",2004-03-30,1730007,2013-07-10,3800000,2069993,3389,610.7975804071998
"1 MORTON SQUARE, 7D W",2004-11-17,1629200,2012-12-07,3425000,1795800,2942,610.4010876954453
"78 LAIGHT STREET, 3A",2011-05-09,4700000,2016-08-15,5875000,1175000,1925,610.3896103896104
"21 ASTOR PLACE, 4B",2004-01-21,1114984,2007-01-23,1785000,670016,1098,610.2149362477231
"305 EAST 85TH   STREET, 9D",2010-06-15,2341975,2014-05-20,3217500,875525,1435,610.1219512195122
"275 GREENWICH STREET, 4ES",2010-03-25,1100000,2016-09-26,2550000,1450000,2377,610.0126209507783
"41 WEST 72ND   STREET, 7H",2012-12-14,236615,2016-11-15,1110037,873422,1432,609.93156424581
"129 GRAND STREET, R4",2006-12-07,3700000,2017-04-04,6000000,2300000,3771,609.9177936886767
"517 EAST 11TH STREET, 3",2012-06-22,1445000,2015-06-10,2105000,660000,1083,609.4182825484764
"400 EAST 51 STREET, 11C",2003-04-07,982611,2005-08-03,1500000,517389,849,609.4098939929329
"67 CLINTON STREET, 3",2010-08-26,1200000,2015-05-15,2250000,1050000,1723,609.4022054556007
"27 NORTH MOORE STREET, 3E",2003-10-28,1385000,2006-07-26,1995000,610000,1002,608.7824351297405
"5 WEST 120 STREET, 5",2012-06-28,609931,2016-01-17,1400000,790069,1298,608.6818181818181
"422 EAST 72ND STREET, 35D",2009-06-12,1550000,2010-07-28,1800000,250000,411,608.272506082725
"181 EAST 65 STREET, 4B",2004-01-15,3240000,2006-05-03,3750000,510000,839,607.8665077473182
"133 WEST 22ND   STREET, 7B",2009-11-06,1476462,2012-08-28,2100000,623538,1026,607.7368421052631
"310 WEST 52ND   STREET, 39H",2007-07-10,1272812,2012-07-05,2380000,1107188,1822,607.6772777167947
"39 EAST 29TH   STREET, 14A",2009-07-13,1250000,2014-04-07,2300000,1050000,1729,607.2874493927126
"57 BOND STREET, 5EAST",2004-01-14,1425550,2018-05-09,4600000,3174450,5229,607.0854847963282
"31 WEST 11TH   STREET, 1A",2008-11-12,605475,2016-07-07,2300000,1694525,2794,606.4871152469577
"845 UNITED NATIONS PLAZA, 76D",2004-06-15,2150000,2013-04-05,4100000,1950000,3216,606.3432835820895
"30 WEST 63RD   STREET, 8D",2010-01-04,860421,2013-04-30,1595000,734579,1212,606.0882838283828
"33 WEST 56TH   STREET, 14A",2012-07-16,5478185,2014-06-12,5900000,421815,696,606.0560344827586
"30 WEST 90TH STREET, 7D",2004-10-19,525000,2005-04-21,636406,111406,184,605.4673913043479
"120 WEST 72ND STREET, 3A",2008-03-19,4597398,2015-09-10,6250000,1652602,2731,605.127059685097
"117 EAST 57TH   STREET, 21H",2011-09-13,1250000,2014-03-10,1800000,550000,909,605.0605060506051
"235 WEST END AVENUE, 2F",2003-12-03,725000,2004-06-25,849000,124000,205,604.8780487804878
"210 WEST 19TH STREET, 1G",2009-10-30,920000,2013-10-24,1800000,880000,1455,604.8109965635739
"350 WEST 42 STREET, 52D",2006-10-26,1313542,2008-05-21,1660000,346458,573,604.6387434554974
"217 WEST 14 STREET, 4R",2005-02-25,560037,2006-01-30,765000,204963,339,604.6106194690266
"124 HUDSON STREET, 6C",2004-02-10,3200000,2008-10-27,4240000,1040000,1721,604.2998256827426
"220, 3B",2003-01-28,466440,2003-10-01,615000,148560,246,603.9024390243902
"31 NORTH MOORE STREET, 2E",2006-05-03,4250000,2007-06-21,4500000,250000,414,603.864734299517
"53 WARREN STREET, 6",2010-06-03,1781937,2015-06-29,2900000,1118063,1852,603.7057235421166
"502 PARK AVENUE, 9C",2004-10-08,1120075,2007-09-28,1775050,654975,1085,603.6635944700461
"101 WEST 24TH STREET, 16A",2009-11-12,1355000,2015-03-05,2525000,1170000,1939,603.4038164002063
"212 WARREN STREET, 17S",2016-04-25,2448891,2017-11-20,2795000,346109,574,602.9773519163763
"220 RIVERSIDE BOULEVARD, 18M",2004-08-13,1810000,2007-07-27,2460000,650000,1078,602.9684601113172
"52 EAST END AVENUE, 20B",2009-06-09,369358,2018-07-11,2370000,2000642,3319,602.7845736667671
"173 PERRY STREET, 13N",2008-01-07,5498550,2015-12-22,7250000,1751450,2906,602.7013076393669
"225 5 AVENUE, 5P",2007-02-14,982611,2008-08-19,1315000,332389,552,602.1539855072464
"25 BEEKMAN PLACE, PENTHS",2010-04-19,3027375,2016-12-29,4500000,1472625,2446,602.0543744889616
"641 FIFTH AVENUE, 26D",2005-09-29,2100000,2010-01-25,3050000,950000,1579,601.6466117796074
"845 UNITED NATIONS PLAZA, 42C",2003-03-31,1858306,2004-05-06,2100000,241694,402,601.2288557213931
"150 WEST 56TH STREET, 5106",2011-01-12,1437500,2015-04-21,2375000,937500,1560,600.9615384615385
"350 EAST 82ND   STREET, 18AB",2012-04-13,2162554,2015-03-10,2800000,637446,1061,600.7973609802074
"220 EAST 65 STREET, 17C",2004-04-14,1325000,2006-08-28,1845000,520000,866,600.4618937644342
"496 LA GUARDIA PLACE, 4C",2004-10-08,1533000,2005-04-21,1650000,117000,195,600.0
"780 WEST END AVENUE, 11E",2003-10-28,560000,2015-11-16,3200000,2640000,4402,599.7273966378918
"122 GREENWICH AVENUE, 6",2009-08-31,1747996,2015-11-04,3100000,1352004,2256,599.2925531914893
"310 WEST 52ND   STREET, 11D",2007-02-20,776415,2007-07-18,865000,88585,148,598.5472972972973
"133 WEST 22ND   STREET, 10C",2010-04-30,2291062,2017-06-19,3850000,1558938,2607,597.981588032221
"40 BROAD STREET, 27E",2011-05-05,656771,2014-12-22,1450000,793229,1327,597.7611152976639
"106 CENTRAL PARK SOUTH, 25D",2006-01-03,2800000,2013-10-10,4495000,1695000,2837,597.4621078604159
"21 ASTOR PLACE, 2B",2004-05-18,1379729,2007-07-30,2077500,697771,1168,597.4066780821918
"416 WASHINGTON STREET, 3G",2005-12-01,2026317,2016-06-17,4326200,2299883,3851,597.2170864710465
"120 EAST 87 STREET, P14-F",2004-07-28,340000,2005-08-09,565000,225000,377,596.8169761273209
"2000 BROADWAY, 19C",2004-10-25,1300000,2010-07-21,2550000,1250000,2095,596.6587112171837
"721 FIFTH AVENUE, 39B",2009-10-13,2500000,2011-05-23,2850000,350000,587,596.252129471891
"23 WEST 116 STREET, 8H",2015-02-06,985156,2018-04-25,1685000,699844,1174,596.1192504258944
"150 NASSAU STREET, 2D",2003-05-14,845178,2007-02-13,1662000,816822,1371,595.7855579868709
"1 MORTON SQUARE, 5D E",2004-12-16,1680112,2006-06-06,2000000,319888,537,595.6945996275605
"25 COLUMBUS CIRCLE, ST60C",2004-04-28,4889584,2015-11-12,7400000,2510416,4215,595.5909845788849
"67 HUDSON STREET, 4A",2003-07-16,1525000,2015-04-10,4076500,2551500,4286,595.3103126458236
"49 EAST 21ST STREET, 8C",2004-11-23,1288086,2007-07-16,1862500,574414,965,595.2476683937824
"415 WASHINGTON STREET, 3B",2010-07-22,1527375,2016-08-25,2850000,1322625,2226,594.1711590296496
"333 RECTOR PLACE, 1105",2012-05-23,2550000,2017-06-01,3640000,1090000,1835,594.0054495912807
"250 MANHATTAN AVENUE, 5A",2013-06-03,621132,2014-03-06,785000,163868,276,593.7246376811594
"22 MERCER STREET, 2C",2007-01-29,2427508,2015-12-18,4354000,1926492,3245,593.6801232665639
"146 WEST 57 STREET, 53B",2004-03-01,875000,2005-03-15,1100000,225000,379,593.6675461741424
"120 EAST 87 STREET, R12-D",2003-09-15,905000,2006-06-12,1499000,594000,1001,593.4065934065934
"222 WEST 14 STREET, 14A",2004-02-05,899000,2004-06-29,985000,86000,145,593.1034482758621
"240 RIVERSIDE BOULEVARD, 11B-T",2005-10-20,2259496,2010-08-10,3300000,1040504,1755,592.8797720797721
"540 WEST 28TH   STREET, 13E",2011-08-15,2240150,2016-08-18,3325000,1084850,1830,592.8142076502733
"212 WARREN STREET, 16J",2015-12-15,2718727,2017-01-25,2960000,241273,407,592.8083538083538
"416 WASHINGTON STREET, 3I",2005-12-01,1603743,2013-10-04,3300000,1696257,2864,592.2685055865921
"330 EAST 38 STREET, 19I",2003-10-28,490000,2005-11-09,930000,440000,743,592.1938088829071
"200 CHAMBERS STREET, 3A",2007-09-05,2291062,2013-07-02,3550000,1258938,2127,591.8843441466855
"38 WARREN STREET, 7C",2013-02-14,2475000,2015-10-14,3050000,575000,972,591.5637860082304
"1623 3 AVENUE, 17A",2003-03-10,487989,2008-11-04,1710000,1222011,2066,591.4864472410455
"1992 BROADWAY, 22-K",2003-08-12,212379,2004-07-08,408135,195756,331,591.4078549848942
"69 WEST 106TH STREET, 1B",2004-11-04,570000,2005-06-29,710000,140000,237,590.717299578059
"395 BROADWAY, 8B",2003-09-18,685000,2006-06-13,1275000,590000,999,590.5905905905906
"595 WEST END AVENUE, 9A",2007-10-04,5826063,2015-04-16,7450000,1623937,2751,590.3078880407124
"151 WEST 17TH STREET, PH12G",2016-12-22,3828219,2017-12-29,4047750,219531,372,590.1370967741935
"2211 BROADWAY, 3KS",2010-07-23,2779822,2016-11-30,4150000,1370178,2322,590.0852713178294
"151 WEST 21ST STREET, 5B",2014-10-29,1649565,2017-10-02,2280000,630435,1069,589.7427502338634
"220 RIVERSIDE BOULEVARD, 4N",2009-09-21,1682500,2015-06-29,2925000,1242500,2107,589.7009966777408
"15 BROAD STREET, 3930",2007-10-03,2851100,2017-05-12,4920000,2068900,3509,589.5981761185523
"1992 BROADWAY, 24-K",2003-08-12,212379,2004-07-29,419796,207417,352,589.2528409090909
"447 WEST 18TH   STREET, 6E",2011-01-25,1642000,2014-08-04,2400000,758000,1287,588.9665889665889
"175 SULLIVAN STREET, 5A",2004-03-22,1619680,2018-04-27,4650000,3030320,5149,588.5259273645368
"1641 3 AVENUE, 11K",2003-02-20,364754,2005-05-25,850000,485246,825,588.1769696969696
"1 YORK STREET, 3B",2009-11-05,1935000,2015-05-22,3125000,1190000,2024,587.9446640316205
"32 WEST 18TH   STREET, 2B",2007-08-28,3512962,2015-10-02,5250000,1737038,2957,587.4325329726074
"22 WEST 66TH STREET, 7",2010-04-15,3000100,2014-08-08,3925000,924900,1576,586.8654822335026
"300 EAST 79TH   STREET, 14A",2010-05-06,2225000,2014-06-05,3100000,875000,1491,586.8544600938967
"233 EAST 17TH   STREET, PH1",2010-09-01,4400000,2014-11-14,5300000,900000,1535,586.3192182410423
"140 WEST 22ND   STREET, 7B",2010-07-26,1807393,2015-09-03,2900000,1092607,1865,585.8482573726542
"155 WEST 70 STREET, 6B",2004-01-08,1162500,2005-05-13,1450000,287500,491,585.5397148676171
"160 WEST 66TH STREET, 56B",2006-05-02,3500000,2007-07-03,3750000,250000,427,585.480093676815
"15 BROAD STREET, 1022",2014-01-07,726000,2015-04-20,999999,273999,468,585.4679487179487
"272 WEST 107TH STREET, 12C",2013-10-11,3200000,2014-09-16,3399000,199000,340,585.2941176470588
"200 CHAMBERS STREET, 28A",2007-07-20,3090388,2013-09-04,4400000,1309612,2238,585.1706881143879
"222 RIVERSIDE DRIVE, 9C",2004-08-27,1150000,2005-03-03,1260000,110000,188,585.1063829787234
"2 COLUMBUS AVENUE, PHC",2004-03-23,1800000,2007-07-03,2500000,700000,1197,584.7953216374269
"21 ASTOR PLACE, 3H",2004-05-07,916425,2008-06-26,1800000,883575,1511,584.7617471872932
"188 EAST 78TH   STREET, 3B",2011-05-04,2197500,2015-12-31,3191732,994232,1702,584.1551116333725
"42 WOOSTER STREET, 2NOFR",2004-08-09,2500000,2013-12-24,4500000,2000000,3424,584.1121495327103
"40 SUTTON PLACE, 9E",2003-06-05,600000,2004-10-26,897300,297300,509,584.0864440078585
"322 WEST 57TH   STREET, 45B3",2011-06-21,2851100,2018-01-12,4250000,1398900,2397,583.6045056320401
"350 WEST 50 STREET, 2LL",2004-01-09,456300,2005-04-05,720000,263700,452,583.4070796460177
"43 EAST 25 STREET, 17D",2003-11-04,445000,2004-03-03,515000,70000,120,583.3333333333334
"305 EAST 108 STREET, 3F",2004-11-10,575000,2005-11-29,799000,224000,384,583.3333333333334
"429-435 GREENWICH STREET, 7C",2004-08-27,3400000,2012-11-15,5150000,1750000,3002,582.9447035309794
"246 WEST 17TH   STREET, 1B",2009-06-09,998000,2010-07-12,1230000,232000,398,582.9145728643216
"166 DUANE STREET, 3C",2009-08-14,1625000,2011-12-20,2125000,500000,858,582.7505827505828
"845 WEST END AVENUE, 8F",2012-02-16,1960000,2014-06-06,2450000,490000,841,582.6397146254459
"166 DUANE STREET, 6B",2003-10-31,2615000,2009-08-20,3850000,1235000,2120,582.5471698113207
"350 WEST 42ND STREET, 10L",2006-05-19,982611,2007-08-30,1255000,272389,468,582.0277777777778
"2 COLUMBUS AVENUE, 4D",2004-02-13,995000,2006-04-05,1450000,455000,782,581.841432225064
"30 LITTLE WEST STREET, 22B",2012-06-25,1345000,2014-10-16,1835000,490000,843,581.2574139976275
"350 WEST 42ND STREET, 19K",2006-09-08,733900,2006-12-29,799000,65100,112,581.25
"129 LAFAYETTE STREET, 5A",2005-01-26,1781937,2009-11-13,2800000,1018063,1752,581.0861872146119
"275 WEST 96TH   STREET, 20E",2006-11-09,190000,2013-07-02,1600000,1410000,2427,580.964153275649
"220 MANHATTAN AVENUE, 5A",2004-01-30,250000,2004-05-21,315000,65000,112,580.3571428571429
"22 MERCER STREET, 2B",2007-01-18,2023262,2015-05-04,3780000,1756738,3028,580.164464993395
"330 EAST 38 STREET, 11Q",2003-07-16,580000,2005-10-04,1050000,470000,811,579.5314426633786
"220 RIVERSIDE BOULEVARD, 3/4T",2005-06-01,995000,2017-08-09,3575000,2580000,4452,579.5148247978436
"45 EAST 30TH   STREET, 14A",2012-02-17,1410000,2015-02-26,2050000,640000,1105,579.1855203619909
"316 EAST 22ND   STREET, 6",2010-03-26,2240150,2015-03-30,3300000,1059850,1830,579.1530054644809
"210 LAFAYETTE STREET, 6A",2010-01-11,1575000,2017-03-29,3100000,1525000,2634,578.967350037965
"422 WEST 20TH   STREET, 3D",2012-12-17,963283,2015-02-23,1425000,461717,798,578.592731829574
"250 EAST 31 STREET, 2B",2004-10-21,667000,2005-06-15,804000,137000,237,578.0590717299579
"99 JANE STREET, 6F",2003-02-04,1250000,2007-11-01,2250000,1000000,1731,577.7007510109763
"905 WEST END AVENUE, 111",2010-07-29,2743296,2013-03-19,3300000,556704,964,577.49377593361
"1992 BROADWAY, 23-J",2003-08-12,222732,2004-09-07,448949,226217,392,577.0841836734694
"220, 5U",2003-02-05,419036,2004-05-11,685000,265964,461,576.9284164859002
"30 WEST 63RD   STREET, 16L",2009-12-30,992793,2017-05-22,2550000,1557207,2700,576.7433333333333
"56 EAST 13TH STREET, 6",2008-01-15,1832850,2014-10-08,3250000,1417150,2458,576.5459723352319
"505 GREENWICH STREET, 7D",2004-12-15,2163781,2008-09-09,2950000,786219,1364,576.4068914956011
"205 EAST 85TH   STREET, 10L",2009-08-26,2511971,2016-02-16,3875000,1363029,2365,576.3336152219873
"220, 18V",2003-03-12,486720,2003-11-07,625000,138280,240,576.1666666666666
"1601 3 AVENUE, 16C",2003-04-14,267242,2003-12-04,402000,134758,234,575.8888888888889
"254 PARK AVENUE SOUTH, 6D",2010-07-01,1827758,2017-06-22,3295000,1467242,2548,575.8406593406594
"319 EAST 105 STREET, 3A",2016-11-18,295000,2018-07-19,645000,350000,608,575.6578947368421
"42 WOOSTER STREET, 4NORE",2004-08-30,2300000,2014-02-26,4295000,1995000,3467,575.4254398615518
"15 BROAD STREET, 1610",2006-06-08,1583378,2010-04-08,2388888,805510,1400,575.3642857142858
"104 CHARLTON STREET, 3E",2006-08-01,1662000,2010-02-04,2400000,738000,1283,575.2143413873733
"171 EAST 84TH   STREET, 14E",2014-02-11,658333,2014-10-24,805000,146667,255,575.1647058823529
"426 WEST BROADWAY, 2A",2004-05-12,850000,2006-01-11,1200000,350000,609,574.7126436781609
"65 WEST 13TH STREET, 2D",2012-07-30,2050000,2016-01-13,2775000,725000,1262,574.4849445324882
"139 WOOSTER STREET, PH1C",2007-06-01,2235058,2014-08-21,3750000,1514942,2638,574.2767247915087
"47 MURRAY STREET, 3",2011-07-28,2290713,2013-12-31,2800000,509287,887,574.1679819616686
"84 SULLIVAN STREET, 6A/PH",2006-01-20,2749275,2010-08-03,3700000,950725,1656,574.1092995169082
"1437 3 AVENUE, 20B",2008-03-24,200000,2011-05-09,855000,655000,1141,574.0578439964943
"150 NASSAU STREET, 14B",2003-05-09,1619018,2007-01-31,2400000,780982,1363,572.9875275128393
"429 GREENWICH STREET, 2D",2004-01-05,3792500,2007-05-24,4500000,707500,1235,572.8744939271255
"135 WEST 14TH   STREET, RES 5",2009-12-22,1934675,2015-04-23,3050000,1115325,1948,572.5487679671457
"1992 BROADWAY, 25-P",2003-08-12,212927,2004-10-28,466440,253513,443,572.2641083521445
"356 BROADWAY, 2A",2012-08-23,828000,2017-04-18,1800000,972000,1699,572.1012360211889
"80 RIVERSIDE BOULEVARD, 21B",2009-10-16,2372522,2014-09-16,3400000,1027478,1796,572.0924276169266
"505 GREENWICH STREET, 8E",2005-01-19,1196443,2007-12-10,1800000,603557,1055,572.091943127962
"50 WEST 15TH STREET, 4D",2008-11-10,1993875,2015-08-05,3400000,1406125,2459,571.8279788531923
"125 WEST 21ST   STREET, 8E",2009-08-18,997885,2014-04-25,1975000,977115,1711,571.0783167738165
"200 EAST 66TH   STREET, D0603",2011-04-07,2112868,2014-07-24,2800000,687132,1204,570.7076411960132
"108 DUANE STREET, PH3S",2012-07-27,3431502,2017-12-08,4550000,1118498,1960,570.6622448979592
"220, 19C",2003-02-25,481650,2004-05-14,735000,253350,444,570.6081081081081
"416 WASHINGTON STREET, 2I",2005-11-28,1713205,2014-08-27,3535000,1821795,3194,570.3804007514088
"415 GREENWICH STREET, 4F",2008-05-12,3385681,2017-07-21,5300000,1914319,3357,570.246946678582
"260 PARK AVENUE SOUTH, 2B",2006-10-11,1934675,2015-08-24,3781000,1846325,3239,570.0293300401358
"161 GRAND STREET, 4B",2009-06-25,1710000,2012-07-23,2350000,640000,1124,569.3950177935943
"692 BROADWAY, 1109",2006-08-17,4000000,2014-07-24,5650000,1650000,2898,569.3581780538302
"754 EAST 6 STREET, 3B",2004-09-22,608500,2005-07-29,785000,176500,310,569.3548387096774
"120 RIVERSIDE BOULEVARD, 5D",2005-12-15,855330,2008-02-22,1310000,454670,799,569.0488110137672
"177 EAST 77 STREET, 2D",2005-03-04,559019,2006-08-24,865000,305981,538,568.7379182156134
"15 UNION SQUARE WEST, 26",2011-12-23,5450000,2015-03-24,6125000,675000,1187,568.6604886267902
"2148 BROADWAY, 4D",2011-08-26,2370000,2016-02-18,3300000,930000,1637,568.1124007330483
"450 WEST 17TH   STREET, 1503",2008-09-23,1395002,2013-10-25,2450000,1054998,1858,567.8137782561895
"52 PARK AVENUE, 6",2009-08-21,1075000,2014-10-28,2150000,1075000,1894,567.5818373812039
"20 EAST END AVENUE, 6B",2017-02-17,8572646,2018-06-21,8850000,277354,489,567.1860940695296
"106 CENTRAL PARK SOUTH, 20E",2005-01-27,395000,2005-07-12,489000,94000,166,566.2650602409639
"350 WEST 50 STREET, 4GG",2003-11-18,373344,2005-05-04,675000,301656,533,565.9587242026266
"212 WARREN STREET, 3E",2015-07-10,1756481,2018-05-24,2350000,593519,1049,565.7950428979981
"15 CENTRAL PARK WEST, 2B",2008-09-19,3708900,2016-06-02,5300000,1591100,2813,565.6238890863847
"150 WEST 51 STREET, 18-6",2005-02-22,456000,2005-06-24,525000,69000,122,565.5737704918033
"250 WEST STREET, 3J",2013-03-21,1369546,2017-11-14,2330000,960454,1699,565.3054738081224
"9399 GREENE STREET, 3D",2003-11-26,999000,2007-03-07,1675000,676000,1197,564.7451963241436
"195 HUDSON STREET, 4C",2005-05-24,1976000,2013-10-02,3700000,1724000,3053,564.6904683917459
"262 MOTT STREET, 2S",2004-01-21,1018190,2017-04-21,3750000,2731810,4839,564.5401942550113
"422 EAST 72ND STREET, 5F",2006-09-07,905000,2007-11-15,1150000,245000,434,564.516129032258
"330 EAST 38 STREET, 12F",2004-08-25,605000,2005-09-01,815000,210000,372,564.516129032258
"106 CENTRAL PARK SOUTH, 25C",2006-01-26,1195000,2008-04-11,1650000,455000,806,564.516129032258
"311 EAST 11TH   STREET, 6D",2010-10-12,848966,2013-08-16,1435000,586034,1039,564.0365736284889
"382 CENTRAL PARK WEST, 5K",2003-05-02,442500,2004-07-14,690000,247500,439,563.7813211845103
"415 EAST 37 STREET, 20L",2004-06-03,1175000,2005-06-15,1387500,212500,377,563.6604774535809
"377 RECTOR PLACE, 22A",2011-06-07,1150000,2014-04-01,1730000,580000,1029,563.6540330417881
"101 WARREN STREET, 3140",2010-03-08,2672906,2014-06-12,3550000,877094,1557,563.3230571612074
"40 EAST 94TH STREET, 21F",2006-08-10,1585000,2008-10-27,2040000,455000,809,562.4227441285537
"211 EAST 46TH   STREET, 30D",2011-09-14,312500,2014-06-02,870000,557500,992,561.9959677419355
"5 HARRISON STREET, 5",2003-05-13,1486997,2008-06-05,2525000,1038003,1850,561.0827027027027
"77 READE STREET, 5E",2012-08-29,2235000,2016-01-11,2925000,690000,1230,560.9756097560976
"845 UNITED NATIONS PLAZA, 52B",2005-06-15,3920262,2018-01-17,6500000,2579738,4599,560.9345509893456
"70 BATTERY PLACE, 25A",2010-02-26,1918383,2013-11-06,2675000,756617,1349,560.8724981467753
"305 EAST 51ST   STREET, RU27A",2016-01-21,5070681,2017-08-31,5400000,329319,588,560.0663265306123
"359 WEST 11 STREET, 1B",2004-05-25,1250000,2006-12-01,1765000,515000,920,559.7826086956521
"27 NORTH MOORE STREET, 4B",2004-05-20,1490000,2011-01-14,2850000,1360000,2430,559.6707818930041
"330 EAST 33RD   STREET, 18-E",2007-03-28,250000,2008-05-21,485000,235000,420,559.5238095238095
"415 GREENWICH STREET, 7B",2008-08-06,3742068,2017-07-28,5575000,1832932,3278,559.1616839536302
"416 WASHINGTON STREET, 3E",2005-11-29,2061956,2016-12-29,4325000,2263044,4048,559.052371541502
"127 MADISON AVENUE, 7",2010-07-08,1336453,2015-08-27,2385000,1048547,1876,558.9269722814499
"1619 3 AVENUE, 29F",2003-02-20,439011,2005-05-23,899000,459989,823,558.91737545565
"220, 10A",2003-04-29,545000,2004-04-30,750000,205000,367,558.58310626703
"220, 30E",2003-03-31,560038,2004-05-07,785000,224962,403,558.2183622828784
"420 WEST 23RD   STREET, 4A",2014-06-10,562500,2017-10-31,1253750,691250,1239,557.909604519774
"211 EAST 13TH   STREET, 5B",2014-06-12,1987587,2017-06-15,2600000,612413,1099,557.24567788899
"203 WEST 90 STREET, 9G",2003-05-06,716000,2004-06-11,940000,224000,402,557.2139303482587
"401 EAST 60 STREET, 16D",2003-08-25,1540000,2005-08-30,1950000,410000,736,557.0652173913044
"165 CHARLES STREET, RU13",2007-01-12,6572995,2016-12-29,8600000,2027005,3639,557.0225336630942
"160 WOOSTER STREET, 5C",2005-03-16,1954090,2014-01-13,3750000,1795910,3225,556.8713178294573
"540 WEST 28TH   STREET, 8C",2012-08-10,815100,2014-09-30,1250000,434900,781,556.8501920614597
"181 EAST 65TH STREET, 9D",2004-10-06,2200000,2014-06-23,4175000,1975000,3547,556.8085706230618
"540 WEST 28TH   STREET, 4E",2012-10-15,765000,2014-12-04,1199000,434000,780,556.4102564102565
"299 WEST 12TH   STREET, 11D",2012-07-20,3250000,2013-04-16,3400000,150000,270,555.5555555555555
"251 WEST 19TH   STREET, 9A",2012-03-28,2150000,2017-06-01,3200000,1050000,1891,555.2617662612374
"129 LAFAYETTE STREET, 9C",2005-01-04,1909218,2016-07-21,4250000,2340782,4216,555.2139468690702
"25 5 AVENUE, 7A",2007-12-27,1718296,2011-04-29,2395000,676704,1219,555.1304347826087
"333 RECTOR PLACE, 1405",2011-05-10,2725000,2013-11-14,3235000,510000,919,554.9510337323177
"150 EAST 85 STREET, 10C",2003-10-09,237276,2004-05-19,361000,123724,223,554.8161434977578
"310 EAST 53RD STREET, 8B",2006-10-20,2306336,2007-05-22,2425000,118664,214,554.5046728971963
"768 5 AVENUE, 1006",2009-07-27,4000000,2010-10-21,4250000,250000,451,554.3237250554324
"1 MORTON SQUARE, 4D W",2004-10-26,1400093,2017-03-02,3900000,2499907,4510,554.3031042128603
"36 HUDSON STREET, 4B",2007-04-11,3207487,2015-06-11,4860000,1652513,2983,553.9768689239021
"230 RIVERSIDE DRIVE, 5A",2008-06-30,487000,2010-12-21,987702,500702,904,553.8738938053098
"101 WEST 24TH   STREET, 22D",2008-09-29,1843032,2015-06-15,3200000,1356968,2450,553.8644897959184
"158 FRANKLIN STREET, 3",2006-08-03,800000,2016-03-25,2750000,1950000,3522,553.6626916524702
"1623 3 AVENUE, 39K",2003-02-20,531374,2005-03-21,952000,420626,760,553.4552631578947
"140 EAST 63RD STREET, 17C",2007-10-04,6084043,2014-10-06,7500000,1415957,2559,553.3243454474404
"100 UNITED NATIONS PLAZA, 36D",2003-09-08,1500000,2006-02-28,2000000,500000,904,553.0973451327434
"22 WEST 15TH   STREET, TWPHB",2010-06-28,2100000,2014-09-12,2950000,850000,1537,553.0253741054001
"7 HUBERT STREET, 4D",2004-09-15,1400093,2011-03-31,2720000,1319907,2388,552.7248743718593
"112 WEST 18TH   STREET, 18-6B",2011-12-01,1900000,2017-02-03,2945000,1045000,1891,552.6176626123744
"400 EAST 51 STREET, 3B",2003-03-31,942679,2005-01-06,1300000,357321,647,552.273570324575
"124 8 AVENUE, 8B",2003-02-26,419269,2003-12-05,575000,155731,282,552.2375886524823
"285 LAFAYETTE STREET, 2E",2004-07-09,2850000,2014-07-24,4875000,2025000,3667,552.2225252249796
"200 EAST 32 STREET, 7A",2003-03-28,245000,2005-07-08,705000,460000,833,552.2208883553421
"5 EAST 22 STREET, 19-F",2004-05-05,810000,2006-01-11,1150000,340000,616,551.9480519480519
"150 NASSAU STREET, 3E",2003-04-07,371661,2004-01-28,535000,163339,296,551.8209459459459
"111 CENTRAL PARK NORTH, 3A",2007-12-20,2285971,2017-06-19,4200000,1914029,3469,551.7523782069761
"302 WEST 12TH STREET, 12G",2013-12-20,3525000,2018-01-24,4350000,825000,1496,551.4705882352941
"106 CENTRAL PARK SOUTH, 30E",2006-04-06,2575000,2017-10-23,4900000,2325000,4218,551.2091038406828
"515 EAST 72ND   STREET, 22A",2009-08-21,4836687,2012-09-07,5450000,613313,1113,551.0449236298293
"222 WEST 14TH   STREET, 13B",2011-06-07,500000,2014-01-24,1030000,530000,962,550.935550935551
"40 EAST 61ST STREET, 5B",2008-02-27,1400000,2012-01-04,2175000,775000,1407,550.8173418621179
"200 WEST END AVENUE, PHA S",2009-08-07,2800000,2014-07-28,3800000,1000000,1816,550.6607929515418
"225 WEST 83 STREET, 5E",2003-11-17,797000,2005-11-18,1200000,403000,732,550.5464480874317
"330 EAST 75TH   STREET, 10E",2013-07-31,995000,2015-05-07,1350000,355000,645,550.3875968992248
"30 LITTLE WEST STREET, 18B",2012-11-20,1410000,2015-10-28,2000000,590000,1072,550.3731343283582
"212 WARREN STREET, 6B",2015-07-14,1985587,2017-12-20,2475000,489413,890,549.9022471910113
"129 LAFAYETTE STREET, 4C",2005-05-11,1374637,2015-12-02,3495000,2120363,3857,549.7441016333938
"71 NASSAU STREET, 11A",2013-08-28,1300000,2014-05-28,1450000,150000,273,549.4505494505495
"325-33 EAST 45 STREET, 12A",2003-04-11,170000,2004-01-09,320000,150000,273,549.4505494505495
"421 EAST 13TH   STREET, PHG",2008-10-02,1596887,2012-10-03,2400000,803113,1462,549.3248974008208
"350 WEST 50 STREET, 5W",2003-12-17,324480,2004-06-17,425000,100520,183,549.2896174863388
"1992 BROADWAY, 23-K",2003-08-12,212379,2004-08-13,413966,201587,367,549.283378746594
"195 HUDSON STREET, 2C",2003-12-08,1900000,2014-10-20,4080000,2180000,3969,549.2567397329302
"15 BROAD STREET, 2504",2006-09-08,1420458,2007-05-11,1555000,134542,245,549.1510204081633
"66 WEST 45TH   STREET, U 29D",2012-04-18,923093,2014-01-28,1280000,356907,650,549.0876923076924
"50 FRANKLIN STREET, 4D",2012-09-27,1010000,2015-01-13,1470000,460000,838,548.926014319809
"240 RIVERSIDE BOULEVARD, 25 B",2006-02-07,3188438,2010-02-25,4000000,811562,1479,548.7234617985125
"160 CENTRAL PARK SOUTH, 3118",2012-12-27,1056300,2015-01-09,1464000,407700,743,548.721399730821
"223 WEST 80TH   STREET, 8",2010-01-11,832419,2017-06-14,2320000,1487581,2711,548.7203983769826
"107 GREENE STREET, PH-A",2010-07-30,4450000,2012-02-06,4755000,305000,556,548.5611510791367
"525 PARK AVENUE, 2B",2004-04-06,1160000,2006-10-17,1666500,506500,924,548.1601731601731
"155 FRANKLIN STREET, 5N",2007-08-30,5025000,2014-02-03,6312500,1287500,2349,548.105576841209
"140 7 AVENUE, 4M",2003-01-24,475000,2006-03-10,1100000,625000,1141,547.7651183172655
"30 WEST 63RD   STREET, 31VW",2011-07-28,2698362,2017-08-17,3910000,1211638,2212,547.75678119349
"502 PARK AVENUE, 9B",2004-06-10,2468238,2006-05-08,2850000,381762,697,547.7216642754663
"280 PARK AVENUE SOUTH, 11B",2005-07-14,985000,2007-04-05,1330000,345000,630,547.6190476190476
"706 RIVERSIDE DRIVE, 7A",2012-04-17,137000,2015-07-22,789143,652143,1191,547.5591939546599
"60 RIVERSIDE BOULEVARD, 1902",2012-04-18,1861306,2016-11-30,2785000,923694,1687,547.5364552459988
"101 WARREN STREET, 2360",2009-01-23,3110753,2010-04-05,3350000,239247,437,547.4759725400457
"100 UNITED NATIONS PLAZA, 18C",2004-02-27,600000,2005-04-13,825000,225000,411,547.4452554744526
"301 EAST 79TH   STREET, 36 A",2007-09-28,2450000,2014-08-15,3825000,1375000,2513,547.1547950656586
"144 COLUMBUS AVENUE, 19F",2003-02-28,1525000,2006-05-31,2175000,650000,1188,547.1380471380471
"310 EAST 53RD   STREET, 4/5B",2009-04-08,1500000,2014-04-01,2495000,995000,1819,547.0038482682793
"200 EAST 61 STREET, 35B",2003-02-28,630500,2005-04-05,1050000,419500,767,546.936114732725
"10 WEST STREET, 30A",2003-12-17,1781938,2008-07-22,2700000,918062,1679,546.7909469922573
"905 WEST END AVENUE, 122",2009-08-10,1884380,2013-07-26,2675000,790620,1446,546.7634854771784
"30 EAST 37TH STREET, 9F",2007-02-23,179550,2008-03-14,390000,210450,385,546.6233766233767
"502 PARK AVENUE, 14G",2003-12-10,2469256,2014-11-13,4650000,2180744,3991,546.4154347281383
"303 GREENWICH STREET, 4J",2010-09-30,1425000,2015-08-20,2400000,975000,1785,546.218487394958
"2 COLUMBUS AVENUE, 19A",2003-02-11,1925000,2015-01-09,4300000,2375000,4350,545.9770114942529
"1992 BROADWAY, 24-L",2003-08-12,219448,2004-09-14,437288,217840,399,545.9649122807018
"59 JOHN STREET, PH2",2009-06-24,1350000,2014-11-14,2425000,1075000,1969,545.9624174707974
"129 LAFAYETTE STREET, 3A",2004-12-21,1680112,2017-02-09,4100000,2419888,4433,545.8804421385066
"25 COLUMBUS CIRCLE, ST65E",2004-02-24,2408035,2016-02-25,4800000,2391965,4384,545.612454379562
"25 COLUMBUS CIRCLE, ST53G",2004-05-11,2734423,2009-09-15,3800000,1065577,1953,545.610343061956
"345 EAST 80 STREET, 19E",2003-05-12,1125000,2006-03-30,1699000,574000,1053,545.1092117758784
"414 WEST 54TH   STREET, 6D",2009-01-05,360000,2010-04-27,620000,260000,477,545.0733752620545
"1 MORTON SQUARE, 11B E",2004-11-24,2123051,2014-04-30,4000000,1876949,3444,544.9909988385598
"175 WEST 12TH   STREET, 16L",2014-05-09,740000,2016-10-06,1220000,480000,881,544.8354143019296
"225 5 AVENUE, 11J",2007-08-10,3263491,2014-10-29,4700000,1436509,2637,544.75123246113
"15 BROAD STREET, 2410",2006-11-28,1863397,2008-08-07,2200000,336603,618,544.6650485436893
"476 BROADWAY, 2R",2004-11-17,977520,2013-07-16,2700000,1722480,3163,544.5716092317421
"101 WARREN STREET, 9B",2008-08-20,3258400,2013-08-15,4250000,991600,1821,544.5359692476661
"520 WEST 19TH STREET, 8C",2008-09-26,2952925,2014-05-15,4073000,1120075,2057,544.5187165775401
"120 WEST 72ND   STREET, 4A",2012-07-02,2310000,2016-06-24,3100000,790000,1453,543.7026841018583
"117 WEST 123 STREET, 5A",2011-07-27,746752,2013-10-01,1180000,433248,797,543.5984943538268
"7 WOOSTER STREET, 2A",2011-05-10,2950000,2014-08-18,3600000,650000,1196,543.4782608695652
"1992 BROADWAY, 25-K",2003-08-12,212379,2005-02-01,504822,292443,539,542.5658627087198
"252 7 AVENUE, PH-Q",2004-02-10,2702629,2013-03-07,4500000,1797371,3313,542.5206761243586
"51-53 LEONARD STREET, 1W",2003-04-10,1756481,2013-08-22,3810000,2053519,3787,542.2548191180354
"1212 5 AVENUE, 8A",2012-06-12,3910080,2017-12-13,5000000,1089920,2010,542.2487562189054
"350 WEST 50 STREET, 10D",2004-01-15,433000,2004-07-23,536000,103000,190,542.1052631578947
"200 CHAMBERS STREET, 11A",2007-07-05,2443800,2013-07-16,3637000,1193200,2203,541.625056740808
"26 WEST 97 STREET, 4C",2005-01-07,455000,2005-09-30,599000,144000,266,541.3533834586466
"2109 BROADWAY, 7-144",2009-12-18,2700000,2015-10-22,3855000,1155000,2134,541.2371134020618
"280 PARK AVENUE SOUTH, 7D",2014-09-15,700000,2016-10-21,1115000,415000,767,541.0691003911343
"330 EAST 38TH   STREET, 52K",2014-03-25,1475000,2015-03-30,1675000,200000,370,540.5405405405405
"540 WEST 28TH   STREET, 8E",2012-08-10,853600,2014-11-14,1300000,446400,826,540.4358353510896
"170 EAST END AVENUE, 2G",2008-02-15,2575625,2010-02-23,2975000,399375,739,540.4262516914749
"200 EAST 66TH   STREET, E0607",2010-06-01,2400000,2013-07-31,3024500,624500,1156,540.2249134948097
"2 EAST 55 STREET, 901",2006-08-23,476580,2006-11-29,529490,52910,98,539.8979591836735
"148 EAST 24TH   STREET, 5E",2012-03-21,740231,2013-05-30,975000,234769,435,539.6988505747127
"845 UNITED NATIONS PLAZA, 44B",2004-07-28,3869350,2016-05-25,6200000,2330650,4319,539.6272285251216
"250 WEST STREET, 8G",2013-03-20,3456958,2017-11-16,4375000,918042,1702,539.3901292596945
"2000 BROADWAY, PH1B",2008-10-03,3300000,2014-11-06,4500000,1200000,2225,539.3258426966293
"1 RIVER TERRACE, 3D",2012-12-27,1680000,2015-11-19,2250000,570000,1057,539.2620624408704
"311 AMSTERDAM AVENUE, PHA",2007-02-22,1730000,2015-03-31,3325000,1595000,2959,539.0334572490706
"400 5 AVENUE, 31A",2011-06-08,1200000,2012-12-26,1505000,305000,567,537.9188712522046
"120 EAST 87TH   STREET, P26-A",2007-04-17,5250000,2012-05-21,6250000,1000000,1861,537.345513164965
"252 7 AVENUE, 16M",2003-04-30,2060000,2010-08-31,3500000,1440000,2680,537.3134328358209
"225 WEST 83 STREET, 8F",2003-09-23,825000,2006-07-13,1375000,550000,1024,537.109375
"1623 3 AVENUE, 9K",2003-02-20,387908,2005-11-16,925000,537092,1000,537.092
"344 BOWERY, 3",2007-12-06,2087412,2014-08-15,3400000,1312588,2444,537.0654664484451
"79 LAIGHT STREET, 5G",2003-11-07,1850000,2008-09-10,2800000,950000,1769,537.0265686828717
"1619 3 AVENUE, 8H",2003-02-20,396424,2005-01-07,765000,368576,687,536.5007278020379
"343 EAST 30TH   STREET, 15-L",2007-08-07,400000,2011-01-27,1080000,680000,1269,535.8550039401104
"272 WATER STREET, 4R",2012-04-09,845147,2016-05-20,1650000,804853,1502,535.8541944074567
"530 WEST END AVENUE, 11-B",2006-01-31,3075000,2009-07-14,3750000,675000,1260,535.7142857142857
"205 EAST 68 STREET, T3D",2003-07-23,240000,2003-12-10,315000,75000,140,535.7142857142857
"50 FRANKLIN STREET, 8C",2010-09-08,1170987,2013-07-09,1725000,554013,1035,535.2782608695652
"148 EAST 24TH   STREET, 5A",2012-01-27,799000,2013-11-13,1150000,351000,656,535.060975609756
"150 WEST 56TH STREET, 3302",2011-05-10,1150000,2013-07-31,1585000,435000,813,535.0553505535055
"122 EAST 25TH STREET, PH",2007-05-29,4560000,2014-10-14,6000000,1440000,2695,534.3228200371058
"99 JANE STREET, 5K",2009-12-07,1915000,2017-12-05,3475000,1560000,2920,534.2465753424658
"160 WOOSTER STREET, 2A",2005-02-23,2341975,2015-07-27,4375000,2033025,3806,534.1631634261693
"215 EAST 80TH   STREET, 2DC",2011-09-08,990458,2015-02-13,1660000,669542,1254,533.9250398724083
"540 WEST 28TH   STREET, 13B",2011-07-29,1600000,2017-06-21,2750000,1150000,2154,533.8904363974002
"8 UNION SQUARE SOUTH, 6A",2007-11-29,3054750,2013-07-12,4150000,1095250,2052,533.7475633528265
"1992 BROADWAY, 22-J",2003-08-12,222732,2004-09-28,443118,220386,413,533.6222760290557
"25 NORTH MOORE STREET, 2A",2006-09-15,2341975,2018-06-22,4635000,2293025,4298,533.5097719869707
"10 UNION SQUARE EAST, G11B",2003-05-21,625000,2005-08-04,1055000,430000,806,533.4987593052109
"425 5 AVENUE, 25A",2004-01-20,616041,2005-03-15,840000,223959,420,533.2357142857143
"225 FIFTH AVENUE, 6J",2007-08-29,3877500,2017-08-30,5825000,1947500,3654,532.9775588396278
"15 WEST 53 STREET, 20E",2003-05-27,750000,2006-06-26,1350000,600000,1126,532.8596802841919
"253-63 WEST 73 STREET, 8C",2003-08-06,693428,2004-05-24,849000,155572,292,532.7808219178082
"15 BROAD STREET, 1812",2006-05-03,1374637,2007-10-02,1650000,275363,517,532.6170212765958
"50 RIVERSIDE BOULEVARD, 4R",2015-08-18,1124075,2016-11-03,1360000,235925,443,532.5620767494356
"173-175 EAST BROADWAY, 3A",2006-08-17,585493,2007-06-22,750000,164507,309,532.3851132686084
"40 MERCER STREET, 36",2007-06-12,6924100,2010-09-28,7565000,640900,1204,532.3089700996678
"7 ESSEX STREET, 3",2003-09-22,760633,2008-01-16,1600000,839367,1577,532.2555485098288
"240 RIVERSIDE BOULEVARD, 15 F",2005-12-29,1013250,2017-03-30,3200000,2186750,4109,532.1854465806765
"845 UNITED NATIONS PLAZA, 58B",2005-03-21,3742068,2015-11-30,5820000,2077932,3906,531.9846390168971
"252 WEST 30TH STREET, 4A",2014-12-22,1945000,2017-09-14,2475000,530000,997,531.5947843530591
"415 EAST 37 STREET, 6K",2004-03-31,415000,2005-06-03,643000,228000,429,531.4685314685315
"70 BATTERY PLACE, 9M",2010-06-14,1552831,2014-01-16,2250000,697169,1312,531.3788109756098
"27 NORTH MOORE STREET, 2C",2004-11-19,2250000,2015-06-16,4300000,2050000,3861,530.950530950531
"817 WEST END AVENUE, 11AA",2007-10-24,267190,2008-03-28,350000,82810,156,530.8333333333334
"151 WEST 17TH   STREET, 2G",2007-04-16,1990000,2015-06-19,3575000,1585000,2986,530.8104487608841
"80 RIVERSIDE BOULEVARD, 28D",2009-09-16,3309312,2014-01-17,4150000,840688,1584,530.7373737373738
"25 MURRAY STREET, 6G",2011-08-03,1552831,2013-02-13,1850000,297169,560,530.6589285714285
"280 PARK AVENUE SOUTH, 15M",2003-06-06,600000,2005-06-20,995000,395000,745,530.2013422818792
"160 WADSWORTH AVENUE, 102",2016-05-06,250000,2017-09-18,515000,265000,500,530.0
"350 WEST 42ND   STREET, PH D",2007-01-10,1379728,2014-05-13,2800000,1420272,2680,529.9522388059702
"310 WEST 52ND   STREET, 10H",2007-02-14,1084436,2008-07-18,1360000,275564,520,529.9307692307692
"400 EAST 51 STREET, 3F",2003-03-31,875713,2005-11-07,1380000,504287,952,529.7132352941177
"500 WEST END AVENUE, 8Y",2004-02-20,300000,2007-03-27,899000,599000,1131,529.6198054818744
"200 CHAMBERS STREET, 10A",2007-06-20,2800187,2014-09-18,4202000,1401813,2647,529.5855685681904
"220 MANHATTAN AVENUE, 3J",2003-07-07,50000,2005-08-24,462500,412500,779,529.5250320924262
"303 EAST 33RD   STREET, PHB",2011-06-28,2051773,2015-03-25,2775000,723227,1366,529.4487554904831
"540 WEST 28TH   STREET, 5C",2012-08-10,815100,2014-01-21,1095000,279900,529,529.1115311909263
"161 HUDSON STREET, 5B",2007-11-26,3411137,2015-06-24,4875000,1463863,2767,529.0433682688832
"43 WEST 61 STREET, 12B",2004-07-15,620000,2005-02-08,730000,110000,208,528.8461538461538
"1420 YORK AVENUE, 5B",2004-09-29,270000,2005-01-11,325000,55000,104,528.8461538461538
"1641 3 AVENUE, 21A",2003-02-20,484795,2006-09-18,1175000,690205,1306,528.4877488514549
"17 ORCHARD STREET, 3",2011-07-27,995000,2015-09-28,1800000,805000,1524,528.2152230971128
"25 CENTRAL PARK WEST, 15E",2003-04-30,1800000,2010-01-27,3100000,1300000,2464,527.5974025974026
"300 EAST 77 STREET, 20B",2003-03-17,1832850,2005-08-19,2300000,467150,886,527.2573363431151
"447 WEST 18TH   STREET, 3A",2010-11-03,1655000,2015-03-25,2500000,845000,1603,527.1366188396756
"30 WEST 63RD   STREET, 24VW",2011-12-23,2443800,2017-03-15,3450000,1006200,1909,527.0822420115244
"124 EAST 79 STREET, 4C",2003-06-30,490000,2004-07-23,695000,205000,389,526.9922879177378
"130 WEST 79TH STREET, 19B",2008-03-26,1980000,2016-02-18,3500000,1520000,2885,526.8630849220104
"418 CENTRAL PARK WEST, 6",2003-01-22,715000,2005-06-20,1178115,463115,880,526.2670454545455
"22 MERCER STREET, PHC",2007-04-27,4938512,2011-03-14,5684141,745629,1417,526.2025405786874
"254 PARK AVENUE SOUTH, 7D",2010-06-17,1806333,2017-02-02,3080000,1273667,2422,525.8740710156895
"321 WEST 110TH STREET, 4A",2014-08-22,1042688,2017-04-13,1550000,507312,965,525.7119170984456
"146 WEST 22 STREET, 13-PH",2005-05-23,1975000,2006-07-25,2200000,225000,428,525.7009345794393
"230 RIVERSIDE DRIVE, 10D",2008-06-30,548000,2011-11-23,1200000,652000,1241,525.3827558420628
"1628 2 AVENUE, 1E",2004-04-08,304200,2005-07-20,550000,245800,468,525.2136752136752
"321 EAST 48TH   STREET, 6A",2008-05-09,375253,2008-10-27,465000,89747,171,524.8362573099415
"50 FRANKLIN STREET, 18C",2010-07-12,1084436,2013-08-20,1680000,595564,1135,524.7259911894273
"43 EAST 25 STREET, 24B",2004-09-14,1350000,2006-09-18,1735000,385000,734,524.5231607629428
"21 ASTOR PLACE, 5C",2004-02-06,1680113,2015-06-09,3850000,2169887,4141,524.0007244626902
"1992 BROADWAY, 21-P",2003-08-12,212927,2004-06-02,367323,154396,295,523.3762711864407
"163 ST NICHOLAS AVENUE, 5A",2004-06-09,425880,2005-07-29,643000,217120,415,523.1807228915662
"225 LAFAYETTE STREET, 11D",2005-03-03,2102686,2015-03-26,4025000,1922314,3675,523.0786394557823
"77 HORATIO STREET, 2A",2003-01-21,686500,2005-06-29,1152000,465500,890,523.0337078651686
"10 LITTLE WEST STREET, 19A",2010-07-09,1850000,2013-12-03,2500000,650000,1243,522.9283990345938
"530 EAST 76 STREET, 17G",2005-05-03,905000,2007-12-06,1400000,495000,947,522.7032734952481
"1 YORK STREET, 5F",2009-11-19,2545625,2012-07-11,3050000,504375,965,522.6683937823834
"117 EAST 24TH   STREET, RES 8",2007-01-11,4100000,2014-11-20,5600000,1500000,2870,522.6480836236934
"450 WEST 17TH   STREET, 2106",2008-12-16,1685203,2014-02-24,2675000,989797,1896,522.0448312236286
"100 RIVERSIDE BOULEVARD, 21D T",2008-07-14,3207487,2010-06-18,3575000,367513,704,522.0355113636364
"205 WEST 76TH   STREET, 4H",2009-12-14,1895479,2014-03-05,2700000,804521,1542,521.7386511024644
"555 WEST 23RD STREET, S9L",2011-01-06,994830,2015-11-24,1925000,930170,1783,521.6881660123388
"301 EAST 79TH   STREET, 18 B",2012-02-01,985000,2014-07-03,1445000,460000,883,520.951302378256
"441-51 5 AVENUE, 21A",2003-02-13,360000,2003-07-07,435000,75000,144,520.8333333333334
"1619 3 AVENUE, 15K",2003-02-20,440787,2005-04-14,849000,408213,784,520.6798469387755
"141 5 AVENUE, 12",2010-06-30,2450000,2018-08-24,4000000,1550000,2977,520.6583809203896
"123 WEST 131 STREET, 1",2012-07-13,540000,2016-02-19,1225000,685000,1316,520.516717325228
"1 MORTON SQUARE, 5B E",2004-10-28,1731025,2007-04-19,2200000,468975,903,519.3521594684386
"721 5 AVENUE, 50B",2005-01-14,1800000,2016-07-14,3980000,2180000,4199,519.1712312455346
"65 WEST 13TH   STREET, 7A",2010-06-28,3850000,2016-07-22,5000000,1150000,2216,518.9530685920578
"181 EAST 90TH   STREET, 7B",2009-02-02,800000,2015-09-09,2050000,1250000,2410,518.6721991701245
"520 CATHEDRAL PARKWAY, 7A",2010-01-26,940000,2016-01-14,2069000,1129000,2179,518.127581459385
"200 EAST 66TH   STREET, B1703",2010-07-19,2316518,2014-07-22,3075000,758482,1464,518.0887978142076
"17 ORCHARD STREET, 5",2011-08-23,1150000,2013-08-16,1525000,375000,724,517.9558011049724
"200 EAST 89 STREET, 34B",2003-11-03,785000,2006-04-19,1250000,465000,898,517.8173719376392
"41 WEST 72ND   STREET, 14G",2012-12-14,205189,2017-06-01,1048797,843608,1630,517.5509202453987
"1 IRVING PLACE, P8K",2005-08-24,304000,2008-06-25,840000,536000,1036,517.3745173745174
"220 3 AVENUE, 5B",2012-02-09,1384820,2014-09-04,1870000,485180,938,517.2494669509595
"225 5 AVENUE, 9M",2007-03-08,1985587,2012-02-29,2926195,940608,1819,517.1017042330951
"48 LAIGHT STREET, 3S",2006-05-09,1476462,2012-04-20,2600000,1123538,2173,517.0446387482742
"124 8 AVENUE, 5G",2003-03-27,730000,2004-08-11,990000,260000,503,516.8986083499005
"505 GREENWICH STREET, PHB",2005-10-12,4327562,2013-08-01,5800000,1472438,2850,516.6449122807018
"57 READE STREET, 16F",2012-09-12,1845000,2016-03-03,2500000,655000,1268,516.5615141955836
"25 COLUMBUS CIRCLE, ST52E",2004-06-18,2143278,2016-12-15,4500000,2356722,4563,516.4852071005918
"205 EAST 85TH   STREET, 5GH",2010-05-20,2211437,2016-08-18,3390000,1178563,2282,516.4605609114811
"415 GREENWICH STREET, 4B",2008-05-23,3156575,2017-08-22,4900000,1743425,3378,516.111604499704
"16 JAY STREET, 2",2006-01-13,5200000,2013-06-18,6600000,1400000,2713,516.0339107998526
"363 GREENWICH STREET, 3B",2005-02-22,1600000,2010-06-14,2600000,1000000,1938,515.9958720330237
"101 WARREN STREET, 2030",2008-11-20,2224876,2015-07-20,3480000,1255124,2433,515.875051376901
"28 LAIGHT STREET, 4D",2004-06-14,2300000,2014-04-30,4158800,1858800,3607,515.3313002495148
"302 WEST 12TH   STREET, 17B",2010-12-15,1600000,2014-07-18,2275000,675000,1311,514.8741418764303
"475 BROADWAY, 3W",2003-04-03,1547740,2010-12-23,3000000,1452260,2821,514.8032612548742
"25 COLUMBUS CIRCLE, ST67E",2004-03-15,2484406,2017-08-03,5000000,2515594,4889,514.5416240539988
"1890 ADAM C POWELL BLVD, 5E",2014-05-30,1199000,2016-07-12,1597000,398000,774,514.2118863049095
"115 4 AVENUE, 3J",2003-08-20,450000,2014-01-08,2400000,1950000,3794,513.9694254085398
"475 GREENWICH STREET, 5D",2008-07-10,1960131,2015-01-09,3180000,1219869,2374,513.8454085930919
"200 CHAMBERS STREET, 17A",2007-07-17,2683088,2011-05-13,3400000,716912,1396,513.5472779369627
"124 HUDSON STREET, 5A",2011-06-28,3500000,2017-08-17,4650000,1150000,2242,512.9348795718109
"322 WEST 57TH   STREET, 22P1",2012-07-16,1425550,2015-11-16,2050000,624450,1218,512.6847290640394
"106 DUANE STREET, 5",2004-07-12,870000,2018-07-30,3500000,2630000,5131,512.570648996297
"230 RIVERSIDE DRIVE, 2H",2008-06-30,278000,2010-07-09,656771,378771,739,512.5453315290933
"99 BATTERY PLACE, 17-C",2004-07-30,700000,2005-01-06,782000,82000,160,512.5
"312 EAST 22ND STREET, 4-A",2011-04-11,850000,2013-02-22,1200000,350000,683,512.4450951683748
"70 BATTERY PLACE, 30F",2012-08-01,1445915,2014-06-23,1800000,354085,691,512.4240231548481
"159 WEST 24TH   STREET, 3D",2012-02-15,902500,2014-04-01,1300000,397500,776,512.2422680412371
"14 PRINCE STREET, 2A",2003-02-12,585000,2006-03-21,1165000,580000,1133,511.9152691968226
"327 CENTRAL PARK WEST, 15D",2005-05-27,13796,2015-11-04,1961000,1947204,3813,510.6750590086546
"200 CHAMBERS STREET, 27F",2007-06-08,2011043,2015-12-17,3600000,1588957,3114,510.262363519589
"109 MERCER STREET, 2",2007-05-31,3547430,2015-05-05,5025000,1477570,2896,510.210635359116
"610 PARK AVENUE, 7E",2003-04-01,2725000,2016-07-12,5200000,2475000,4851,510.2040816326531
"415 EAST 54TH STREET, 3A",2006-08-04,1850000,2008-09-26,2250000,400000,784,510.2040816326531
"534 HUDSON STREET, 5D",2007-03-23,2000000,2014-08-18,3380000,1380000,2705,510.1663585951941
"206 1 AVENUE, 3B",2004-02-27,685000,2006-09-20,1162500,477500,936,510.14957264957263
"200 WEST END AVENUE, 24C",2009-11-06,2265606,2013-10-16,3000000,734394,1440,509.99583333333334
"40 BOND STREET, 5A",2007-07-23,5345812,2018-08-02,7400000,2054188,4028,509.97715988083417
"540 WEST 28TH   STREET, 7C",2012-08-10,815100,2014-09-04,1200000,384900,755,509.80132450331126
"42 EAST 12TH STREET, 2",2007-03-20,1580000,2014-09-17,2975000,1395000,2738,509.49598246895545
"159 DUANE STREET, UNIT4",2010-09-08,2038432,2016-12-06,3200000,1161568,2281,509.23629986847874
"45 EAST 80 STREET, 4A",2003-07-09,1775000,2006-05-05,2300000,525000,1031,509.21435499515036
"845 UNITED NATIONS PLAZA, 82B",2007-06-26,5366667,2015-03-11,6800000,1433333,2815,509.17690941385433
"322 WEST 57TH   STREET, 53D2",2011-09-19,2565990,2015-08-31,3300000,734010,1442,509.0221914008322
"32 WEST 18TH   STREET, 2A",2007-09-10,3105662,2012-07-02,4000000,894338,1757,509.0142287990894
"52 EAST 4TH   STREET, 8",2009-10-01,2000000,2015-01-09,2980000,980000,1926,508.82658359293873
"10 WEST END AVENUE, 10H",2007-07-31,1487113,2018-05-30,3500000,2012887,3956,508.81875631951465
"121 WEST 19TH ST, PHF",2006-07-31,2749275,2014-02-12,4150000,1400725,2753,508.79949146385763
"18 LEONARD STREET, 1C",2007-06-29,2975000,2017-08-01,4850000,1875000,3686,508.68149755832883
"92 GREENE STREET, 2B",2009-07-17,3500000,2017-08-14,5000000,1500000,2950,508.47457627118644
"56 LEONARD STREET, 30AW",2016-07-06,4750029,2018-02-16,5050000,299971,590,508.42542372881354
"155 EAST 38TH STREET, 6L",2005-07-14,150000,2007-05-18,492000,342000,673,508.17236255572067
"845 UNITED NATIONS PLAZA, 14C",2003-10-23,789000,2005-06-01,1087000,298000,587,507.66609880749576
"322 WEST 57TH   STREET, 39K1",2010-10-28,1340000,2017-07-07,2580000,1240000,2444,507.36497545008183
"166 PERRY STREET, 1B",2010-04-23,1756481,2014-06-17,2525000,768519,1516,506.938654353562
"155 EAST 38TH   STREET, 17B",2011-07-11,27500,2015-06-25,760000,732500,1445,506.9204152249135
"220 RIVERSIDE BOULEVARD, 33D",2004-09-08,1724250,2014-07-21,3550000,1825750,3603,506.73050235914513
"395 BROADWAY, 7C",2004-09-02,995000,2006-06-06,1320000,325000,642,506.2305295950156
"311 EAST 11TH   STREET, PH1C",2010-06-18,1965000,2015-07-10,2900000,935000,1848,505.95238095238096
"21 ASTOR PLACE, 2D",2004-04-28,1680112,2016-05-03,3900000,2219888,4388,505.8997265268915
"418 CENTRAL PARK WEST, 8",2012-06-30,350000,2015-07-17,912500,562500,1112,505.8453237410072
"240 RIVERSIDE BOULEVARD, 25 C",2005-12-15,2264500,2012-08-23,3500000,1235500,2443,505.730659025788
"225 WEST 83 STREET, 20G",2004-07-26,1350000,2006-09-25,1750000,400000,791,505.6890012642225
"1 MORTON SQUARE, 12D E",2004-12-13,2163781,2013-07-16,3750000,1586219,3137,505.64839018170227
"641 FIFTH AVENUE, 36A",2006-09-27,2850000,2013-08-14,4120000,1270000,2513,505.37206526064466
"303 EAST 33RD   STREET, 7L",2010-08-03,1135348,2013-09-23,1715000,579652,1147,505.3635571054926
"99 JANE STREET, 3C",2003-03-05,1480000,2013-06-10,3375000,1895000,3750,505.3333333333333
"300 EAST 77TH STREET, 4D",2005-05-10,1781937,2010-08-09,2750000,968063,1917,504.9885237350026
"132 DUANE STREET, 3",2005-08-30,1975000,2013-05-22,3400000,1425000,2822,504.9610205527994
"101 WEST 24TH   STREET, 29D",2008-10-01,1949948,2015-04-06,3150000,1200052,2378,504.6476030277544
"310 EAST 53RD STREET, 6B",2006-10-16,2112868,2010-07-09,2800000,687132,1362,504.5022026431718
"92 LAIGHT STREET, 9B",2005-11-01,2675000,2008-12-15,3250000,575000,1140,504.3859649122807
"445 FIFTH AVENUE, 17H",2008-02-07,247500,2010-04-15,650000,402500,798,504.3859649122807
"120 RIVERSIDE BOULEVARD, 16M",2006-06-22,1965222,2007-05-08,2126600,161378,320,504.30625
"415 WASHINGTON STREET, 4B",2010-07-07,1680112,2017-05-31,2950000,1269888,2520,503.9238095238095
"350 WEST 42ND STREET, 56G",2006-11-09,1491736,2010-03-01,2100000,608264,1208,503.5298013245033
"200 WEST END AVENUE, 3A",2009-06-22,1593561,2014-09-04,2550000,956439,1900,503.38894736842104
"421 HUDSON STREET, 825",2011-09-14,1190000,2015-12-22,1975000,785000,1560,503.20512820512823
"340 EAST 64TH STREET, 9J",2013-07-02,1454030,2016-06-21,2000000,545970,1085,503.1981566820277
"230 RIVERSIDE DRIVE, 14A",2006-12-01,965810,2016-05-09,2700000,1734190,3447,503.1012474615608
"459 WASHINGTON STREET, 6N",2012-10-22,2650000,2018-07-11,3700000,1050000,2088,502.8735632183908
"845 UNITED NATIONS PLAZA, 78D",2003-05-14,2320000,2012-12-03,4075000,1755000,3491,502.7212832999141
"147 WAVERLY PLACE, 2W",2008-03-27,1985587,2016-06-16,3495000,1509413,3003,502.6350316350316
"9 MURRAY STREET, 5NE",2011-08-09,2025000,2015-10-29,2800000,775000,1542,502.5940337224384
"150 WEST 56TH   STREET, 3110",2012-09-24,890000,2015-06-16,1390000,500000,995,502.51256281407035
"222 RIVERSIDE DRIVE, 2B",2012-06-27,2100000,2018-02-21,3137500,1037500,2065,502.42130750605327
"1641 3 AVENUE, 10H",2003-02-20,366967,2005-07-05,802000,435033,866,502.3475750577367
"1049 5 AVENUE, 14A",2003-07-13,3800000,2017-09-13,6400000,2600000,5176,502.3183925811437
"455 MAIN STREET, PH1A",2006-05-05,560037,2006-11-30,665000,104963,209,502.21531100478467
"455 WEST 20TH   STREET, 5B",2014-01-10,3650426,2017-04-18,4250000,599574,1194,502.15577889447235
"230 RIVERSIDE DRIVE, 2O",2008-06-30,344000,2010-06-04,697501,353501,704,502.13210227272725
"350 WEST 42ND STREET, 55E",2006-11-03,952063,2008-07-01,1256000,303937,606,501.54620462046205
"421 EAST 13TH   STREET, 6A",2009-03-10,814600,2014-09-05,1820000,1005400,2005,501.44638403990024
"333 EAST 30 STREET, 5-K",2004-11-03,525000,2005-10-18,700000,175000,349,501.43266475644697
"260 PARK AVENUE SOUTH, 4F",2010-04-12,937500,2014-07-23,1721000,783500,1563,501.27959053103007
"124 HUDSON STREET, 2D",2003-03-06,1565000,2008-10-30,2600000,1035000,2065,501.21065375302663
"100 READE STREET, 2-D",2007-01-22,1650000,2008-09-12,1950000,300000,599,500.8347245409015
"299 WEST 12TH STREET, 4G",2005-09-09,1225000,2007-09-12,1592000,367000,733,500.68212824010914
"455 WEST 20TH   STREET, 3A",2013-12-17,2800187,2017-02-08,3375000,574813,1149,500.272410791993
"515 EAST 72ND   STREET, 7M",2012-12-19,665000,2013-06-07,750000,85000,170,500.0
"382 CENTRAL PARK WEST, 18G",2014-10-24,575000,2016-02-26,820000,245000,490,500.0
"60 RIVERSIDE BOULEVARD, 2301",2011-07-06,2800187,2015-11-23,3600000,799813,1601,499.57089319175515
"10 BEDFORD STREET, 2",2004-01-30,540000,2006-06-19,975000,435000,871,499.4259471871412
"330 EAST 57TH STREET, 9",2011-05-27,2229967,2014-12-19,2880000,650033,1302,499.2572964669739
"305 EAST 85TH   STREET, 10B",2011-01-19,1635188,2014-09-12,2300000,664812,1332,499.1081081081081
"333 RECTOR PLACE, 202",2013-08-09,390390,2014-08-14,575000,184610,370,498.94594594594594
"36 HUDSON STREET, 3B",2007-04-13,3054750,2016-08-01,4750000,1695250,3398,498.8964096527369
"302 WEST 12 STREET, 12A",2003-01-08,875000,2006-06-14,1500000,625000,1253,498.80287310454906
"93 WORTH STREET, 801",2014-01-13,1471371,2017-10-05,2150000,678629,1361,498.62527553269655
"1965 BROADWAY, 22F",2004-03-30,906000,2007-04-18,1461000,555000,1114,498.20466786355473
"325 5 AVENUE, 44C",2011-12-28,2180000,2016-03-22,2950000,770000,1546,498.0595084087969
"2 COLUMBUS AVENUE, 36A",2003-09-03,2100000,2012-06-20,3700000,1600000,3213,497.97696856520383
"462 WEST 58TH STREET, 8A",2010-04-12,1770000,2013-07-30,2370000,600000,1205,497.9253112033195
"79 LAIGHT STREET, 2F",2005-07-15,3334768,2017-09-20,5550000,2215232,4450,497.8049438202247
"160 CENTRAL PARK SOUTH, 560",2004-09-10,657500,2006-07-20,995000,337500,678,497.78761061946904
"60 RIVERSIDE BOULEVARD, 2603",2012-01-12,3083206,2016-07-08,3899000,815794,1639,497.738865161684
"330 EAST 38TH STREET, 11A",2013-06-26,998000,2014-08-04,1199000,201000,404,497.5247524752475
"212 WARREN STREET, 9R",2015-08-04,1634291,2017-11-17,2050000,415709,836,497.25956937799043
"225 LAFAYETTE STREET, 6C",2005-02-08,1466280,2015-03-16,3300000,1833720,3688,497.2125813449024
"300 EAST 23RD   STREET, 18B",2012-01-19,2285606,2015-09-17,2950000,664394,1337,496.9289454001496
"1623 3 AVENUE, 29C",2003-02-20,276822,2004-05-14,499900,223078,449,496.8329621380846
"45 CHRISTOPHER STREET, 4B",2005-12-31,545000,2018-04-27,2780000,2235000,4500,496.6666666666667
"101 WARREN STREET, 3250",2009-08-05,5524006,2017-09-25,7000000,1475994,2973,496.46619576185674
"250 EAST 40 STREET, 27B",2004-04-30,775000,2005-05-18,965000,190000,383,496.0835509138381
"25 CENTRAL PARK WEST, 6R",2006-05-11,2000000,2015-05-01,3625000,1625000,3277,495.88037839487333
"322 WEST 57TH   STREET, 27B",2011-07-28,975000,2015-01-29,1610000,635000,1281,495.7064793130367
"340 EAST 64TH STREET, 4N",2013-12-04,950000,2017-06-28,1595000,645000,1302,495.39170506912444
"126 WEST 22ND STREET, 6S",2004-12-07,1580000,2008-10-10,2275000,695000,1403,495.3670705630791
"102 FULTON STREET, 7W",2011-02-14,1150000,2016-11-29,2197310,1047310,2115,495.1820330969267
"51 WALKER STREET, 9A",2007-02-23,3054750,2017-05-08,4900000,1845250,3727,495.10330024148107
"333 EAST 34 STREET, 6KL",2004-04-28,1272813,2006-09-06,1699000,426187,861,494.99070847851334
"835 BROADWAY, 4W",2005-06-22,1663057,2016-09-30,3700000,2036943,4118,494.6437591063623
"80 RIVERSIDE BOULEVARD, 14C",2010-02-19,2528314,2016-01-26,3600000,1071686,2167,494.5482233502538
"129 WEST 123 STREET, 1",2012-08-03,1075000,2017-01-30,1885000,810000,1641,493.60146252285193
"1 MORTON SQUARE, 14D E",2004-12-21,2249150,2014-02-18,3900000,1650850,3346,493.3801554094441
"67 CLINTON STREET, 2",2010-08-26,1000000,2015-05-15,1850000,850000,1723,493.3255948926291
"157 CHAMBERS STREET, 5C",2009-03-13,2744183,2014-11-21,3769800,1025617,2079,493.3222703222703
"2000 BROADWAY, 10C",2014-07-10,1400000,2016-11-18,1825000,425000,862,493.03944315545243
"250 EAST 53RD   STREET, 1201",2010-10-08,2030000,2014-06-19,2695000,665000,1350,492.5925925925926
"9 MURRAY STREET, 5SE",2009-05-29,1150000,2018-07-31,2800000,1650000,3350,492.53731343283584
"1992 BROADWAY, 24-P",2003-08-12,213039,2004-07-26,384813,171774,349,492.18911174785103
"159 WEST 118 STREET, PHH",2014-04-02,838019,2015-10-27,1120000,281981,573,492.11343804537523
"447 WEST 18TH   STREET, 2A",2011-01-25,1674156,2014-07-30,2305000,630844,1282,492.0780031201248
"425 5 AVENUE, 33D",2004-12-20,1048797,2008-04-25,1650000,601203,1222,491.9828150572831
"80 COLUMBUS CIRCLE, NT66F",2004-02-24,1527375,2017-11-28,4000000,2472625,5026,491.966772781536
"1 MORTON SQUARE, PH A",2004-12-16,2698362,2008-06-03,3320000,621638,1265,491.41343873517786
"845 UNITED NATIONS PLAZA, 59C",2004-11-19,2240150,2015-07-13,4150000,1909850,3888,491.21656378600824
"429 GREENWICH STREET, 2C",2006-06-28,3375000,2014-12-19,4895000,1520000,3096,490.9560723514212
"400 EAST 51ST   STREET, 3E",2010-08-23,2077739,2013-11-01,2650000,572261,1166,490.78987993138935
"157 CHAMBERS STREET, 11B",2010-03-04,2325000,2016-02-11,3390000,1065000,2170,490.7834101382488
"153 BOWERY, 6",2004-10-12,1654656,2007-04-18,2105000,450344,918,490.57080610021785
"1200 5 AVENUE, PHA",2009-01-02,15000000,2013-12-11,15884450,884450,1804,490.27161862527714
"366 EAST 8TH STREET, 2",2005-04-19,180000,2013-06-20,1642000,1462000,2984,489.9463806970509
"1992 BROADWAY, 23-P",2003-08-12,212927,2004-07-16,378983,166056,339,489.8407079646018
"210 LAFAYETTE STREET, PH2B",2006-02-27,5504625,2013-12-17,6900000,1395375,2850,489.60526315789474
"444 WEST 19TH   STREET, 703",2011-09-15,1700000,2017-06-30,2735000,1035000,2115,489.36170212765956
"181 EAST 90TH STREET, 7D",2011-04-05,1660000,2015-02-03,2345000,685000,1400,489.2857142857143
"90 FRANKLIN STREET, 3S",2003-11-24,1750000,2011-06-15,3100000,1350000,2760,489.1304347826087
"1641 3 AVENUE, 9C",2003-02-20,254110,2005-08-30,705000,450890,922,489.0347071583514
"226 EAST 52 STREET, 23",2004-08-25,575000,2005-07-08,730000,155000,317,488.9589905362776
"129 LAFAYETTE STREET, 4A",2004-12-22,1827758,2010-06-03,2800000,972242,1989,488.8094519859226
"57 READE STREET, 12B",2012-08-09,1254993,2014-05-06,1565000,310007,635,488.2
"250 EAST 30 STREET, 12B",2003-11-12,916425,2005-06-15,1200000,283575,581,488.08089500860586
"350 WEST 53 STREET, 3D",2005-07-11,605858,2006-10-03,825000,219142,449,488.06681514476617
"57 READE STREET, 8E",2013-02-08,1817576,2016-02-04,2350000,532424,1091,488.01466544454627
"220 RIVERSIDE BOULEVARD, 21B",2004-07-14,2000000,2013-08-21,3620000,1620000,3325,487.21804511278197
"88 WASHINGTON PLACE, 5D",2007-08-01,1832850,2013-07-31,2900000,1067150,2191,487.0607028753994
"2 CORNELIA STREET, 41003",2004-07-30,1100000,2006-10-19,1495000,395000,811,487.0530209617756
"241 WEST 19TH   STREET, PH1",2009-06-19,2550000,2013-07-17,3275000,725000,1489,486.90396239086635
"59 JOHN STREET, 6F",2014-05-22,1430000,2017-04-24,1950000,520000,1068,486.89138576779027
"540 WEST 28TH STREET, 10C",2012-10-23,2046682,2017-08-11,2900000,853318,1753,486.77581289218483
"77 PARK AVENUE, 11D",2006-05-16,1225000,2008-07-15,1610000,385000,791,486.72566371681415
"800 TENTH AVENUE, 3D",2013-05-01,1682412,2015-12-28,2155000,472588,971,486.70236869207
"2056 5 AVENUE, 2-B",2011-07-06,483668,2013-04-16,800000,316332,650,486.6646153846154
"416 WASHINGTON STREET, 4H",2005-12-30,1451006,2016-05-31,3302000,1850994,3805,486.4636005256242
"319 WEST 38TH   STREET, 3212R",2009-11-02,375000,2014-12-17,1285062,910062,1871,486.40406199893107
"77 WHITE STREET, 4",2006-05-01,1853215,2016-03-01,3600000,1746785,3592,486.298719376392
"251 WEST 89TH   STREET, 8B",2013-07-30,1950000,2016-12-05,2545000,595000,1224,486.1111111111111
"20 PINE STREET, 1913",2013-03-11,697501,2014-09-02,960000,262499,540,486.10925925925926
"33 RECTOR STREET, 4",2014-09-26,2350000,2016-12-27,2750000,400000,823,486.02673147023086
"706 RIVERSIDE DRIVE, 2B",2012-04-17,48000,2015-05-27,599000,551000,1135,485.4625550660793
"28 LAIGHT STREET, 5B",2004-11-19,1850000,2009-12-17,2750000,900000,1854,485.43689320388347
"40 EAST 94 STREET, 26G",2003-10-28,720000,2004-11-02,900000,180000,371,485.17520215633425
"127 7 AVENUE, 7D",2012-03-01,1125000,2014-09-05,1570000,445000,918,484.7494553376906
"310 EAST HOUSTON STREET, 5E",2008-03-03,1200000,2010-07-08,1615000,415000,857,484.24737456242707
"1 MORTON SQUARE, 8D E",2004-11-19,2214693,2016-07-15,4275000,2060307,4256,484.09468984962405
"120 EAST 87TH   STREET, R18-C",2007-05-14,2800000,2012-09-27,3750000,950000,1963,483.95313295975546
"635 WEST 42ND   STREET, 43H",2016-08-24,1170000,2017-03-29,1275000,105000,217,483.8709677419355
"136 SULLIVAN STREET, 1",2004-05-28,1800000,2007-07-10,2350000,550000,1138,483.30404217926184
"71 MURRAY STREET, 3",2003-12-08,2600000,2011-08-22,3960000,1360000,2814,483.29779673063257
"200 RIVERSIDE BOULEVARD, 7M",2013-10-09,1595000,2016-12-01,2150000,555000,1149,483.02872062663187
"415 GREENWICH STREET, 5B",2008-05-28,3309312,2011-10-03,3900000,590688,1223,482.982829108749
"60 RIVERSIDE BOULEVARD, 4001",2012-11-28,6688481,2017-07-07,7500000,811519,1682,482.4726516052319
"1280 FIFTH AVENUE, 8E",2012-04-10,1280000,2017-07-21,2210000,930000,1928,482.3651452282158
"57 READE STREET, 21B",2012-09-27,2200000,2013-09-25,2375000,175000,363,482.09366391184574
"148 CHAMBERS STREET, 2",2010-03-18,1476462,2016-04-22,2550000,1073538,2227,482.05568028738213
"2000 BROADWAY, PH3AB",2004-12-22,9062425,2017-07-18,11275000,2212575,4591,481.9374863864082
"1619 3 AVENUE, 18K",2003-02-20,447530,2004-02-13,620000,172470,358,481.75977653631287
"111 CENTRAL PARK NORTH, 4A",2009-07-02,1463231,2016-07-13,2700000,1236769,2568,481.6078660436137
"5 FRANKLIN PLACE, 15D",2016-03-15,3159120,2017-11-09,3450000,290880,604,481.58940397350995
"41 WEST 72ND   STREET, 9B",2012-12-14,196563,2017-10-11,1045000,848437,1762,481.5192962542565
"53 WARREN STREET, 2",2009-08-07,1705568,2012-02-16,2150000,444432,923,481.5081256771398
"58 WHITE STREET, 2",2003-09-15,967338,2012-07-25,2525000,1557662,3236,481.3541409147095
"220 RIVERSIDE BOULEVARD, 3C",2004-01-01,405374,2006-03-31,800000,394626,820,481.2512195121951
"630 FIRST AVENUE, 22E",2004-09-29,695250,2006-06-14,995000,299750,623,481.13964686998395
"241 WEST 19TH   STREET, PH3",2009-05-22,2291062,2016-05-31,3525000,1233938,2566,480.87996882307095
"372 BROOME STREET, 4A",2012-06-19,3767525,2018-01-23,4750000,982475,2044,480.66291585127203
"53 NORTH MOORE STREET, 5H",2003-08-31,200000,2010-12-15,1480000,1280000,2663,480.6609087495306
"200 RIVERSIDE BOULEVARD, 16IJ",2004-10-20,1150000,2017-03-22,3330000,2180000,4536,480.5996472663139
"10 WEST END AVENUE, 30C",2008-12-12,2825643,2013-12-06,3700000,874357,1820,480.41593406593404
"120 EAST 87 STREET, R10-D",2003-07-16,965000,2006-08-03,1500000,535000,1114,480.25134649910234
"205 WEST 76TH   STREET, 1002",2010-04-27,1609915,2014-04-03,2300000,690085,1437,480.2261656228253
"2628 BROADWAY, 30A",2007-12-21,3701338,2015-05-19,5000000,1298662,2706,479.91943828529196
"60 RIVERSIDE BOULEVARD, 2803",2012-07-31,3195213,2016-09-29,3925000,729787,1521,479.80736357659435
"243 WEST 98TH STREET, 7E",2006-01-16,680000,2007-11-14,1000000,320000,667,479.76011994003
"380 LENOX AVENUE, 6G",2012-02-15,835760,2016-11-30,1675000,839240,1750,479.5657142857143
"205 EAST 85TH   STREET, 6GH",2010-03-09,2302721,2012-08-06,2725000,422279,881,479.3178206583428
"57 READE STREET, 10D",2012-08-13,990000,2015-06-18,1488000,498000,1039,479.3070259865255
"304 EAST 65 STREET, 29C",2003-04-17,800000,2004-07-19,1020000,220000,459,479.3028322440087
"52 EAST 4TH   STREET, 11",2009-10-01,2160000,2015-05-08,3140000,980000,2045,479.21760391198046
"100 READE STREET, 5-A",2009-06-23,1545000,2017-03-21,2900000,1355000,2828,479.13719943422916
"130 WEST 19TH STREET, THC",2006-11-13,2164799,2016-05-09,3825000,1660201,3465,479.1344877344877
"200 CHAMBERS STREET, PHF",2007-09-07,2698362,2014-02-04,3820000,1121638,2342,478.92314261315113
"40 EAST 94 STREET, 17C",2005-05-16,3200000,2015-08-21,4995000,1795000,3749,478.794345158709
"160 WOOSTER STREET, 3A",2005-03-03,2596537,2012-01-20,3800000,1203463,2514,478.7044550517104
"205 EAST 16TH   STREET, 4F",2012-03-09,1275000,2014-09-04,1710000,435000,909,478.54785478547853
"159 DUANE STREET, UNIT2",2010-11-16,2053569,2016-09-21,3075000,1021431,2136,478.1980337078652
"212 WARREN STREET, 4J",2016-01-05,2443800,2018-08-16,2900000,456200,954,478.1970649895178
"54 WARREN STREET, 3",2008-02-14,2443800,2014-03-03,3500000,1056200,2209,478.1349026708918
"393 WEST 49 STREET, 5B",2003-12-02,952064,2006-06-26,1400000,447936,937,478.05336179295625
"63 DOWNING STREET, 2C",2012-05-02,1400000,2018-06-29,2475000,1075000,2249,477.99021787461095
"845 UNITED NATIONS PLAZA, 82A",2007-10-29,4300000,2011-11-03,5000000,700000,1466,477.4897680763984
"1623 3 AVENUE, 10C",2003-02-20,247366,2005-04-21,625000,377634,791,477.4134007585335
"7 HUBERT STREET, 4B",2004-09-14,1451006,2016-09-28,3550000,2098994,4397,477.36957016147375
"462 GREENWICH STREET, 3",2012-08-27,2150000,2016-08-12,2840200,690200,1446,477.3167358229599
"111 WEST 67TH   STREET, 22-E",2010-07-30,7000000,2018-03-08,8325000,1325000,2778,476.9618430525558
"845 UNITED NATIONS PLAZA, 79B",2004-11-04,4225737,2013-08-05,5750000,1524263,3196,476.92834793491863
"52 THOMAS STREET, 2C",2008-01-08,1680112,2014-08-11,2825000,1144888,2407,475.64935604486914
"215 WEST 90 STREET, 7-G",2003-02-24,779500,2005-09-15,1223750,444250,934,475.6423982869379
"121 EAST 23RD STREET, 19A",2011-06-27,2325000,2016-02-05,3125000,800000,1684,475.05938242280286
"1623 3 AVENUE, 13D",2003-02-20,245237,2004-04-01,438000,192763,406,474.7857142857143
"1601 THIRD AVENUE, 23H",2005-02-24,799000,2007-05-18,1185000,386000,813,474.78474784747846
"169 HUDSON STREET, 3N",2003-12-01,3300000,2018-05-02,5800000,2500000,5266,474.743638435245
"39 EAST 29TH STREET, 17A",2008-12-03,1685203,2016-03-31,2955000,1269797,2675,474.6904672897196
"112 HUDSON STREET, 5",2003-04-16,850000,2006-04-27,1375000,525000,1107,474.25474254742545
"222 RIVERSIDE DRIVE, PH3A",2005-08-17,3200000,2015-06-11,4900000,1700000,3585,474.19804741980477
"163 ST NICHOLAS AVENUE, 3B",2004-05-28,278850,2006-01-11,560000,281150,593,474.11467116357505
"27 GREAT JONES STREET, 3W",2003-06-13,1690000,2005-10-25,2100000,410000,865,473.9884393063584
"322 WEST 57TH STREET, 47U1",2011-06-07,2700000,2018-07-26,3935000,1235000,2606,473.90636991557943
"540 WEST 28TH   STREET, 7E",2012-08-10,853600,2014-11-25,1250000,396400,837,473.59617682198325
"1 MORTON SQUARE, 7B W",2004-11-15,1374637,2007-11-19,1895000,520363,1099,473.4877161055505
"309 WEST 118 STREET, 1KTPL",2005-03-09,740220,2017-07-24,2880000,2139780,4520,473.4026548672566
"222 RIVERSIDE DRIVE, 10C",2005-02-18,1250000,2007-08-21,1682500,432500,914,473.19474835886217
"350 WEST 53 STREET, 4E",2005-07-21,390390,2006-03-31,510000,119610,253,472.7667984189723
"9399 GREENE STREET, 3F",2003-09-24,960000,2008-04-30,1754000,794000,1680,472.6190476190476
"275 GREENWICH STREET, 8ES",2005-11-08,980000,2016-10-31,2875000,1895000,4010,472.56857855361596
"66 LEONARD STREET, 2F",2004-08-27,1745000,2007-08-01,2250000,505000,1069,472.4041159962582
"1601 3 AVENUE, 28G",2003-02-20,288889,2003-11-14,415000,126111,267,472.3258426966292
"515 PARK AVENUE, 5B",2005-07-12,3500000,2015-12-18,5300000,1800000,3811,472.3169771713461
"150 EAST 85 STREET, 5D",2004-01-21,738231,2005-09-30,1030000,291769,618,472.1181229773463
"1 MORTON SQUARE, L5B W",2004-09-21,1812485,2012-08-16,3175000,1362515,2886,472.11191961191963
"25 COLUMBUS CIRCLE, ST53E",2003-12-11,1965085,2017-09-14,4337500,2372415,5026,472.0284520493434
"40 BROAD STREET, 18H",2009-08-20,1337000,2015-01-29,2275000,938000,1988,471.83098591549293
"14 WEST 14TH   STREET, 9B",2010-09-14,1225000,2015-04-28,2020000,795000,1687,471.25074096028453
"30 WEST 61ST   STREET, 25D",2009-05-01,1050000,2011-12-12,1500000,450000,955,471.2041884816754
"144 COLUMBUS AVENUE, 20A",2003-05-14,3000000,2016-06-09,5250000,2250000,4775,471.2041884816754
"210 LAFAYETTE STREET, PH1C",2006-01-31,2316518,2015-04-15,3900000,1583482,3361,471.13418625409105
"425 5 AVENUE, 18A",2004-06-25,590585,2006-07-26,949000,358415,761,470.9789750328515
"160 EAST 22ND   STREET, 3C",2014-09-19,2406990,2016-02-17,2650000,243010,516,470.9496124031008
"99 JANE STREET, 3E",2010-02-24,1725000,2016-02-10,2750000,1025000,2177,470.83141938447403
"225 LAFAYETTE STREET, 8D",2005-01-14,1924492,2017-03-02,4010000,2085508,4430,470.7693002257336
"520 WEST 19TH STREET, 2C",2008-09-24,2675000,2011-06-30,3150000,475000,1009,470.7631318136769
"845 UNITED NATIONS PLAZA, 19B",2003-03-18,695000,2004-03-24,870000,175000,372,470.4301075268817
"50 FRANKLIN STREET, 14C",2010-05-12,1028432,2014-07-24,1750000,721568,1534,470.3833116036506
"101 WARREN STREET, 7B",2008-07-29,3079188,2012-06-05,3741000,661812,1407,470.37100213219617
"1 CENTRAL PARK WEST, 41D",2007-08-01,8000000,2010-06-30,8500000,500000,1064,469.9248120300752
"60 THOMAS STREET, 6",2004-05-12,1900000,2014-02-04,3570000,1670000,3555,469.760900140647
"255 WEST 85TH   STREET, 9A/B",2010-03-02,2300000,2017-10-24,3612000,1312000,2793,469.7457930540637
"146 WEST 57 STREET, 39B",2004-12-22,900000,2006-04-26,1130000,230000,490,469.38775510204084
"1601 3 AVENUE, 31K",2003-02-20,485860,2007-05-01,1204400,718540,1531,469.3272370999347
"101 WEST 79TH   STREET, 23C",2009-03-27,2495000,2018-01-08,4001000,1506000,3209,469.30507946400746
"65 WEST 13TH   STREET, 10D",2008-09-15,2710000,2013-12-27,3615000,905000,1929,469.1550025920166
"1992 BROADWAY, 25-J",2003-08-12,222732,2005-05-16,524398,301666,643,469.15396578538105
"1438 THIRD AVENUE, 25E",2007-08-15,2199420,2008-07-01,2350000,150580,321,469.09657320872276
"11 VESTRY STREET, 5",2003-08-21,1290000,2012-06-13,2800000,1510000,3219,469.089779434607
"225 5 AVENUE, 4A",2007-04-18,1585000,2015-04-06,2950000,1365000,2910,469.07216494845363
"309 WEST 118 STREET, 4PDPL",2005-04-07,941881,2015-10-28,2750000,1808119,3856,468.91052904564316
"462 GREENWICH STREET, 2",2011-11-14,1792850,2018-08-17,2950000,1157150,2468,468.8614262560778
"450 WEST 17TH   STREET, 2002",2009-04-03,913624,2011-08-29,1325000,411376,878,468.5375854214123
"425 FIFTH AVENUE, 40A",2005-12-22,916425,2007-10-01,1220000,303575,648,468.47993827160496
"333 EAST 34 STREET, 10G",2004-01-29,410670,2005-06-08,643000,232330,496,468.40725806451616
"692 BROADWAY, 1102",2006-06-01,750000,2016-03-16,2425000,1675000,3576,468.40044742729305
"905 WEST END AVENUE, 81",2011-07-06,2769640,2015-08-31,3480000,710360,1517,468.26631509558337
"28 LAIGHT STREET, 6C",2006-06-05,3525000,2017-05-24,5400000,1875000,4006,468.04792810783823
"40 BOND STREET, 5C",2007-07-31,5600375,2016-12-08,7200000,1599625,3418,468.00029256875365
"150 CHAMBERS STREET, 5EAST",2007-01-18,1685000,2014-09-29,3000000,1315000,2811,467.80505158306653
"404 EAST 79 STREET, 17C",2003-09-18,440000,2005-04-28,715000,275000,588,467.687074829932
"144 EAST 30TH STREET, 4",2011-08-11,1700000,2016-06-09,2525000,825000,1764,467.687074829932
"157 CHAMBERS STREET, 9C",2008-12-30,3116506,2016-07-06,4400000,1283494,2745,467.5752276867031
"66 LEONARD STREET, 2E",2005-06-17,2950000,2015-06-01,4650000,1700000,3636,467.5467546754675
"845 UNITED NATIONS PLAZA, 79A",2004-08-20,3360225,2012-10-10,4750000,1389775,2973,467.4655230406996
"79 LAIGHT STREET, 3C",2006-08-21,2850000,2016-01-07,4450000,1600000,3426,467.0169293636894
"175 EAST 2 STREET, 3B",2003-12-18,479000,2005-02-10,675000,196000,420,466.6666666666667
"135 EAST 54TH   STREET, 16F",2007-06-04,480000,2008-04-10,625000,145000,311,466.2379421221865
"40 MERCER STREET, 17",2010-03-03,2243000,2015-10-16,3200000,957000,2053,466.1471018022406
"199 PRINCE STREET, 5",2012-10-11,1109853,2015-01-26,1500000,390147,837,466.1254480286738
"3844 WARREN STREET, 5C",2004-03-04,2195000,2004-06-30,2250000,55000,118,466.10169491525426
"15 BROAD STREET, 2026",2006-09-15,580402,2009-06-19,1050000,469598,1008,465.87103174603175
"220, 9D",2003-01-21,610521,2003-12-08,760000,149479,321,465.6666666666667
"88 WEST WASHINGTON PLCE, 3B",2007-08-07,1522283,2013-08-22,2550000,1027717,2207,465.6624376982329
"60 RIVERSIDE BOULEVARD, 1607",2011-06-30,1036523,2012-05-30,1192500,155977,335,465.6029850746269
"255 EAST 74TH   STREET, 7C",2009-03-04,3665700,2012-08-10,4250000,584300,1255,465.57768924302786
"160 CENTRAL PARK SOUTH, 705",2007-03-12,3411137,2015-10-21,4875000,1463863,3145,465.45723370429255
"350 ALBANY STREET, M5",2012-02-10,999000,2016-01-14,1665000,666000,1434,464.43514644351467
"540 WEST 28TH   STREET, 5F",2012-08-10,685260,2016-04-27,1315000,629740,1356,464.4100294985251
"317 WEST 95TH   STREET, F7",2007-09-28,825000,2010-06-04,1280000,455000,980,464.2857142857143
"136 BAXTER STREET, 5B",2011-07-28,1700000,2016-09-13,2570000,870000,1874,464.24759871931695
"7 ESSEX STREET, 12",2003-12-15,1095000,2007-07-11,1700000,605000,1304,463.95705521472394
"1049 5 AVENUE, 4A",2003-02-07,1450000,2015-03-17,3500000,2050000,4421,463.6959963809093
"455 MAIN STREET, 5D",2006-03-16,505000,2006-11-30,625000,120000,259,463.3204633204633
"150 WEST 56 STREET, 3202",2004-08-12,795000,2005-08-25,970000,175000,378,462.962962962963
"1641 3 AVENUE, 33G",2003-02-20,304861,2003-10-16,415000,110139,238,462.7689075630252
"450 WEST 17TH   STREET, 1909",2008-12-17,2698362,2016-09-01,4000000,1301638,2815,462.3936056838366
"25 COLUMBUS CIRCLE, ST67F",2004-07-08,2438065,2012-04-16,3750000,1311935,2839,462.1116590348714
"101 WEST 87TH   STREET, 614",2013-12-17,972428,2016-01-19,1325000,352572,763,462.086500655308
"147 WAVERLY PLACE, 6W",2008-06-05,2421087,2012-06-14,3100000,678913,1470,461.8455782312925
"2421 BROADWAY, 8B",2004-09-08,780000,2005-07-19,925000,145000,314,461.78343949044586
"200 EAST 58TH STREET, 5H",2004-06-24,900000,2008-05-02,1550000,650000,1408,461.64772727272725
"344 WEST 23RD STREET, 3C",2009-02-06,998000,2010-08-06,1250000,252000,546,461.53846153846155
"312 EAST 22 STREET, 4-B",2004-07-13,1100000,2005-06-03,1250000,150000,325,461.53846153846155
"333 RECTOR PLACE, 412",2011-05-16,446160,2014-02-14,910000,463840,1005,461.5323383084577
"706 RIVERSIDE DRIVE, 2A",2012-04-17,108000,2017-05-23,967337,859337,1862,461.5128893662728
"101 WEST 24TH   STREET, 37B",2008-10-17,2851100,2015-03-13,3930000,1078900,2338,461.4627887082977
"76 MADISON AVENUE, 12B",2007-06-14,2036500,2014-01-22,3150000,1113500,2414,461.2676056338028
"835 BROADWAY, 3E",2005-07-06,1808412,2013-08-05,3170000,1361588,2952,461.24254742547424
"166 PERRY STREET, 4B",2010-03-19,2093934,2015-08-05,3000000,906066,1965,461.10229007633586
"1 IRVING PLACE, P10C",2007-02-05,770000,2017-05-15,2500000,1730000,3752,461.08742004264394
"235 EAST 40TH   STREET, 3D",2015-08-25,530000,2017-12-29,925000,395000,857,460.91015169194867
"130 WEST 19TH STREET, 9E",2013-06-25,2150000,2017-06-29,2825000,675000,1465,460.75085324232083
"845 UNITED NATIONS PLAZA, 60C",2004-06-17,2425000,2009-10-14,3320000,895000,1945,460.1542416452442
"415 GREENWICH STREET, 8F",2009-04-07,3869350,2013-08-12,4600000,730650,1588,460.10705289672546
"350 WEST 42ND STREET, 9E",2006-05-31,560456,2007-05-02,715000,154544,336,459.95238095238096
"195 BOWERY, 13",2006-07-10,1671159,2012-05-29,2660000,988841,2150,459.92604651162793
"250 EAST 53RD STREET, 1704",2008-02-20,2474014,2014-03-31,3500000,1025986,2231,459.8771851187808
"1641 3 AVENUE, 18K",2003-02-20,396779,2007-04-09,1090000,693221,1509,459.39098740888005
"1235 PARK AVENUE, 9B",2012-10-03,1750000,2017-03-24,2500000,750000,1633,459.27740355174524
"220 RIVERSIDE BOULEVARD, 22F",2005-06-08,1040000,2016-06-14,2887500,1847500,4024,459.12027833001986
"524 EAST 72ND   STREET, PH 1A",2008-06-05,3940000,2017-06-01,5447000,1507000,3283,459.03137374352724
"101 WARREN STREET, 2660",2008-12-17,3258400,2017-11-10,4750000,1491600,3250,458.95384615384614
"225 EAST 24TH   STREET, 5 FL",2007-05-25,3716612,2014-06-05,4895000,1178388,2568,458.8738317757009
"1641 3 AVENUE, 25G",2003-02-20,275049,2003-12-22,415000,139951,305,458.85573770491806
"230 RIVERSIDE DRIVE, 2E",2008-06-30,253000,2009-10-16,470000,217000,473,458.7737843551797
"258 ST NICHOLAS AVENUE, 5A",2008-08-07,1030672,2015-07-31,2200000,1169328,2549,458.7398979992154
"30 EAST 37TH STREET, 8C",2007-02-01,320424,2008-04-22,525000,204576,446,458.69058295964123
"101 WARREN STREET, 5I",2008-04-07,2958016,2014-06-05,3990000,1031984,2250,458.6595555555555
"126 WAVERLY PLACE, 2E",2009-08-31,1525000,2013-09-11,2200000,675000,1472,458.5597826086956
"25 COLUMBUS CIRCLE, ST53F",2004-11-01,2010387,2013-09-24,3500000,1489613,3249,458.48353339489074
"220 EAST 65 STREET, 15B",2003-02-24,860000,2005-09-08,1285000,425000,927,458.46817691477884
"255 EAST 49 STREET, 16B",2004-05-18,590000,2005-05-13,755000,165000,360,458.3333333333333
"1641 3 AVENUE, 23J",2003-02-28,265822,2005-10-25,710000,444178,970,457.91546391752576
"205 WEST 76TH   STREET, 7L",2009-11-10,1295000,2015-07-28,2250000,955000,2086,457.8139980824545
"1601 3 AVENUE, 20H",2003-02-20,420202,2006-06-27,980000,559798,1223,457.7252657399836
"43 EAST 25 STREET, 9A",2004-02-26,550000,2005-06-21,770000,220000,481,457.38045738045736
"15 BROAD STREET, 1620",2006-06-08,1440823,2014-11-14,2850000,1409177,3081,457.37650113599483
"111 CENTRAL PARK NORTH, 14A",2007-11-28,2435654,2018-01-31,4135625,1699971,3717,457.3502824858757
"101 WARREN STREET, 650",2008-06-23,1515156,2014-12-11,2595000,1079844,2362,457.1735817104149
"400 EAST 51 STREET, 6F",2003-04-08,896060,2007-11-06,1660000,763940,1673,456.62881052002393
"101 WARREN STREET, 7G",2008-05-12,2341975,2014-05-29,3350000,1008025,2208,456.5330615942029
"393 WEST 49 STREET, 2GG",2004-03-19,259145,2004-11-30,376000,116855,256,456.46484375
"43 WEST 64 STREET, 6B",2004-03-18,2301245,2012-08-08,3700000,1398755,3065,456.36378466557915
"106 WEST 59 STREET, 8J",2003-01-23,247500,2003-06-09,310000,62500,137,456.2043795620438
"101 WEST 24TH   STREET, 23D",2009-05-04,1395002,2017-06-23,2750000,1354998,2972,455.921265141319
"215 WEST 95TH STREET, 6K",2006-04-21,408000,2007-10-04,650000,242000,531,455.74387947269304
"165 WEST 91ST   STREET, 8C",2015-10-27,1705568,2016-12-16,1895000,189432,416,455.36538461538464
"475 BROADWAY, 6E",2004-12-13,2025000,2014-12-18,3690000,1665000,3657,455.29122231337163
"130 WATTS STREET, 2S",2009-12-14,1415000,2017-05-19,2650000,1235000,2713,455.21562845558424
"80 RIVERSIDE BOULEVARD, 6C",2011-05-31,2573581,2013-09-04,2950000,376419,827,455.1620314389359
"250 WEST 90TH STREET, 16A",2004-09-17,1175000,2013-11-21,2700000,1525000,3352,454.95226730310264
"158 FRANKLIN STREET, 2",2006-08-03,252500,2017-09-15,2100000,1847500,4061,454.9372075843388
"321 EAST 48TH STREET, 10E",2004-05-27,255000,2004-11-30,340000,85000,187,454.54545454545456
"160 WOOSTER STREET, 3C",2005-03-15,1883762,2014-09-12,3460000,1576238,3468,454.50922722029986
"252 7 AVENUE, PH-X",2004-06-30,3350000,2017-06-14,5500000,2150000,4732,454.35333896872356
"350 EAST 72ND   STREET, 12A",2009-12-22,900000,2013-11-20,1549000,649000,1429,454.16375087473756
"372 CENTRAL PARK WEST, 17D",2003-10-22,999100,2004-05-07,1089000,89900,198,454.04040404040404
"300 EAST 77 STREET, 17C",2003-05-23,1451006,2006-11-08,2025000,573994,1265,453.7501976284585
"195 BOWERY, 14",2006-07-07,1680112,2012-12-20,2750000,1069888,2358,453.726887192536
"57 READE STREET, 12C",2012-10-22,1668000,2016-05-20,2260500,592500,1306,453.6753445635528
"120 RIVERSIDE BOULEVARD, 6J",2005-12-12,563540,2007-08-30,847500,283960,626,453.6102236421725
"40 SUTTON PLACE, 7C",2004-10-29,275000,2005-10-28,440000,165000,364,453.2967032967033
"310 WEST 52ND STREET, 37B",2013-05-07,2500000,2016-03-31,2980000,480000,1059,453.25779036827197
"79 LAIGHT STREET, 6D",2005-08-01,3563875,2018-06-27,5700000,2136125,4713,453.24103543390623
"322 WEST 57TH   STREET, 45F2",2010-08-25,1705658,2013-12-09,2250000,544342,1202,452.86356073211317
"140 WEST 22ND   STREET, 2F",2010-06-29,1205904,2013-06-14,1695000,489096,1081,452.4477335800185
"301 WEST 57TH STREET, 43C",2009-12-14,2875000,2018-06-08,4275000,1400000,3098,451.90445448676564
"200 RECTOR PLACE, 5W",2004-03-01,175000,2006-08-31,587500,412500,913,451.8072289156627
"845 UNITED NATIONS PLAZA, 56B",2004-09-20,3563875,2014-06-26,5175000,1611125,3566,451.80173864273695
"1 CENTRAL PARK WEST, 30E",2004-11-08,2000000,2013-10-17,3475000,1475000,3265,451.76110260336907
"111 FULTON STREET, PH102",2010-05-25,1476462,2015-09-11,2350000,873538,1935,451.440826873385
"269 BROADWAY, 26BT",2005-02-11,4276650,2007-09-07,4700000,423350,938,451.3326226012793
"79 LAIGHT STREET, 2D",2006-01-12,2850000,2013-12-05,4150000,1300000,2884,450.7628294036061
"251 WEST 19TH STREET, 1D",2010-03-29,830000,2018-07-25,2200000,1370000,3040,450.6578947368421
"301 WEST 57 STREET, 8A",2003-06-02,499999,2005-06-09,832500,332501,738,450.54336043360433
"407 EAST 12 STREET, 4RSW",2003-03-14,580403,2005-04-28,930000,349597,776,450.51159793814435
"1031 6 AVENUE, 37D",2006-08-30,575311,2007-03-06,660000,84689,188,450.47340425531917
"7 WEST 131ST STREET, A1",2011-08-29,537000,2015-09-09,1200000,663000,1472,450.4076086956522
"40 EAST 94TH   STREET, 22B",2011-03-23,4900000,2017-04-21,5900000,1000000,2221,450.24763619990995
"88 GREENWICH STREET, 3105",2013-07-26,817500,2015-08-04,1150000,332500,739,449.93234100135317
"15 BROAD STREET, 1210",2006-05-09,1507010,2010-09-21,2225000,717990,1596,449.86842105263156
"395 BROADWAY, 10C",2011-06-14,1225000,2016-03-03,2000000,775000,1724,449.53596287703016
"99 JANE STREET, 8A",2003-11-21,1151100,2008-10-03,1950000,798900,1778,449.3250843644544
"75 WALL STREET, 21N/O",2011-11-15,2352157,2016-06-06,3100000,747843,1665,449.154954954955
"210 LAFAYETTE STREET, 9A",2006-03-07,1674156,2014-07-28,3050000,1375844,3065,448.8887438825449
"333 RECTOR PLACE, 705",2012-06-11,1140000,2015-11-11,1700000,560000,1248,448.71794871794873
"450 WEST 17TH   STREET, 1705",2008-10-24,1232082,2013-03-12,1950000,717918,1600,448.69875
"1 MORTON SQUARE, 10E W",2009-03-27,1495000,2012-08-15,2050000,555000,1237,448.6661277283751
"27 WEST 72ND STREET, 502",2010-09-08,3400000,2017-05-26,4500000,1100000,2452,448.6133768352365
"1965 BROADWAY, 23F",2004-06-02,975000,2007-12-06,1550000,575000,1282,448.51794071762873
"392 CENTRAL PARK WEST, 10Y",2009-11-10,502544,2010-05-24,590000,87456,195,448.4923076923077
"58 WALKER STREET, 2",2003-07-18,1384820,2017-01-30,3600000,2215180,4945,447.96359959555105
"230 WEST 56 STREET, 52D",2003-06-02,736629,2003-09-18,785000,48371,108,447.8796296296296
"65 THOMPSON STREET, 6",2003-10-10,1500000,2014-03-04,3200000,1700000,3798,447.60400210637175
"201 WEST 72ND   STREET, 6N",2013-10-04,805000,2016-10-14,1300000,495000,1106,447.5587703435805
"300 EAST 77TH   STREET, 18C",2012-11-26,2110000,2016-10-26,2750000,640000,1430,447.5524475524476
"2250 BROADWAY, MF",2004-07-15,443000,2012-12-28,1825000,1382000,3088,447.5388601036269
"62 COOPER SQUARE, 9C",2008-09-16,1900000,2011-03-10,2305000,405000,905,447.51381215469615
"25 LEONARD STREET, 1",2003-03-25,1300000,2012-05-31,2800000,1500000,3355,447.0938897168405
"721 5 AVENUE, 57C",2004-08-30,950000,2015-09-09,2750000,1800000,4027,446.9828656568165
"77 READE STREET, 3F",2012-03-16,1990679,2017-07-14,2860000,869321,1946,446.7219938335046
"1600 BROADWAY, 7G",2006-05-19,1216808,2007-11-19,1462000,245192,549,446.61566484517306
"400 EAST 67TH   STREET, 21B",2012-06-15,2851100,2016-02-16,3450000,598900,1341,446.607009694258
"300 EAST 23RD   STREET, 3E",2012-06-07,890000,2013-11-04,1120000,230000,515,446.6019417475728
"101 WEST 24TH   STREET, 16D",2008-09-03,1746298,2016-01-22,2950000,1203702,2697,446.31145717463846
"15 UNION SQUARE WEST, 6",2012-03-01,3531937,2017-10-20,4450000,918063,2059,445.878096163186
"92 WARREN STREET, 12-PH",2007-11-14,5498550,2018-04-26,7200000,1701450,3816,445.87264150943395
"400 EAST 51 STREET, 4B",2003-03-31,952981,2005-09-07,1350000,397019,891,445.5881032547699
"15 BROAD STREET, 720",2010-10-08,1750000,2017-07-14,2850000,1100000,2471,445.1639012545528
"333 EAST 34 STREET, 5J",2004-02-04,385320,2005-08-18,635000,249680,561,445.06238859180036
"540 WEST 28TH   STREET, 7H",2012-01-30,877695,2014-09-05,1300000,422305,949,445.0
"130 WEST 12TH STREET, 4D",2012-08-02,1440823,2018-05-15,2380000,939177,2112,444.68607954545456
"134 EAST 93RD   STREET, 11B",2012-04-20,1550000,2017-06-30,2393550,843550,1897,444.67580390089614
"123 WASHINGTON STREET, 47G",2012-08-21,976247,2016-06-24,1600000,623753,1403,444.58517462580187
"124 HUDSON STREET, 4A",2008-10-07,3165000,2017-10-04,4625000,1460000,3284,444.5797807551766
"101 WEST 24TH   STREET, 27D",2008-09-23,1919401,2016-02-26,3125000,1205599,2712,444.5424041297935
"88 WASHINGTON PLACE, 4C",2007-07-30,2387796,2012-07-19,3195000,807204,1816,444.4955947136564
"505 GREENWICH STREET, 1A",2005-04-14,1170987,2018-07-24,3325000,2154013,4849,444.21798308929675
"635 WEST 42ND   STREET, 24A",2007-10-11,980000,2008-12-23,1175000,195000,439,444.19134396355355
"1992 BROADWAY, 20-C",2003-08-12,213197,2004-07-21,365980,152783,344,444.13662790697674
"165 WEST 91ST STREET, 14H",2015-05-08,446928,2018-06-14,950000,503072,1133,444.01765225066197
"43 WEST 64TH   STREET, 4D",2009-12-18,1900000,2014-03-21,2590000,690000,1554,444.015444015444
"120 RIVERSIDE BOULEVARD, PH1J",2006-03-23,1298268,2007-05-29,1490000,191732,432,443.8240740740741
"30 WEST 63RD   STREET, 11N",2010-01-19,1640656,2012-11-19,2100000,459344,1035,443.81062801932364
"1601 3 AVENUE, 10C",2003-02-20,258724,2004-11-15,540000,281276,634,443.6529968454259
"150 EAST 85TH STREET, 5D",2007-12-21,451645,2012-06-19,1180000,728355,1642,443.57795371498173
"15 BROAD STREET, 3422",2007-05-09,1266672,2008-08-21,1475000,208328,470,443.25106382978726
"111 CENTRAL PARK NORTH, 12B",2007-11-08,4461971,2017-05-09,6000000,1538029,3470,443.23602305475504
"475 BROADWAY, 7W",2004-09-30,1825000,2009-11-05,2650000,825000,1862,443.0719656283566
"225 FIFTH AVENUE, 2S",2007-07-10,1639382,2013-10-08,2650000,1010618,2282,442.86503067484665
"270 BROADWAY, 8A",2004-02-05,1298268,2007-01-12,1773000,474732,1072,442.8470149253731
"165 CHARLES STREET, RU14",2007-01-12,5682859,2017-05-04,7350000,1667141,3765,442.7997343957503
"25 COLUMBUS CIRCLE, ST72E",2004-06-08,3085179,2017-07-07,5200000,2114821,4777,442.70902239899516
"220 RIVERSIDE BOULEVARD, 24A",2006-06-01,2650000,2014-10-07,4000000,1350000,3050,442.62295081967216
"21 ASTOR PLACE, 4E",2004-01-16,1354273,2012-10-31,2775000,1420727,3211,442.4562441606976
"195 BOWERY, 9",2006-07-31,1603743,2014-04-17,2850000,1246257,2817,442.40575079872207
"1485 FIFTH AVENUE, 15A",2012-02-09,930000,2017-09-07,1830000,900000,2037,441.82621502209133
"1992 BROADWAY, 22-P",2003-08-12,213039,2004-08-12,374716,161677,366,441.74043715846994
"100 WEST 18TH STREET, 4C",2008-06-06,2291062,2014-05-19,3250000,958938,2173,441.2968246663599
"25 CENTRAL PARK WEST, 5X",2009-08-10,985000,2015-08-06,1950000,965000,2187,441.2437128486511
"421 HUDSON STREET, 219",2011-08-03,999000,2014-09-12,1500000,501000,1136,441.0211267605634
"220 WEST 93RD   STREET, PHB",2008-02-08,1395000,2014-08-29,2450000,1055000,2394,440.6850459482038
"350 WEST 50TH STREET, 4R",2005-01-06,385000,2005-10-28,515000,130000,295,440.6779661016949
"250 EAST 30 STREET, 10H",2003-10-20,319410,2004-05-24,415000,95590,217,440.5069124423963
"845 UNITED NATIONS PLAZA, 47B",2004-06-03,3395935,2009-08-21,4235000,839065,1905,440.4540682414698
"175 SULLIVAN STREET, 4A",2004-03-23,1808361,2009-06-16,2650000,841639,1911,440.41810570382
"120 WEST 72ND STREET, 10A",2008-04-03,5702200,2013-09-06,6575000,872800,1982,440.3632694248234
"1623 THIRD AVENUE, 35H",2005-08-15,830000,2008-01-29,1225000,395000,897,440.3567447045708
"360 EAST 88TH STREET, 11F",2011-03-09,2090000,2016-03-22,2900000,810000,1840,440.2173913043478
"422 WEST 20TH   STREET, PAR B",2013-11-14,1850000,2017-04-06,2395000,545000,1239,439.87086359967714
"104 CHARLTON STREET, 2W",2003-12-10,577014,2013-07-09,2116000,1538986,3499,439.83595312946557
"60 RIVERSIDE BOULEVARD, 2402",2011-06-24,1965222,2017-06-15,2925000,959778,2183,439.66010077874483
"1623 3 AVENUE, 20D",2003-02-20,255175,2004-03-01,420000,164825,375,439.53333333333336
"125 EAST 12 STREET, 3-F",2003-06-05,725000,2004-07-30,910000,185000,421,439.4299287410926
"27 LEONARD STREET, 4",2003-01-31,1155000,2014-08-01,3000000,1845000,4200,439.2857142857143
"147 WAVERLY PLACE, 6E",2008-06-05,3142262,2012-07-12,3800000,657738,1498,439.0774365821095
"58 WEST 106 STREET, 1B",2011-04-20,522000,2015-07-01,1195000,673000,1533,439.0084801043705
"279 CENTRAL PARK WEST, 9C",2011-01-25,2613500,2012-07-17,2850000,236500,539,438.7755102040816
"15 BROAD STREET, 920",2011-11-11,2163000,2016-04-21,2875000,712000,1623,438.6937769562538
"380 LENOX AVENUE, 2E",2007-01-12,627140,2008-03-04,810000,182860,417,438.51318944844127
"400 EAST 67TH   STREET, 4C",2011-03-01,2087412,2014-05-13,2600000,512588,1169,438.4841745081266
"129 LAFAYETTE STREET, 10A",2005-05-11,2749275,2012-08-07,3909034,1159759,2645,438.4722117202268
"403 EAST 62 STREET, 6C",2004-02-19,360000,2005-04-16,545000,185000,422,438.38862559241704
"50 EAST 72ND STREET, 11C",2005-05-04,1450000,2010-08-25,2300000,850000,1939,438.3702939659618
"502 PARK AVENUE, 18C",2005-10-28,4460548,2011-01-26,5300000,839452,1916,438.12734864300626
"88 LAIGHT STREET, 6",2007-11-13,2698362,2015-07-15,3925000,1226638,2801,437.928596929668
"400 EAST 51 STREET, 7E",2003-12-11,1756481,2006-09-19,2200000,443519,1013,437.82724580454095
"1600 BROADWAY, 19E",2017-04-07,1008387,2017-09-29,1085000,76613,175,437.7885714285714
"230 RIVERSIDE DRIVE, 4D",2008-06-30,525000,2014-08-07,1500000,975000,2229,437.4158815612382
"36 GRAMERCY PARK EAST, 8P",2011-05-09,748413,2015-09-18,1445000,696587,1593,437.2799748901444
"53 MURRAY STREET, 6",2007-08-24,2341975,2010-01-05,2720000,378025,865,437.02312138728325
"369 BLEECKER STREET, 4",2007-08-16,2341975,2016-02-19,3700000,1358025,3109,436.80443872627853
"366 WEST 11TH   STREET, 6A",2009-12-14,1232500,2013-10-28,1850000,617500,1414,436.7043847241867
"240 RIVERSIDE BOULEVARD, 3 LM",2005-09-16,171250,2018-08-06,2225000,2053750,4707,436.3182494157638
"35 WEST 23 STREET, 3",2004-09-15,2150000,2014-10-01,3750000,1600000,3668,436.2050163576881
"330 EAST 38 STREET, 11J",2003-10-28,565000,2005-10-31,885000,320000,734,435.96730245231606
"1641 3 AVENUE, 22A",2003-02-20,490118,2007-08-07,1200000,709882,1629,435.77777777777777
"2 RIVER TERRACE, 14N",2011-12-08,2072138,2018-05-25,3100000,1027862,2360,435.53474576271185
"90 EAST END AVENUE, 4B",2012-11-13,2115000,2016-07-11,2696600,581600,1336,435.3293413173653
"333 WEST 14TH STREET, 6",2009-10-23,2000000,2018-06-29,3380000,1380000,3171,435.19394512772
"15 BROAD STREET, 1808",2006-05-18,605858,2007-06-13,776000,170142,391,435.1457800511509
"1992 BROADWAY, 20-P",2003-08-12,213039,2004-05-25,337917,124878,287,435.1149825783972
"330 SPRING STREET, 8B",2008-07-17,3027375,2015-12-03,4200000,1172625,2695,435.1113172541744
"1623 3 AVENUE, 40A",2003-02-20,669297,2006-10-17,1250000,580703,1335,434.98352059925094
"272 WATER STREET, 3R",2012-10-09,834965,2016-12-05,1495000,660035,1518,434.8056653491436
"299 WEST 12 STREET, 11B",2003-08-13,450000,2004-03-30,550000,100000,230,434.7826086956522
"1623 3 AVENUE, 22E",2003-02-20,130960,2003-11-14,247000,116040,267,434.60674157303373
"425 FIFTH AVENUE, 43A",2004-10-14,809508,2007-02-02,1175000,365492,841,434.5921521997622
"368 WEST 117TH STREET, 5B",2012-12-13,892500,2013-08-06,995000,102500,236,434.3220338983051
"101 WARREN STREET, 750",2008-08-19,1603743,2013-08-27,2400000,796257,1834,434.1641221374046
"53 NORTH MOORE STREET, 4G",2004-03-31,1281000,2008-08-14,1974000,693000,1597,433.93863494051345
"99 READE STREET, 3W",2003-11-03,950000,2010-12-10,2075000,1125000,2594,433.69313801079414
"5 FRANKLIN PLACE, 9A",2016-04-29,3464595,2017-10-24,3700000,235405,543,433.5267034990792
"534 HUDSON STREET, 3C",2010-09-22,2144000,2014-07-21,2750000,606000,1398,433.47639484978544
"141 WEST 24TH   STREET, RES-6",2011-05-17,2500000,2014-01-22,2925000,425000,981,433.2313965341488
"80 RIVERSIDE BOULEVARD, 3X",2009-11-30,999921,2011-03-07,1200000,200079,462,433.07142857142856
"21 SOUTH END AVENUE, 340",2008-07-20,413990,2015-09-28,1550000,1136010,2626,432.6009139375476
"1623 3 AVENUE, 15G",2003-03-10,262982,2005-06-10,619000,356018,823,432.5856622114216
"80 RIVERSIDE BOULEVARD, 8B/L",2009-09-22,5854937,2010-08-12,5995000,140063,324,432.2932098765432
"150 NASSAU STREET, 15A",2003-03-20,1038615,2007-07-25,1725000,686385,1588,432.2323677581864
"15 BROAD STREET, 1800",2006-04-28,906242,2008-12-22,1325000,418758,969,432.1547987616099
"650 AVENUE OF THE AMER, 6M",2011-05-06,1575000,2014-09-02,2100000,525000,1215,432.0987654320988
"139 WOOSTER STREET, 4C",2007-05-23,2072138,2016-06-10,3500000,1427862,3306,431.90018148820326
"347 WEST 57TH   STREET, 4BB",2013-10-29,435000,2014-06-06,530000,95000,220,431.8181818181818
"111 FULTON STREET, PH210",2010-12-15,999000,2016-05-31,1860000,861000,1994,431.7953861584754
"1235 PARK AVENUE, 15B",2007-01-11,400000,2017-02-23,1995770,1595770,3696,431.7559523809524
"333 RECTOR PLACE, 610",2012-01-12,975000,2015-08-13,1540000,565000,1309,431.6271963330787
"251 WEST 98TH STREET, 9C",2010-04-15,880000,2015-05-01,1675000,795000,1842,431.59609120521174
"108-12 EAST 87 STREET, 3F",2003-10-15,262500,2004-05-21,357000,94500,219,431.5068493150685
"393 WEST 49 STREET, 5NN",2003-12-29,590000,2006-08-03,999000,409000,948,431.43459915611817
"1400 5 AVENUE, TH-C2",2011-10-06,1329650,2016-11-04,2130000,800350,1856,431.22306034482756
"15 BROAD STREET, 1810",2006-05-03,1675021,2013-10-18,2850000,1174979,2725,431.1849541284404
"101 WARREN STREET, 7I",2008-05-15,2392887,2015-01-08,3440000,1047113,2429,431.08810209962945
"416 WASHINGTON STREET, 5I",2005-12-20,1781937,2016-11-18,3500000,1718063,3986,431.0243351731059
"158 WEST 23, 7",2009-05-05,1680112,2013-08-07,2350000,669888,1555,430.7961414790997
"309 EAST 49 STREET, 12F",2003-04-09,890000,2006-07-06,1400000,510000,1184,430.7432432432432
"66-72 ST. NICHOLAS AVENUE, 1G",2005-06-23,251000,2006-07-21,420000,169000,393,430.0254452926209
"70 BATTERY PLACE, 11M",2009-08-24,1629200,2014-07-22,2400000,770800,1793,429.89403234802006
"101 WARREN STREET, 2140",2009-01-13,2418343,2010-07-06,2650000,231657,539,429.79035250463824
"60 WEST 13TH STREET, 13D",2005-08-22,1125000,2008-07-28,1585000,460000,1071,429.50513538748834
"240 EAST 47TH   STREET, 41A",2009-08-10,2250000,2013-10-02,2900000,650000,1514,429.32628797886395
"260 PARK AVENUE SOUTH, 3D",2006-09-27,2011043,2016-03-15,3495000,1483957,3457,429.2614984090252
"188 EAST 70TH   STREET, 21A",2007-06-11,2600000,2009-12-29,3000000,400000,932,429.18454935622316
"145 EAST 48 STREET, 24C",2004-05-25,495000,2005-01-13,595000,100000,233,429.18454935622316
"150 CHARLES STREET, 3HS",2015-10-14,5885639,2017-06-21,6150000,264361,616,429.15746753246754
"450 WEST 17TH   STREET, 2105",2008-12-18,1196443,2015-09-18,2254000,1057557,2465,429.0292089249493
"1080 MADISON AVENUE, 6B",2003-01-31,910000,2015-01-05,2779000,1869000,4357,428.9648840945605
"145 EAST 48 STREET, 15F",2004-09-30,575311,2005-10-19,740000,164689,384,428.8776041666667
"99 JOHN STREET, 2203",2010-11-12,839999,2013-09-04,1280000,440001,1027,428.4333008763389
"217 WEST 14 STREET, 3F",2003-07-16,368000,2004-07-26,529000,161000,376,428.1914893617021
"519 WEST 135 STREET, 5A",2003-06-27,370110,2004-02-13,469000,98890,231,428.0952380952381
"1619 3 AVENUE, 20J",2003-02-20,296343,2004-11-09,565000,268657,628,427.79777070063693
"20 WEST 64TH   STREET, 35S",2015-08-26,1054680,2018-02-12,1440000,385320,901,427.6581576026637
"305 EAST 85TH   STREET, 9B",2010-12-15,1624885,2014-07-29,2190000,565115,1322,427.4697428139183
"230 RIVERSIDE DRIVE, 7A",2008-06-30,490000,2016-06-07,1729000,1239000,2899,427.38875474301483
"21 SOUTH END AVENUE, 539",2011-02-10,895000,2015-09-10,1610000,715000,1673,427.3759713090257
"60 RIVERSIDE BOULEVARD, 1107",2011-07-21,995793,2013-07-02,1300000,304207,712,427.2570224719101
"1600 BROADWAY, 15A",2006-07-25,896317,2008-05-19,1180000,283683,664,427.23343373493975
"650 AVENUE OF THE AMER, 4M",2010-06-24,1513687,2014-03-28,2100000,586313,1373,427.03058994901676
"140 WEST 22ND   STREET, 5F",2010-05-10,1175000,2013-09-09,1695000,520000,1218,426.9293924466338
"88 WEST WASHINGTON PLCE, 3C",2007-08-06,2112868,2016-06-17,3495000,1382132,3238,426.8474366893144
"22 RIVERSIDE DRIVE, 12",2007-06-20,5956762,2015-06-11,7200000,1243238,2913,426.78956402334364
"205 EAST 68 STREET, T5D",2004-01-09,330000,2005-06-03,548000,218000,511,426.61448140900194
"1485 FIFTH AVENUE, 24A",2012-06-22,830000,2015-06-17,1295000,465000,1090,426.60550458715596
"165 CHAMBERS STREET, 3H",2003-01-16,611000,2005-07-14,999000,388000,910,426.3736263736264
"1235 PARK AVENUE, 3B",2009-06-11,1370000,2017-01-09,2550000,1180000,2769,426.14662332972193
"44 EAST 12 STREET, 7B",2003-08-07,665000,2006-05-24,1100000,435000,1021,426.052889324192
"309 WEST 118 STREET, 1CTPL",2005-03-15,778961,2017-07-24,2700000,1921039,4514,425.57354895879485
"225 5 AVENUE, PHL",2011-12-27,2026317,2017-08-11,2900000,873683,2054,425.356864654333
"220 EAST 65TH STREET, 6G",2009-07-30,1500000,2014-09-23,2300000,800000,1881,425.3056884635832
"66 LEONARD STREET, 11B",2004-08-03,3250000,2013-06-10,4625000,1375000,3233,425.30157748221467
"21 ASTOR PLACE, 2G",2004-05-05,1542649,2013-09-10,2995000,1452351,3415,425.2857979502196
"50 WEST 15TH   STREET, 8D",2011-04-13,2650000,2014-10-16,3195000,545000,1282,425.1170046801872
"530 EAST 76TH STREET, 14C",2005-04-08,710000,2007-05-01,1030000,320000,753,424.9667994687915
"15 BROAD STREET, 2020",2006-05-31,1547740,2016-02-04,3050000,1502260,3536,424.8472850678733
"230 RIVERSIDE DRIVE, 6N",2008-06-30,250000,2010-04-22,530799,280799,661,424.8093797276853
"415 EAST 54TH   STREET, 4F",2014-10-31,1240000,2016-08-25,1522000,282000,664,424.69879518072287
"1 BOND STREET, 2D",2009-04-24,1195000,2014-01-07,1925000,730000,1719,424.6655031995346
"280 PARK AVENUE SOUTH, 18E",2005-06-08,1600000,2010-08-05,2400000,800000,1884,424.6284501061571
"200, 44C",2003-03-19,1125000,2003-12-15,1240000,115000,271,424.3542435424354
"280 PARK AVENUE SOUTH, 27J",2010-09-28,1050000,2016-11-14,1999999,949999,2239,424.29611433675746
"150 WEST 51 STREET, 1927A",2004-05-26,150000,2005-02-07,259000,109000,257,424.12451361867704
"161 WEST 61ST STREET, 14E",2012-10-19,800000,2016-03-10,1325000,525000,1238,424.07108239095317
"68 THOMAS STREET, 5R",2012-01-12,1900000,2016-12-20,2665000,765000,1804,424.05764966740577
"275 WEST 96 STREET, 9D",2004-04-28,799999,2006-05-11,1115000,315001,743,423.95827725437414
"311 EAST 11TH   STREET, 5A",2010-05-25,1488459,2016-12-05,2500000,1011541,2386,423.94844928751047
"1485 FIFTH AVENUE, 20C",2012-05-22,790000,2014-06-16,1110000,320000,755,423.841059602649
"322 WEST 57TH STREET, 31U1",2008-04-10,2698362,2016-01-15,3900000,1201638,2836,423.70874471086034
"225 LAFAYETTE STREET, 5D",2005-01-26,1878671,2015-03-24,3450000,1571329,3709,423.65300620113237
"333 RECTOR PLACE, 609",2012-12-21,2020000,2018-03-06,2825000,805000,1901,423.4613361388743
"92 WARREN STREET, 4(4E)",2007-02-06,1960131,2015-08-25,3282000,1321869,3122,423.40454836643175
"216-18 EAST 47 STREET, 18A",2003-06-11,435000,2004-06-23,595000,160000,378,423.2804232804233
"225 EAST 34TH STREET, 3I",2013-05-20,1390000,2016-01-14,1800000,410000,969,423.11661506707947
"330 EAST 38 STREET, 7B",2003-04-04,555000,2004-04-28,720000,165000,390,423.0769230769231
"15 UNION SQUARE WEST, 22",2012-05-04,2600000,2017-06-15,3390000,790000,1868,422.9122055674518
"162 WEST 56TH STREET, 1402",2007-07-02,640000,2008-08-07,810000,170000,402,422.88557213930346
"81 WHITE STREET, 2E",2005-08-17,1476462,2015-07-01,3000000,1523538,3605,422.61803051317617
"265 1 AVENUE, 10A",2003-05-30,360000,2004-08-10,545000,185000,438,422.3744292237443
"115 4 AVENUE, 7B",2003-11-19,779000,2007-11-29,1400000,621000,1471,422.1617946974847
"322 WEST 57TH STREET, 15D5",2012-09-25,1990678,2016-03-15,2525000,534322,1267,421.72217837411205
"540 WEST 28TH   STREET, 13A",2011-12-19,2495000,2018-03-02,3450000,955000,2265,421.6335540838852
"780 WEST END AVENUE, 7C",2012-04-10,1369000,2015-02-26,1812500,443500,1052,421.5779467680608
"25 CENTRAL PARK WEST, 10Y",2009-11-24,999921,2017-03-17,2125000,1125079,2670,421.37790262172285
"99 JOHN STREET, 401",2011-05-27,1075000,2015-02-02,1642500,567500,1347,421.30660727542687
"130 WEST 12TH STREET, 8C",2012-08-07,3258400,2017-09-29,4050000,791600,1879,421.2879191059074
"101 WARREN STREET, 3130",2009-08-26,2250000,2017-08-17,3477000,1227000,2913,421.2152420185376
"230 RIVERSIDE DRIVE, 2K",2008-06-30,255000,2010-06-17,556982,301982,717,421.17433751743374
"200 CHAMBERS STREET, 24A",2007-07-09,2998746,2016-08-18,4400000,1401254,3328,421.0498798076923
"27 WEST 72ND   STREET, 909",2010-03-17,110437,2017-04-21,1201535,1091098,2592,420.9483024691358
"330 EAST 38 STREET, 16D",2003-05-16,825000,2006-09-21,1340000,515000,1224,420.7516339869281
"11 PRINCE STREET, 5A",2004-07-06,492340,2006-07-12,802000,309660,736,420.73369565217394
"219 WEST 81ST   STREET, 12HJ",2011-07-15,1600000,2017-09-19,2550000,950000,2258,420.72630646589903
"177 EAST 77TH   STREET, 9C",2012-12-27,1495000,2018-01-24,2275000,780000,1854,420.7119741100324
"157 CHAMBERS STREET, 11C",2009-10-30,2810370,2017-07-31,3999999,1189629,2831,420.2151183327446
"58 WEST 129TH STREET, PHA",2015-07-22,1564143,2017-07-31,1875000,310857,740,420.07702702702704
"77 PARK AVENUE, 6D",2010-05-18,1050000,2015-08-05,1850000,800000,1905,419.9475065616798
"62 WEST 62 STREET, 25D",2003-07-14,758596,2008-10-28,1570000,811404,1933,419.76409725814796
"35 VESTRY STREET, 2",2004-08-26,1349181,2014-01-10,2786000,1436819,3424,419.63171728971963
"350 EAST 62 STREET, 5Q",2003-11-03,430000,2005-09-01,710000,280000,668,419.1616766467066
"635 WEST 42ND   STREET, 35K",2009-02-24,1120075,2014-07-28,1950000,829925,1980,419.1540404040404
"420 WEST 25TH   STREET, 2G",2009-05-18,1298268,2016-02-02,2325000,1026732,2451,418.9033047735618
"16 WEST 19TH   STREET, 8-F",2009-12-04,999000,2014-06-23,1695000,696000,1662,418.7725631768953
"1641 3 AVENUE, 11F",2003-02-20,369674,2004-11-03,630000,260326,622,418.53054662379424
"230 RIVERSIDE DRIVE, 4A",2008-06-30,485000,2013-11-19,1308451,823451,1968,418.4202235772358
"817 WEST END AVENUE, 1A",2008-01-16,825780,2014-06-04,1800000,974220,2331,417.94079794079795
"195 HUDSON STREET, 3D",2012-03-16,2850000,2015-10-23,3400000,550000,1316,417.93313069908817
"15 BROAD STREET, 1900",2006-08-23,1438259,2016-01-21,2875000,1436741,3438,417.9002326934264
"59 BANK STREET, 4",2004-09-17,2200000,2017-10-25,4200000,2000000,4786,417.88549937317174
"473 BROADWAY, 4W",2003-02-14,1565000,2018-08-27,3935000,2370000,5673,417.7683765203596
"395 BROADWAY, 11B",2003-05-30,690000,2005-06-09,999500,309500,741,417.67881241565453
"2148 BROADWAY, 7D",2011-09-09,5463929,2017-03-27,6310000,846071,2026,417.606614017769
"157 CHAMBERS STREET, 2B",2009-11-13,1731025,2017-07-27,2905000,1173975,2813,417.33913970849625
"350 WEST 42ND STREET, 4K",2010-04-30,218400,2014-01-06,780000,561600,1347,416.9265033407572
"25 CENTRAL PARK WEST, 11A",2008-11-05,2475000,2017-07-20,3800000,1325000,3179,416.79773513683546
"79 LAIGHT STREET, 6E",2007-05-17,3207487,2012-07-31,4000000,792513,1902,416.6735015772871
"275 WEST 96 STREET, 26B",2004-04-27,785000,2004-09-30,850000,65000,156,416.6666666666667
"99 JANE STREET, 5C",2003-03-04,1700000,2013-09-09,3300000,1600000,3842,416.4497657470068
"312 BLEECKER STREET, B2",2004-09-27,835000,2007-07-16,1260000,425000,1022,415.8512720156556
"164-68 PEARL STREET, 3C",2003-04-04,315000,2004-06-10,495000,180000,433,415.70438799076214
"519 WEST 23RD   STREET, R2",2009-09-14,1400000,2010-11-09,1575000,175000,421,415.67695961995247
"105 NORFOLK STREET, 11B",2011-02-16,1320000,2014-04-04,1795000,475000,1143,415.57305336832894
"1 MORTON SQUARE, 10B E",2004-11-30,1944857,2010-07-20,2800000,855143,2058,415.52137998056367
"319 EAST 105 STREET, 5F",2003-11-19,212500,2004-11-08,360000,147500,355,415.49295774647885
"203 WEST 90 STREET, 8F",2003-05-06,682300,2006-10-03,1200000,517700,1246,415.48956661316214
"151 WEST 21ST STREET, 8A",2014-10-29,992918,2018-06-07,1540000,547082,1317,415.40015186028853
"421 HUDSON STREET, 717",2011-12-07,1781937,2018-06-26,2775000,993063,2393,414.98662766402003
"151 WEST 17TH   STREET, 6A",2010-08-19,2250000,2011-12-14,2450000,200000,482,414.9377593360996
"133 WEST 22ND   STREET, 8B",2009-01-12,1700477,2015-04-15,2648000,947523,2284,414.8524518388792
"211 ELIZABETH STREET, 4S",2010-12-16,2403070,2014-11-24,3000000,596930,1439,414.8227936066713
"502 PARK AVENUE, 8J",2004-10-20,1405185,2012-05-11,2550000,1144815,2760,414.7880434782609
"450 WEST 17TH   STREET, 2505",2009-02-19,1349181,2014-10-03,2200000,850819,2052,414.6291423001949
"1107 BROADWAY, 9A",2015-10-27,4225737,2017-04-20,4450000,224263,541,414.53419593345654
"28 LAIGHT STREET, 2B",2005-06-23,2700000,2017-05-26,4505000,1805000,4355,414.4661308840413
"111 FULTON STREET, 401",2010-07-28,1298268,2015-07-16,2050000,751732,1814,414.4057331863286
"25 COLUMBUS CIRCLE, ST59F",2004-01-28,1872930,2017-03-16,3860000,1987070,4796,414.3181818181818
"50 FRANKLIN STREET, PHB",2010-03-02,1131575,2014-06-02,1775000,643425,1553,414.31101094655503
"1485 FIFTH AVENUE, 14B",2012-03-21,759000,2015-04-20,1225000,466000,1125,414.22222222222223
"133 WEST 22ND   STREET, PHE",2010-03-02,2341975,2017-06-28,3450000,1108025,2675,414.21495327102804
"301 WEST 57TH   STREET, 47D",2012-11-16,999999,2014-03-14,1200000,200001,483,414.0807453416149
"145 EAST 48 STREET, 15E",2004-10-19,570220,2005-06-17,670000,99780,241,414.0248962655602
"2101 BROADWAY, 15-79",2004-04-21,1626000,2007-10-09,2150000,524000,1266,413.90205371248027
"151 WEST 21ST STREET, 5C",2014-10-16,952063,2017-02-27,1310000,357937,865,413.8
"92 CHAMBERS STREET, 2",2007-09-20,992794,2012-12-17,1785000,792206,1915,413.6845953002611
"235 WEST END AVENUE, 5D",2003-09-11,470000,2015-06-24,2250000,1780000,4304,413.56877323420076
"252 7 AVENUE, 3K",2003-08-07,680000,2006-01-18,1050000,370000,895,413.4078212290503
"101 WARREN STREET, 970N",2008-07-28,2392887,2010-12-09,2750000,357113,864,413.32523148148147
"237 EAST 88TH STREET, 204",2007-09-26,346205,2008-05-15,442000,95795,232,412.9094827586207
"115 CHRISTOPHER STREET, NO.7",2013-12-23,3475000,2017-11-09,4060000,585000,1417,412.8440366972477
"49 EAST 21ST   STREET, 8A",2010-07-20,1800000,2016-02-08,2637500,837500,2029,412.76490882207986
"333 EAST 34 STREET, 14M",2004-03-11,560038,2005-08-02,770000,209962,509,412.4990176817289
"40 BOND STREET, 7C",2007-12-07,6975012,2013-05-29,7800000,824988,2000,412.494
"1641 3 AVENUE, 13G",2003-02-28,249497,2005-05-12,581000,331503,804,412.31716417910445
"2257 ADAM C POWELL BLVD, PHB",2012-07-11,726570,2015-05-04,1150000,423430,1027,412.2979552093476
"253 WEST 73RD   STREET, 4H",2007-02-16,1125000,2017-04-03,2650000,1525000,3699,412.2735874560692
"303 EAST 33RD   STREET, 5C",2011-07-20,1013158,2014-07-08,1460000,446842,1084,412.2158671586716
"52 THOMAS STREET, 4A",2008-01-22,1934675,2016-08-31,3230000,1295325,3144,411.99904580152673
"640 WEST END AVENUE, 10B",2007-02-15,120000,2015-08-25,1402500,1282500,3113,411.98201092194023
"212 EAST 95TH STREET, 2A",2010-02-17,2270531,2015-06-24,3075000,804469,1953,411.91449052739375
"22 MERCER STREET, 3D",2007-01-22,2679219,2010-09-08,3225000,545781,1325,411.91018867924527
"2 RIVER TERRACE, 8H",2014-03-31,3575000,2018-01-25,4150000,575000,1396,411.89111747851
"1049 5 AVENUE, 3A",2003-09-02,250000,2007-03-12,780000,530000,1287,411.81041181041184
"15 BROAD STREET, 1410",2006-05-10,1573196,2013-11-06,2700000,1126804,2737,411.693094629156
"80 COLUMBUS CIRCLE, NT66C",2004-02-20,2765567,2005-05-13,2950000,184433,448,411.68080357142856
"235 EAST 40TH   STREET, 33G",2003-03-26,535000,2016-10-27,2575000,2040000,4964,410.958904109589
"2 RIVER TERRACE, 6L",2011-06-23,2418343,2017-05-08,3300000,881657,2146,410.83737185461325
"350 WEST 42ND STREET, 7E",2006-04-28,556335,2007-09-18,765000,208665,508,410.75787401574803
"65 LEONARD STREET, 4",2003-07-23,960000,2011-06-30,2150000,1190000,2899,410.48637461193516
"524 EAST 72 STREET, 29E",2004-09-22,366501,2005-05-20,465000,98499,240,410.4125
"416 WASHINGTON STREET, 5H",2006-02-15,1725933,2011-08-16,2550000,824067,2008,410.39193227091636
"321 WEST 13TH STREET, 1A",2007-12-03,2500000,2015-04-06,3600000,1100000,2681,410.2946661693398
"425 FIFTH AVENUE, 44A",2004-11-17,740000,2013-08-16,2050000,1310000,3194,410.14402003757044
"230 WEST 56 STREET, 55D",2003-04-28,758596,2004-12-02,998000,239404,584,409.93835616438355
"459 WASHINGTON STREET, 5S",2003-11-06,1629200,2017-03-08,3625000,1995800,4871,409.73106138369945
"130 FULTON STREET, 7B",2006-06-20,2036500,2015-11-30,3450000,1413500,3450,409.71014492753625
"721 5 AVENUE, 45H",2006-12-05,1615000,2009-09-01,2025000,410000,1001,409.5904095904096
"252 7 AVENUE, PH-L",2003-05-01,1275000,2010-12-16,2416000,1141000,2786,409.54773869346735
"241 5 AVENUE, 5B",2013-09-30,2545625,2017-08-15,3125000,579375,1415,409.452296819788
"421 HUDSON STREET, 511",2013-11-25,2138325,2015-08-14,2395000,256675,627,409.3700159489633
"9 WEST 131 STREET, B4",2012-06-29,780000,2017-04-11,1495000,715000,1747,409.27303949627935
"60 RIVERSIDE BOULEVARD, 1207",2011-07-13,1005976,2013-06-19,1295000,289024,707,408.8033946251768
"211 MADISON AVENUE, 14B",2006-10-27,1375000,2016-01-13,2750000,1375000,3365,408.6181277860327
"1623 3 AVENUE, 32D",2003-02-20,277889,2005-05-13,610000,332111,813,408.50061500615004
"250 WEST 90 STREET, 9G",2003-10-10,450000,2004-08-11,575000,125000,306,408.4967320261438
"130 WATTS STREET, 3N",2010-07-21,1950000,2018-04-06,3100000,1150000,2816,408.3806818181818
"630 1 AVENUE, 31H",2004-06-03,745000,2006-08-08,1070000,325000,796,408.29145728643215
"610 CATHEDRAL PARKWAY, 2D",2012-04-24,1145000,2015-05-14,1600000,455000,1115,408.07174887892376
"301 WEST 110 STREET, 6P",2003-01-22,130000,2003-07-08,198000,68000,167,407.18562874251495
"1619 3 AVENUE, 14A",2003-02-20,518545,2007-08-06,1180875,662330,1628,406.83660933660934
"184 THOMPSON STREET, 3F",2007-11-28,605858,2008-07-14,699000,93142,229,406.73362445414847
"330 EAST 72ND   STREET, 14-15",2010-06-11,6000000,2015-03-30,6713000,713000,1753,406.7313177410154
"101 WARREN STREET, 1250",2007-12-14,1940377,2013-11-15,2820000,879623,2163,406.66805362921866
"425 WEST 53RD STREET, 419",2012-06-29,1850000,2017-07-18,2600000,750000,1845,406.5040650406504
"88 CHAMBERS STREET, 201",2011-06-30,1750000,2016-05-18,2475000,725000,1784,406.390134529148
"101 WARREN STREET, 9J",2008-07-14,2489621,2013-12-31,3300000,810379,1996,406.001503006012
"125 CENTRAL PARK NORTH, 7B",2006-08-28,977520,2008-02-27,1200000,222480,548,405.985401459854
"330 EAST 38TH STREET, 9P",2016-01-22,1083249,2017-08-15,1315000,231751,571,405.8686514886165
"450 WEST 17TH   STREET, 2201",2009-01-28,977520,2013-11-19,1690000,712480,1756,405.7403189066059
"650 6TH AVENUE, 2L",2014-12-15,1550000,2016-04-21,1750000,200000,493,405.67951318458415
"225 5 AVENUE, PHY",2007-11-15,2902012,2018-04-27,4450000,1547988,3816,405.65723270440253
"58 WEST 58TH   STREET, 11A",2011-04-19,955000,2013-02-25,1230000,275000,678,405.6047197640118
"9 MURRAY STREET, 8W",2013-04-29,3300000,2016-07-14,3775000,475000,1172,405.29010238907847
"78 RIDGE STREET, 5G",2012-08-07,354900,2015-04-09,750000,395100,975,405.2307692307692
"22 MERCER STREET, 4B",2007-01-11,2596537,2014-10-28,3750000,1153463,2847,405.15033368458023
"333 EAST 34 STREET, 16F",2004-04-12,446160,2005-04-27,600000,153840,380,404.8421052631579
"1080 MADISON AVENUE, 16A",2003-11-10,845000,2013-09-13,2300000,1455000,3595,404.7287899860918
"447 WEST 18TH   STREET, 7C",2009-06-02,1761317,2014-04-01,2475000,713683,1764,404.58219954648524
"1 MORTON SQUARE, 9C E",2004-11-22,1501918,2014-07-11,2925000,1423082,3518,404.51449687322344
"1619 3 AVENUE, 24D",2003-02-20,270435,2004-04-02,435000,164565,407,404.33660933660934
"1 MORTON SQUARE, 9A E",2004-11-23,916425,2008-01-31,1387000,470575,1164,404.27405498281786
"101 WARREN STREET, 1170N",2008-09-03,2540533,2016-11-22,3753750,1213217,3002,404.1362425049967
"144 WEST 27TH STREET, 2R",2006-08-10,1690000,2016-07-01,3150000,1460000,3613,404.09631884860227
"101 WEST 24TH   STREET, 6D",2009-02-26,1527375,2012-04-12,1988000,460625,1141,403.7028921998247
"322 WEST 57TH STREET, 30B2",2007-12-19,2031408,2014-07-02,2995000,963592,2387,403.683284457478
"155 WEST 70 STREET, 10A",2004-02-01,1985000,2006-06-15,2334000,349000,865,403.46820809248555
"456 WEST 19TH   STREET, 6/7B",2010-11-22,1650000,2015-07-28,2339500,689500,1709,403.4523112931539
"129 LAFAYETTE STREET, 7C",2005-01-20,1654656,2010-05-21,2440000,785344,1947,403.36106831022084
"421 EAST 13TH   STREET, PHE",2008-03-06,1909218,2014-11-14,2895000,985782,2444,403.34779050736495
"395 BROADWAY, 14A",2007-04-20,1165000,2013-01-28,2016000,851000,2110,403.3175355450237
"251 WEST 19TH   STREET, 8D",2008-04-17,2475000,2015-10-07,3575000,1100000,2729,403.0780505679736
"985 PARK AVENUE, GT",2007-12-10,7331400,2014-07-10,8300000,968600,2404,402.9118136439268
"667 LEXINGTON AVENUE, 12J",2003-12-03,395000,2005-09-09,655000,260000,646,402.4767801857585
"50 RIVERSIDE BOULEVARD, 3U",2015-08-06,1735025,2017-05-23,1999000,263975,656,402.4009146341463
"133 WEST 4TH STREET, 3",2009-01-28,1650000,2016-03-22,2700000,1050000,2610,402.2988505747126
"325 FIFTH AVENUE, 38C",2007-02-27,1491736,2014-11-14,2625000,1133264,2817,402.2946396876109
"240 RIVERSIDE BOULEVARD, 19 C",2006-01-24,2007250,2013-09-04,3125000,1117750,2780,402.068345323741
"1437 3 AVENUE, 17A",2004-02-10,1175000,2018-03-29,3250000,2075000,5161,402.05386552993605
"330 EAST 38 STREET, 29F",2004-10-13,650000,2005-11-15,810000,160000,398,402.0100502512563
"1641 3 AVENUE, 31K",2003-02-20,454983,2006-09-06,975000,520017,1294,401.8678516228748
"5 WEST 127 STREET, 2A",2013-01-02,535000,2015-02-26,850000,315000,785,401.2738853503185
"150 WEST 56TH   STREET, 5702",2010-01-11,1600000,2016-07-07,2550000,950000,2369,401.01308569016464
"1641 3 AVENUE, 29C",2003-03-27,309830,2005-07-20,649000,339170,846,400.9101654846336
"173 PERRY STREET, 9N",2008-07-24,4900000,2016-01-28,6000000,1100000,2744,400.8746355685131
"151 STANTON STREET, 151-C",2003-08-06,610000,2005-07-27,899000,289000,721,400.83217753120664
"1 CENTRAL PARK WEST, 23B",2008-04-03,5580000,2012-06-28,6200000,620000,1547,400.77569489334195
"1485 FIFTH AVENUE, 11A",2012-03-06,908279,2018-06-13,1825000,916721,2290,400.31484716157206
"165 WEST 91ST STREET, 9H",2015-05-08,446928,2017-10-06,800000,353072,882,400.3083900226757
"195 PRINCE STREET, 3W",2013-02-06,205000,2016-02-24,650000,445000,1113,399.82030548068286
"1641 3 AVENUE, 27F",2003-02-20,427300,2006-07-07,920000,492700,1233,399.59448499594487
"60 THOMAS STREET, 4",2004-01-28,1255000,2018-02-02,3300000,2045000,5119,399.4920882984958
"70 BATTERY PLACE, 21B",2010-02-18,1624108,2014-03-21,2220000,595892,1492,399.39142091152814
"100 WEST 80TH STREET, 9B",2015-07-22,4551021,2018-04-16,4950000,398979,999,399.3783783783784
"905 WEST END AVENUE, 93",2009-07-30,1748780,2015-06-01,2600000,851220,2132,399.25891181988743
"15 CHARLES STREET, 2E",2012-03-16,840056,2015-01-07,1250000,409944,1027,399.16650438169427
"170 EAST END AVENUE, 11C",2009-06-10,3767525,2014-04-30,4480000,712475,1785,399.14565826330534
"220 EAST 65TH   STREET, 17M",2007-10-19,657940,2012-01-13,1275000,617060,1547,398.87524240465416
"7 EAST 20TH STREET, 6R",2005-07-06,1880000,2010-06-16,2600000,720000,1806,398.67109634551497
"25 5 AVENUE, 9A",2008-04-28,2744183,2011-06-16,3200000,455817,1144,398.44143356643355
"304 EAST 65TH STREET, 32C",2005-04-14,1240000,2008-07-07,1710000,470000,1180,398.3050847457627
"80 RIVERSIDE BOULEVARD, 29B",2009-12-14,2805278,2015-10-05,3650000,844722,2121,398.2659123055163
"404 PARK AVENUE SOUTH, 5B",2015-01-21,1099710,2016-06-07,1300000,200290,503,398.19085487077535
"923 FIFTH AVENUE, 16A",2006-11-20,5600000,2011-09-13,6300000,700000,1758,398.1797497155859
"25 CENTRAL PARK WEST, 6K",2003-04-03,930000,2013-05-14,2400000,1470000,3694,397.9426096372496
"47 MERCER STREET, 3",2008-06-03,6350000,2016-05-03,7500000,1150000,2891,397.7862331373227
"220 RIVERSIDE BOULEVARD, 8M",2003-06-18,1360000,2008-05-01,2067500,707500,1779,397.6953344575604
"144 COLUMBUS AVENUE, 26A",2004-06-07,2365000,2013-09-10,3710000,1345000,3382,397.6936723832052
"144 COLUMBUS AVENUE, 26F",2007-04-27,2150000,2011-01-14,2690000,540000,1358,397.6435935198822
"15 BROAD STREET, 1420",2006-05-16,1430641,2011-07-01,2175000,744359,1872,397.62767094017096
"181 EAST 90TH STREET, 23B",2012-11-08,2135000,2016-05-27,2650000,515000,1296,397.37654320987656
"330 EAST 38 STREET, 7I",2003-06-10,455000,2005-02-03,695000,240000,604,397.35099337748346
"1212 5 AVENUE, 7D",2012-05-25,1522283,2014-11-12,1880000,357717,901,397.0221975582686
"330 EAST 38 STREET, 40F",2004-02-04,1155000,2008-01-10,1725000,570000,1436,396.9359331476323
"344 BOWERY, PH",2008-04-11,3864258,2010-08-05,4200000,335742,846,396.8581560283688
"530 PARK AVENUE, 5F",2014-01-16,1825000,2015-04-02,2000000,175000,441,396.8253968253968
"310 WEST 52ND STREET, 32H",2008-01-25,1950000,2014-08-15,2900000,950000,2394,396.8253968253968
"40 WEST 55TH   STREET, 8A",2010-11-15,1380000,2016-11-16,2250000,870000,2193,396.7168262653899
"19-21 WARREN STREET, 2E",2004-03-26,1150000,2008-06-17,1762500,612500,1544,396.6968911917098
"1 MORTON SQUARE, 6B W",2004-11-12,1349181,2012-06-18,2450000,1100819,2775,396.69153153153155
"5 WEST 127 STREET, 2B",2013-01-22,574192,2015-11-24,985000,410808,1036,396.5328185328185
"101 WARREN STREET, 1940",2008-11-03,2392887,2015-09-10,3385000,992113,2502,396.52797761790566
"101 WARREN STREET, 2830",2009-02-06,2596537,2014-10-29,3425000,828463,2091,396.20420851267335
"205 WEST 76TH   STREET, 8F",2009-10-27,3123625,2016-09-30,4125000,1001375,2530,395.800395256917
"101 WARREN STREET, 1050",2008-08-05,1700477,2016-01-05,2772000,1071523,2709,395.5418973791067
"100 UNITED NATIONS PLAZA, 21G",2004-08-26,1190000,2005-12-07,1375000,185000,468,395.2991452991453
"250 EAST 49TH   STREET, 22AB",2011-07-28,1710660,2014-02-04,2075000,364340,922,395.16268980477224
"800 TENTH AVENUE, 3H",2012-05-08,1054800,2014-12-01,1425000,370200,937,395.09071504802563
"1 MORTON SQUARE, 2A W",2004-11-01,1120075,2015-10-14,2700000,1579925,3999,395.08002000500124
"305 EAST 85TH   STREET, 5B",2011-04-19,1527375,2015-10-27,2180000,652625,1652,395.0514527845036
"327 CENTRAL PARK WEST, 5D",2005-05-27,31598,2015-03-02,1440000,1408402,3566,394.95288839035334
"173 EAST BROADWAY, M",2013-01-17,1715000,2018-02-21,2450000,735000,1861,394.94895217624935
"170 JOHN STREET, 3/4E",2014-06-19,1725000,2018-06-14,2300000,575000,1456,394.9175824175824
"80 PARK AVENUE, 14J",2004-06-08,1085000,2006-08-15,1400000,315000,798,394.7368421052632
"300 EAST 55TH   STREET, 8E",2012-04-17,1300000,2017-05-22,2034575,734575,1861,394.7205803331542
"280 PARK AVENUE SOUTH, 9B",2004-04-22,899000,2008-08-25,1525000,626000,1586,394.70365699873895
"25 CENTRAL PARK WEST, 5H",2003-04-16,495000,2005-07-15,819000,324000,821,394.64068209500607
"1623 3 AVENUE, 10J",2003-02-20,259788,2005-03-22,560000,300212,761,394.4967148488831
"209 WEST 111 STREET, UNIT1",2013-02-07,1190000,2017-09-01,1847500,657500,1667,394.42111577684466
"1965 BROADWAY, 24G",2006-03-28,4350000,2012-06-26,5250000,900000,2282,394.3908851884312
"32 WEST 18TH   STREET, 9B",2007-08-27,4251193,2015-08-19,5400000,1148807,2914,394.23713109128346
"1437 3 AVENUE, 8C",2009-05-01,950000,2014-06-23,1690000,740000,1879,393.82650345928687
"145 EAST 48 STREET, 9A",2003-11-10,14500,2006-03-13,350714,336214,854,393.69320843091333
"905 WEST END AVENUE, 32",2009-11-20,2185000,2011-10-26,2462500,277500,705,393.6170212765957
"195 BOWERY, 11",2006-06-26,1567444,2010-03-10,2100000,532556,1353,393.61123429416114
"2211 BROADWAY, PHA",2010-07-22,123717,2014-08-20,710000,586283,1490,393.4785234899329
"321 GREENWICH STREET, A",2004-09-14,2125000,2016-05-13,3800000,1675000,4259,393.28480864052597
"88 GREENWICH STREET, 3505",2013-03-28,795000,2015-04-30,1095000,300000,763,393.1847968545216
"133 WEST 22ND   STREET, 2F",2009-03-13,1275000,2014-03-31,2000000,725000,1844,393.1670281995662
"25 CENTRAL PARK WEST, 4C",2003-09-25,1104801,2010-09-01,2100000,995199,2533,392.8934070272404
"845 UNITED NATIONS PLAZA, 39D",2005-02-09,1580000,2006-10-13,1820000,240000,611,392.7986906710311
"200 CHAMBERS STREET, 12G",2007-05-22,1680112,2014-12-26,2770000,1089888,2775,392.75243243243244
"525 PARK AVENUE, 5C",2006-02-02,2950000,2018-05-24,4715000,1765000,4494,392.745883400089
"1 MORTON SQUARE, 3E W",2004-12-03,1781937,2017-08-07,3600000,1818063,4630,392.67019438444925
"1431 6 AVENUE, 6G",2003-03-07,275000,2004-08-23,485000,210000,535,392.5233644859813
"350 WEST 50 STREET, 4MM",2003-09-15,249693,2004-08-25,385000,135307,345,392.1942028985507
"360 EAST 88TH STREET, 15A",2009-10-30,850000,2014-02-27,1470000,620000,1581,392.15686274509807
"225 LAFAYETTE STREET, 5A",2005-01-20,1196443,2015-12-09,2755000,1558557,3975,392.08981132075473
"404 PARK AVENUE SOUTH, 6A",2014-12-01,2214693,2017-08-10,2600000,385307,983,391.970498474059
"207 EAST 57TH STREET, 16A",2007-03-28,2075000,2013-09-12,3000000,925000,2360,391.9491525423729
"252 7 AVENUE, 3B",2003-06-24,935000,2006-05-18,1350000,415000,1059,391.87913125590177
"254 PARK AVENUE SOUTH, 5P",2012-06-20,800000,2015-02-02,1175000,375000,957,391.84952978056424
"1641 3 AVENUE, 23A",2003-02-20,490118,2008-08-28,1280000,789882,2016,391.8065476190476
"240 PARK AVENUE SOUTH, 10A",2008-03-31,2734001,2015-07-23,3780000,1045999,2670,391.75992509363294
"845 UNITED NATIONS PLAZA, 5A",2004-01-21,1675000,2015-06-24,3309312,1634312,4172,391.73346116970276
"1 MORTON SQUARE, 7G W",2004-11-04,1069162,2016-01-26,2675000,1605838,4100,391.6678048780488
"15 BROAD STREET, 2710",2006-07-28,1522283,2008-08-29,1821000,298717,763,391.5032765399738
"225 WEST 83RD STREET, 7Y",2005-06-03,951000,2008-03-31,1355000,404000,1032,391.47286821705427
"368 WEST 117TH ST, 1D",2004-08-11,154641,2007-05-18,550000,395359,1010,391.44455445544554
"25 WEST HOUSTON, 4B",2006-02-10,1250000,2018-05-10,3000000,1750000,4472,391.32379248658316
"252 SEVENTH AVENUE, 12D",2005-05-02,2100000,2012-10-02,3160000,1060000,2710,391.1439114391144
"305 EAST 85TH   STREET, 7C",2010-04-28,1934675,2017-01-30,2900000,965325,2469,390.97812879708385
"62 BEACH STREET, 6C",2003-01-16,1560000,2013-06-25,3050000,1490000,3813,390.7684238132704
"456 WEST 19TH   STREET, 2/3D",2010-09-22,1747317,2017-02-07,2657500,910183,2330,390.6364806866953
"641 5 AVENUE, 48G",2005-12-15,1700000,2009-10-23,2250000,550000,1408,390.625
"39 EAST 29TH   STREET, 2D",2009-06-30,675000,2014-07-30,1400000,725000,1856,390.625
"10 WEST STREET, 33C",2003-05-16,1443369,2005-11-02,1795000,351631,901,390.2674805771365
"382 CENTRAL PARK WEST, 7D",2004-02-23,745000,2007-05-04,1200000,455000,1166,390.2229845626072
"415 GREENWICH STREET, 4D",2008-05-23,2456528,2017-06-20,3750000,1293472,3315,390.18763197586725
"101 WEST 24TH   STREET, 33A",2008-09-26,2443800,2013-05-06,3100000,656200,1683,389.8989898989899
"1623 3 AVENUE, 5C",2003-02-20,242043,2005-06-23,575000,332957,854,389.87939110070255
"238-40 EAST 47 STREET, 3E",2003-02-28,423000,2004-05-27,600000,177000,454,389.8678414096916
"200 RIVERSIDE BOULEVARD, 20H",2004-07-08,1800000,2015-01-20,3300000,1500000,3848,389.8128898128898
"207 EAST 57TH   STREET, 11A",2012-03-14,2025000,2013-06-06,2200000,175000,449,389.75501113585744
"75 WALL STREET, 26C",2013-04-26,1507010,2015-05-05,1795000,287990,739,389.702300405954
"635 WEST 42ND   STREET, 39F",2014-09-11,1700000,2015-10-01,1850000,150000,385,389.61038961038963
"220 RIVERSIDE BOULEVARD, 7L",2009-09-15,1700000,2014-05-30,2369000,669000,1718,389.4062863795111
"79 LAIGHT STREET, 5F",2004-03-15,1807394,2011-07-15,2850000,1042606,2678,389.3226288274832
"200 CHAMBERS STREET, 25F",2007-06-07,1909218,2015-12-07,3117881,1208663,3105,389.2634460547504
"1601 3 AVENUE, 18H",2003-02-20,420445,2008-04-09,1150000,729555,1875,389.096
"11 EAST 29TH   STREET, 22C",2008-05-23,1440823,2014-12-19,2375000,934177,2401,389.07830070803834
"40 EAST 66TH   STREET, 2C",2010-02-18,4327562,2013-10-23,4850000,522438,1343,389.00819061801934
"845 WEST END AVENUE, 5C",2011-09-08,2230000,2016-07-18,2920125,690125,1775,388.80281690140845
"319 EAST 105 STREET, 3D",2004-05-12,230000,2005-11-16,445000,215000,553,388.7884267631103
"3 BEDFORD STREET, 2B",2004-06-18,970000,2006-04-05,1225000,255000,656,388.719512195122
"701 MADISON AVENUE, 2B",2003-03-14,910000,2009-02-11,1750000,840000,2161,388.7089310504396
"2628 BROADWAY, 36A",2008-01-04,3334768,2010-03-15,3646000,311232,801,388.5543071161049
"200 CHAMBERS STREET, 6U",2011-10-20,462500,2017-05-08,1250000,787500,2027,388.5051800690676
"27 WEST 72ND   STREET, 710",2007-06-04,1598652,2015-02-24,2695000,1096348,2822,388.50035435861093
"220 WEST 148 STREET, PH-6F",2010-12-01,849000,2015-12-18,1565000,716000,1843,388.49701573521435
"133 WEST 22ND STREET, 10B",2011-12-01,1240000,2014-03-04,1560000,320000,824,388.3495145631068
"5 EAST 22ND STREET, 20R",2011-08-08,857500,2014-07-31,1280000,422500,1088,388.3272058823529
"333 EAST 34 STREET, 3O",2003-12-30,370110,2005-08-26,605000,234890,605,388.24793388429754
"350 WEST 50 STREET, 9D",2003-05-19,415000,2005-06-13,708500,293500,756,388.2275132275132
"335-41 EAST 51 STREET, 7H",2003-12-16,272950,2004-05-11,330000,57050,147,388.0952380952381
"20 PINE STREET, 2306",2012-10-23,1825000,2016-07-07,2350000,525000,1353,388.02660753880264
"65 WORTH STREET, PH A",2006-06-15,2443800,2011-02-01,3100000,656200,1692,387.82505910165486
"222 RIVERSIDE DRIVE, 10E",2005-08-30,875000,2006-09-08,1020000,145000,374,387.7005347593583
"130 BARROW STREET, 401",2012-09-11,1190000,2015-11-03,1635000,445000,1148,387.6306620209059
"692 BROADWAY, 1104",2008-11-19,3100000,2015-03-30,4000000,900000,2322,387.5968992248062
"40 EAST 94TH STREET, 4E",2005-05-11,1100000,2008-07-15,1550000,450000,1161,387.5968992248062
"721 5 AVENUE, 35H",2013-10-08,1650000,2016-06-02,2025000,375000,968,387.39669421487605
"382 CENTRAL PARK WEST, 14P",2003-08-13,670000,2008-01-23,1299000,629000,1624,387.3152709359606
"222 RIVERSIDE DRIVE, PH2C",2009-07-10,1285000,2013-03-01,1800000,515000,1330,387.21804511278197
"101 WARREN STREET, 2120",2008-11-17,3441685,2018-06-11,4793343,1351658,3493,386.9619238476954
"1641 3 AVENUE, 35F",2003-02-20,466495,2006-06-02,930000,463505,1198,386.8989983305509
"151 WEST 21ST STREET, 4C",2014-12-24,850238,2018-07-06,1349181,498943,1290,386.777519379845
"240 WEST END AVENUE, 14A",2010-04-12,1135000,2015-05-18,1855000,720000,1862,386.6809881847476
"30 WEST 63RD   STREET, 16H",2010-05-25,2443800,2015-10-02,3200000,756200,1956,386.60531697341514
"101 WEST 24TH   STREET, 24D",2009-05-18,1374637,2016-08-23,2400000,1025363,2654,386.34626978146196
"305 EAST 85TH   STREET, 14A",2010-07-13,1755000,2013-12-20,2240000,485000,1256,386.14649681528664
"32 EAST 76TH   STREET, 1404",2009-03-30,960000,2011-05-03,1255000,295000,764,386.1256544502618
"426 WEST BROADWAY, 4G",2007-04-27,1515000,2017-06-30,2950000,1435000,3717,386.06403013182677
"101 WARREN STREET, 1510",2008-11-24,3701338,2011-01-07,4000000,298662,774,385.86821705426354
"416 WASHINGTON STREET, 3F",2005-12-01,1288086,2018-01-11,2995000,1706914,4424,385.83047016274867
"123 3 AVENUE, 4C",2011-06-03,824200,2014-08-12,1274000,449800,1166,385.7632933104631
"136 WEST 17TH STREET, PHA",2011-06-28,3250000,2016-06-16,3950000,700000,1815,385.6749311294766
"181 EAST 90 STREET, 15A",2004-05-04,2067048,2016-04-15,3750000,1682952,4364,385.64436296975254
"88 LAIGHT STREET, 7",2007-11-08,3008664,2014-07-16,3950000,941336,2442,385.47747747747746
"333 RECTOR PLACE, 1009",2011-07-18,1090000,2016-08-02,1800000,710000,1842,385.45059717698155
"70 BATTERY PLACE, 10M",2009-07-01,1939766,2014-08-26,2665000,725234,1882,385.3528161530287
"80 PARK AVENUE, 16H",2003-06-13,473290,2005-08-04,775000,301710,783,385.32567049808426
"90 EAST END AVENUE, 8B",2003-09-29,1995000,2014-06-09,3500000,1505000,3906,385.3046594982079
"200 EAST 58 STREET, 5B",2004-07-29,610000,2006-02-07,825000,215000,558,385.3046594982079
"667 LEXINGTON AVENUE, 10H",2003-04-10,340000,2004-04-14,482500,142500,370,385.13513513513516
"1601 3 AVENUE, 14D",2003-02-20,265466,2005-04-08,565000,299534,778,385.0051413881748
"144 COLUMBUS AVENUE, 25A",2003-12-26,1775000,2010-12-02,2750000,975000,2533,384.91906829846033
"350 EAST 62 STREET, 5R",2004-05-25,525000,2005-09-19,710500,185500,482,384.85477178423236
"133 WEST 22ND   STREET, 11B",2009-08-14,1573196,2017-02-06,2625000,1051804,2733,384.85327478960846
"1049 5 AVENUE, 5B",2004-06-23,1505000,2010-06-28,2350000,845000,2196,384.7905282331512
"444 WEST 19TH STREET, PH2",2006-09-26,2335500,2017-04-06,3815000,1479500,3845,384.7854356306892
"467 CENTRAL PARK WEST, 6G",2011-07-26,330000,2013-07-15,607000,277000,720,384.72222222222223
"407 EAST 12TH STREET, 1RNW",2012-08-15,815000,2013-07-19,945000,130000,338,384.61538461538464
"386 COLUMBUS AVENUE, 10A",2004-10-22,1525000,2007-02-14,1850000,325000,845,384.61538461538464
"1619 3 AVENUE, 20C",2003-02-20,275404,2004-03-02,420000,144596,376,384.56382978723406
"220 RIVERSIDE BOULEVARD, 8E",2012-08-30,1770000,2017-05-01,2425000,655000,1705,384.1642228739003
"1965 BROADWAY, 21D",2004-07-27,950000,2006-07-13,1225000,275000,716,384.0782122905028
"260 PARK AVENUE SOUTH, 12H",2006-11-30,1629200,2013-09-25,2585000,955800,2491,383.701324769169
"101 WARREN STREET, 1550",2008-09-26,2810370,2011-05-06,3175000,364630,952,383.0147058823529
"327 CENTRAL PARK WEST, PHA",2003-01-22,1451006,2017-05-09,3450000,1998994,5221,382.8756943114346
"261 WEST 112 STREET, 1A",2010-10-07,239811,2015-12-01,960000,720189,1881,382.8755980861244
"93 WORTH STREET, 201",2014-07-17,712775,2015-11-18,900000,187225,489,382.8732106339468
"721 5 AVENUE, 62C",2006-02-10,1600000,2016-02-15,3000000,1400000,3657,382.8274541974296
"106 DUANE STREET, 2",2004-07-12,1069162,2014-12-01,2520000,1450838,3794,382.40326831839747
"270 WEST 19TH STREET, 4B",2005-11-15,1216808,2007-12-14,1507000,290192,759,382.33465085639
"5 EAST 22ND STREET, 21R",2012-12-17,915000,2014-10-15,1170000,255000,667,382.3088455772114
"240 RIVERSIDE BOULEVARD, 10D-T",2006-04-11,2300000,2013-12-09,3370000,1070000,2799,382.27938549481956
"450 WEST 17TH   STREET, 1810",2008-11-25,982611,2015-06-22,1900000,917389,2400,382.24541666666664
"170 EAST END AVENUE, 2F",2008-02-15,2575625,2010-02-02,2850000,274375,718,382.13788300835654
"1965 BROADWAY, 23A",2004-01-07,2200000,2012-04-04,3350000,1150000,3010,382.0598006644518
"5 EAST 22ND   STREET, 11M",2009-05-15,1151000,2010-06-09,1300000,149000,390,382.05128205128204
"62 WEST 62 STREET, 12B",2003-09-17,490000,2004-06-18,595000,105000,275,381.8181818181818
"279 CENTRAL PARK WEST, 8C",2005-09-21,2160000,2017-09-14,3830000,1670000,4376,381.6270566727605
"393 WEST 49 STREET, 2NN",2004-03-19,264745,2005-04-01,409000,144255,378,381.62698412698415
"1 MORTON SQUARE, 4A W",2004-10-22,941881,2013-02-13,2100000,1158119,3036,381.4621212121212
"333 EAST 34 STREET, 10O",2004-01-02,392418,2004-08-16,479000,86582,227,381.4185022026432
"350 EAST 82ND   STREET, 17C",2014-06-16,1500000,2017-02-24,1875000,375000,984,381.0975609756098
"93 GREENE STREET, 3F",2010-04-15,1900000,2013-04-08,2315000,415000,1089,381.0835629017447
"25 MURRAY STREET, 3K",2012-11-09,1364455,2016-03-15,1830000,465545,1222,380.9697217675941
"120 EAST 87TH   STREET, R8-N",2012-05-07,802000,2014-05-07,1080000,278000,730,380.82191780821915
"219 WEST 81ST   STREET, 1C",2011-03-03,1300000,2013-11-26,1680112,380112,999,380.4924924924925
"415 GREENWICH STREET, TH-E",2009-01-09,3762433,2016-06-28,4800000,1037567,2727,380.4792812614595
"114 EAST 13TH STREET, 5C",2013-03-28,1240000,2016-10-19,1735000,495000,1301,380.4765564950038
"333 RECTOR PLACE, 805",2012-06-06,1170000,2016-09-30,1770000,600000,1577,380.46924540266326
"225 EAST 34TH STREET, PHB",2010-12-21,1625000,2014-10-01,2150000,525000,1380,380.4347826086956
"350 EAST 82ND   STREET, 3M",2015-12-22,202800,2017-01-12,350000,147200,387,380.3617571059431
"301 EAST 79 STREET, 25 B",2003-02-27,747500,2006-06-27,1210000,462500,1216,380.3453947368421
"505 GREENWICH STREET, 8H",2005-01-21,1934675,2015-10-19,3425000,1490325,3923,379.8942136120316
"322 WEST 57TH   STREET, 52D2",2012-03-27,2530351,2017-12-18,3325000,794649,2092,379.85133843212236
"1601 3 AVENUE, 16E",2003-02-20,136993,2004-05-10,306000,169007,445,379.79101123595507
"25 COLUMBUS CIRCLE, ST58G",2004-01-12,2810798,2018-05-16,4800000,1989202,5238,379.7636502481863
"35 BETHUNE STREET, 4C",2007-06-05,2315000,2015-08-11,3450000,1135000,2989,379.7256607561057
"150 NASSAU STREET, 4I",2003-04-10,212940,2004-09-10,410000,197060,519,379.6917148362235
"40 EAST 61ST   STREET, 12C",2008-04-30,1725000,2017-03-01,2950000,1225000,3227,379.60954446854663
"2 COLUMBUS AVENUE, 32B",2003-07-22,1540000,2014-10-30,3100000,1560000,4118,378.8246721709568
"715 PARK AVENUE, 8E",2006-04-26,1100000,2007-08-01,1275000,175000,462,378.7878787878788
"243 WEST 60TH   STREET, 8A",2010-11-09,1200000,2013-07-26,1575000,375000,990,378.7878787878788
"15 BROAD STREET, 1112",2006-09-06,855330,2016-05-26,2200000,1344670,3550,378.78028169014084
"2000 BROADWAY, 25E",2009-01-22,985000,2016-10-04,2050000,1065000,2812,378.7339971550498
"260 PARK AVENUE SOUTH, 4D",2006-03-22,2061956,2016-10-20,3525000,1463044,3865,378.5366106080207
"130 WEST 20TH   STREET, PH10B",2009-12-23,1725000,2017-05-23,2750000,1025000,2708,378.50812407680945
"62 EAST 1ST STREET, 6N",2013-04-08,1225000,2014-09-29,1429000,204000,539,378.4786641929499
"1485 FIFTH AVENUE, 16H",2010-12-13,1030000,2017-12-20,2000000,970000,2564,378.3151326053042
"182 MULBERRY STREET, 6",2010-01-07,960000,2015-12-15,1780000,820000,2168,378.22878228782287
"300 EAST 77 STREET, 23B",2003-10-07,1920000,2007-06-04,2425000,505000,1336,377.9940119760479
"41 WEST 72 STREET, 8E",2003-04-25,472500,2005-08-12,790000,317500,840,377.9761904761905
"2211 BROADWAY, 11M",2013-02-25,4989425,2016-11-07,5500000,510575,1351,377.9237601776462
"252 7TH AVENUE, 8P",2006-06-09,2950000,2011-02-23,3600000,650000,1720,377.90697674418607
"1031 6 AVENUE, 35C",2006-08-28,560037,2007-06-15,670000,109963,291,377.87972508591065
"450 WEST 17TH STREET, 1103",2008-09-12,1247356,2016-01-28,2265000,1017644,2694,377.74461766889385
"160 WEST 66TH   STREET, 39F",2012-06-05,1350000,2015-04-30,1750000,400000,1059,377.7148253068933
"232 EAST 50TH   STREET, 1",2013-07-01,2443800,2016-10-21,2900000,456200,1208,377.64900662251654
"175 SULLIVAN STREET, 5B",2004-03-24,1222613,2016-07-27,2925000,1702387,4508,377.6368677905945
"650 AVENUE OF THE AMER, 4G",2010-05-28,1323725,2013-09-04,1775000,451275,1195,377.63598326359835
"44 MERCER STREET, 3",2013-03-22,3350000,2016-08-31,3825000,475000,1258,377.5834658187599
"230 WEST 56TH STREET, 49A",2007-09-26,3410000,2014-03-11,4300000,890000,2358,377.43850720949956
"123 3 AVENUE, 7B",2011-06-08,730000,2015-05-22,1275000,545000,1444,377.4238227146814
"1 MORTON SQUARE, 6D E",2004-11-10,1654656,2007-05-01,1995000,340344,902,377.32150776053214
"1623 3 AVENUE, 5F",2003-02-20,355256,2006-11-29,875000,519744,1378,377.17271407837444
"150 WEST 51ST   STREET, 14-24",2006-12-12,480000,2007-10-09,593500,113500,301,377.0764119601329
"150 WEST 26TH   STREET, PH",2007-12-12,3283856,2013-09-10,4075000,791144,2099,376.91472129585514
"215 EAST 80 STREET, PHF",2003-02-25,554946,2004-06-30,740000,185054,491,376.89205702647655
"29 KING STREET, 3E",2010-10-14,540000,2014-04-23,1025000,485000,1287,376.84537684537685
"240 RIVERSIDE BOULEVARD, 10 E",2005-09-22,2133600,2017-10-31,3800000,1666400,4422,376.84305744007236
"1 MORTON SQUARE, 7D E",2004-11-12,1501918,2016-02-12,3050000,1548082,4109,376.7539547335118
"195 HUDSON STREET, 2D",2003-04-24,1450000,2012-05-25,2700000,1250000,3319,376.6194636938837
"49 EAST 21ST   STREET, 8D",2008-06-26,1537000,2015-06-01,2490000,953000,2531,376.53101540892925
"252 7 AVENUE, 14C",2003-01-10,1080000,2016-04-06,2900000,1820000,4835,376.4219234746639
"75 WALL STREET, 24C",2013-01-10,1387546,2014-05-23,1575000,187454,498,376.4136546184739
"1619 3 AVENUE, 4J",2003-02-20,260144,2004-05-03,425000,164856,438,376.3835616438356
"160 CENTRAL PARK SOUTH, 860",2009-01-16,900000,2013-06-25,1510000,610000,1621,376.31091918568785
"415 EAST 54TH STREET, 8D",2004-08-19,1250000,2007-07-18,1650000,400000,1063,376.29350893697085
"225 LAFAYETTE STREET, 7C",2005-02-04,1725933,2016-03-09,3250000,1524067,4051,376.2199456924216
"117 EAST 57TH   STREET, 36A",2007-08-23,1810000,2013-05-23,2600000,790000,2100,376.1904761904762
"339 GREENWICH STREET, 3",2007-05-11,3600000,2012-07-17,4312500,712500,1894,376.1879619852165
"350 WEST 50 STREET, 4FF",2003-10-17,249693,2005-04-15,455000,205307,546,376.0201465201465
"230 RIVERSIDE DRIVE, 12B",2008-06-30,475000,2010-02-16,699000,224000,596,375.83892617449663
"82 UNIVERSITY PLACE, 4A",2010-05-14,1435732,2018-02-13,2500000,1064268,2832,375.8008474576271
"1 MORTON SQUARE, 14C E",2004-12-14,1858306,2016-07-20,3450000,1591694,4236,375.75401322001886
"101 WEST 24TH   STREET, 23C",2009-02-03,1069162,2013-09-09,1700000,630838,1679,375.72245384157236
"99 JOHN STREET, 1403",2011-01-14,1395000,2017-06-15,2275000,880000,2344,375.4266211604096
"24 WEST 45TH STREET, 2",2011-11-14,925000,2014-06-30,1285000,360000,959,375.39103232533887
"500 WEST END AVENUE, 2B",2003-02-25,2365000,2011-06-07,3500000,1135000,3024,375.33068783068785
"275 GREENWICH STREET, 4KS",2004-03-29,1250000,2015-11-30,2850000,1600000,4263,375.32254281022756
"133 WEST 22ND   STREET, 5G",2009-05-27,784052,2012-08-14,1225000,440948,1175,375.2748936170213
"80 RIVERSIDE BOULEVARD, 15A",2010-05-07,1161967,2014-08-21,1750000,588033,1567,375.26037013401407
"1 YORK STREET, 9C",2010-08-20,3431025,2015-07-08,4100000,668975,1783,375.1962983735278
"330 EAST 33RD   STREET, 3-G",2008-12-10,176235,2009-12-31,321000,144765,386,375.0388601036269
"125 WEST 21ST   STREET, 8A",2009-08-12,1650000,2017-09-19,2760000,1110000,2960,375.0
"215 WEST 95 STREET, 10K",2003-08-06,429000,2005-08-16,706700,277700,741,374.7638326585695
"1600 BROADWAY, 12F",2006-06-27,580402,2007-07-18,725000,144598,386,374.6062176165803
"122 GREENWICH AVENUE, 7",2010-01-07,2494712,2014-06-11,3100000,605288,1616,374.55940594059405
"40 BROAD STREET, 22H",2011-05-04,998312,2015-01-30,1510000,511688,1367,374.3145574250183
"115 FOURTH AVENUE, 5G",2004-11-18,925000,2007-08-17,1300000,375000,1002,374.251497005988
"2 COLUMBUS AVENUE, 8B",2012-05-01,1720000,2015-06-24,2150000,430000,1149,374.2384682332463
"93 WORTH STREET, 411",2014-01-24,778961,2016-05-31,1100000,321039,858,374.1713286713287
"106 CENTRAL PARK SOUTH, 21M",2012-01-11,575000,2016-01-20,1125000,550000,1470,374.1496598639456
"181 EAST 65TH STREET, 16D",2005-01-25,2550000,2015-08-26,3995000,1445000,3865,373.8680465717982
"252 SEVENTH AVENUE, 10X",2005-12-05,2900000,2016-07-19,4350000,1450000,3879,373.80768239236914
"123 3 AVENUE, 3C",2011-05-19,829873,2014-03-28,1220000,390127,1044,373.68486590038316
"508 BROADWAY, 4",2003-12-16,925000,2015-02-17,2450000,1525000,4081,373.6829208527322
"1965 BROADWAY, 12C",2006-06-29,1100000,2007-09-27,1270000,170000,455,373.6263736263736
"121 WEST 20TH STREET, 5E",2005-02-08,1610000,2014-07-24,2900000,1290000,3453,373.5881841876629
"200 CHAMBERS STREET, 11C",2007-05-03,1863397,2016-08-17,3131250,1267853,3394,373.5571596935769
"136 SULLIVAN STREET, 3",2004-11-05,1500136,2015-02-10,2900000,1399864,3749,373.396639103761
"129 WEST 123 STREET, 3",2012-10-22,1100000,2018-04-23,1850000,750000,2009,373.32005973120954
"1601 3 AVENUE, 22B",2003-02-20,159705,2003-11-13,259000,99295,266,373.2894736842105
"52 THOMAS STREET, 4D",2008-01-16,2138325,2016-12-08,3350000,1211675,3249,372.9378270236996
"145 EAST 48 STREET, 7E",2003-09-15,401000,2005-09-19,675000,274000,735,372.7891156462585
"201 WEST 72ND STREET, 5K",2012-02-24,910000,2014-06-18,1225000,315000,845,372.7810650887574
"225 LAFAYETTE STREET, 9C",2005-02-03,1613926,2013-11-07,2806000,1192074,3199,372.639574867146
"900 PARK AVENUE, 27E",2004-01-29,2300000,2017-12-05,4185000,1885000,5059,372.60328128088554
"11 EAST 29TH   STREET, 31A",2008-10-10,2128142,2016-04-14,3150000,1021858,2743,372.53299307327745
"225 LAFAYETTE STREET, 4D",2005-02-02,1654656,2018-08-30,3500000,1845344,4957,372.27032479322173
"350 WEST 50 STREET, 2A",2003-10-29,380250,2005-12-02,665000,284750,765,372.22222222222223
"260 PARK AVENUE SOUTH, 5F",2010-07-21,1055000,2014-04-25,1566000,511000,1374,371.90684133915573
"655 SIXTH AVENUE, 2A",2010-07-12,1390000,2017-12-21,2400000,1010000,2719,371.46009562339094
"301 EAST 79 STREET, 3 B",2003-02-13,600000,2005-12-02,980000,380000,1023,371.45650048875854
"200 WEST END AVENUE, 17D",2009-09-24,1522283,2014-05-12,2150000,627717,1691,371.2105263157895
"555 WEST 59TH   STREET, 25A",2012-10-12,1965000,2016-05-11,2450000,485000,1307,371.0788064269319
"422 EAST 72ND   STREET, 9C",2011-04-13,1200000,2015-05-05,1750000,550000,1483,370.869858395145
"70 BATTERY PLACE, 9B",2009-08-21,1315579,2014-10-20,2015000,699421,1886,370.84888653234356
"240 PARK AVENUE SOUTH, 11A",2008-04-10,2902012,2013-03-04,3565000,662988,1789,370.5913918390162
"120 RIVERSIDE BOULEVARD, 14F",2006-02-27,999186,2007-08-23,1200000,200814,542,370.50553505535055
"30 WEST 86TH STREET, 3B",2010-04-28,1750000,2014-06-04,2305000,555000,1498,370.4939919893191
"1080 MADISON AVENUE, 2A",2003-12-15,1275000,2016-10-24,3015000,1740000,4697,370.4492229082393
"252 7 AVENUE, 9I",2005-01-06,2425000,2012-12-17,3500000,1075000,2902,370.434183321847
"255 HUDSON STREET, TH2",2006-11-16,3258400,2017-02-28,4650000,1391600,3757,370.4019164226777
"100 UNITED NATIONS PLAZA, 15G",2007-01-30,100000,2018-03-05,1600000,1500000,4052,370.1875616979269
"203 WEST 81ST   STREET, 7D",2010-03-17,1193748,2010-08-16,1250000,56252,152,370.07894736842104
"123 SULLIVAN STREET, 2",2004-06-24,1900000,2017-10-19,3700000,1800000,4865,369.9897225077081
"40 BROAD STREET, 12H",2011-05-04,992673,2014-07-29,1430000,437327,1182,369.9890016920474
"140 7 AVENUE, 6G",2003-11-14,479000,2005-03-31,665000,186000,503,369.78131212723656
"25 CENTRAL PARK WEST, 12R",2004-04-08,1760000,2011-12-08,2795000,1035000,2800,369.64285714285717
"147 WAVERLY PLACE, 3W",2008-02-29,2036500,2018-04-06,3400000,1363500,3689,369.61236107346167
"30 WEST 61 STREET, 21C",2006-11-29,1675000,2014-02-18,2650000,975000,2638,369.59818043972706
"1437 3 AVENUE, 18C",2003-09-16,975000,2006-11-09,1400000,425000,1150,369.5652173913044
"135 EAST 54 STREET, 5K",2003-06-17,450000,2004-06-30,590000,140000,379,369.39313984168865
"130 WEST 19TH   STREET, THE",2007-06-29,2443800,2014-07-31,3400000,956200,2589,369.3317883352646
"259 EAST 7TH   STREET, 2B",2015-01-07,2475000,2016-04-25,2650000,175000,474,369.19831223628694
"101 WEST 24TH   STREET, PH2B",2008-10-23,3762433,2011-08-12,4140000,377567,1023,369.07820136852393
"120 RIVERSIDE BOULEVARD, 15R",2006-03-14,1935205,2009-06-18,2375000,439795,1192,368.95553691275165
"372 CENTRAL PARK WEST, 18R",2014-02-28,1850000,2016-01-07,2100000,250000,678,368.7315634218289
"106 CENTRAL PARK SOUTH, 6L",2006-12-20,650000,2008-02-15,805500,155500,422,368.4834123222749
"450 EAST 83RD   STREET, 16C",2012-07-20,1975000,2014-12-19,2300000,325000,882,368.48072562358277
"530 EAST 76 STREET, 8J",2004-02-11,485000,2005-02-25,625000,140000,380,368.42105263157896
"57 READE STREET, 11F",2012-08-16,2245241,2016-09-30,2800000,554759,1506,368.3658698539177
"301 EAST 79 STREET, 26 P",2004-07-12,567812,2006-01-26,775000,207188,563,368.0071047957371
"139 WOOSTER STREET, P2C3C",2007-07-20,4678858,2012-07-17,5350000,671142,1824,367.9506578947368
"1623 3 AVENUE, 30A",2003-02-20,562380,2015-11-19,2275000,1712620,4655,367.90977443609023
"60 RIVERSIDE BOULEVARD, 1908",2011-06-30,980520,2015-09-25,1550000,569480,1548,367.8811369509044
"372 CENTRAL PARK WEST, 4F",2003-01-03,140000,2005-10-05,510000,370000,1006,367.79324055666007
"333 EAST 45 STREET, 28A",2003-09-23,385000,2005-05-27,610000,225000,612,367.6470588235294
"479 WEST 152 STREET, 1B",2015-07-02,631315,2016-05-20,750000,118685,323,367.44582043343655
"715 PARK AVENUE, 9D",2007-02-27,1900000,2010-07-06,2350000,450000,1225,367.3469387755102
"250 EAST 40 STREET, 20F",2003-06-12,500000,2005-02-14,725000,225000,613,367.047308319739
"240 EAST 47TH STREET, 29A",2004-12-22,640000,2006-08-14,860000,220000,600,366.6666666666667
"240 EAST 46 STREET, 10B",2004-01-14,220000,2004-07-12,286000,66000,180,366.6666666666667
"381 BROOME STREET, 5",2004-02-18,809509,2007-10-18,1300000,490491,1338,366.585201793722
"110 EAST 87TH   STREET, 9C",2011-06-17,800000,2015-02-13,1290000,490000,1337,366.4921465968586
"150 WEST 56TH   STREET, 3108",2010-06-22,1675000,2014-12-29,2280000,605000,1651,366.44457904300424
"170 EAST END AVENUE, 7J/K",2008-10-06,5860028,2010-07-23,6100000,239972,655,366.36946564885494
"1 MORTON SQUARE, 2G W",2004-10-14,1476462,2014-09-05,2800000,1323538,3613,366.32659839468585
"209 WEST 104TH STREET, 1E",2011-05-26,330000,2012-11-06,524000,194000,530,366.0377358490566
"109 GREENE STREET, 5B",2005-09-14,2525000,2017-05-18,4085000,1560000,4264,365.8536585365854
"1641 3 AVENUE, 31E",2003-02-20,155447,2003-09-12,230000,74553,204,365.45588235294116
"502 PARK AVENUE, 16H",2004-09-03,1830304,2015-09-08,3300000,1469696,4022,365.41422178020883
"305 WEST 18TH STREET, 5H",2013-11-06,500000,2015-07-15,725000,225000,616,365.2597402597403
"333 RECTOR PLACE, PH6S",2013-04-16,2550000,2018-07-17,3250000,700000,1918,364.963503649635
"354 BOWERY, 2",2004-01-30,181700,2017-11-15,2020000,1838300,5038,364.8868598650258
"62 RIVINGTON STREET, 3A",2006-01-05,856348,2008-08-04,1200000,343652,942,364.81104033970274
"15 WEST 20TH STREET, 4B",2007-06-27,2469256,2015-01-13,3475000,1005744,2757,364.79651795429817
"69 WEST 106 STREET, 1A",2005-07-21,540000,2006-06-15,660000,120000,329,364.741641337386
"10 WEST END AVENUE, 27D",2009-05-27,1350000,2015-10-14,2200000,850000,2331,364.6503646503646
"240 RIVERSIDE BOULEVARD, 26 B",2006-01-13,3238313,2011-10-04,4000000,761687,2090,364.4435406698565
"210 LAFAYETTE STREET, 6F",2006-06-28,939000,2008-01-28,1150000,211000,579,364.4214162348877
"250 EAST 54 STREET, 34C",2003-03-31,570000,2004-11-10,785000,215000,590,364.40677966101697
"15 BROAD STREET, 3520",2006-12-01,2341975,2015-08-14,3500000,1158025,3178,364.38797986154816
"250 EAST 49TH   STREET, 18A",2011-02-10,778961,2013-07-24,1105000,326039,895,364.28938547486035
"200 CHAMBERS STREET, 23E",2007-06-04,1848123,2008-11-12,2040000,191877,527,364.0929791271347
"250 EAST 65TH STREET, 11H",2013-02-11,818000,2015-08-12,1150000,332000,912,364.03508771929825
"630 1 AVENUE, 31D",2004-09-29,870000,2006-07-26,1112000,242000,665,363.90977443609023
"225 5 AVENUE, 9H",2006-12-27,1135987,2008-03-19,1299000,163013,448,363.86830357142856
"93 WORTH STREET, 1006",2014-01-17,3512962,2018-02-01,4050000,537038,1476,363.8468834688347
"30 LITTLE WEST STREET, 20B",2013-05-30,1485000,2017-05-12,2010000,525000,1443,363.8253638253638
"1623 3 AVENUE, 42C",2003-02-20,314443,2004-07-14,499900,185457,510,363.6411764705882
"111 FULTON STREET, 614",2010-04-07,1200000,2013-06-20,1625000,425000,1170,363.2478632478632
"845 UNITED NATIONS PLAZA, 59A",2004-05-14,2189238,2013-07-03,3400000,1210762,3337,362.82948756367995
"109 WEST 117 STREET, 109A",2006-08-04,417160,2009-12-07,860000,442840,1221,362.6863226863227
"250 EAST 40 STREET, 32F",2003-10-28,540000,2005-10-14,800000,260000,717,362.6220362622036
"817 WEST END AVENUE, 5C",2007-10-29,807658,2013-06-07,1550000,742342,2048,362.4716796875
"260 WEST BROADWAY, 8C",2003-05-06,1300000,2017-02-16,3125000,1825000,5035,362.4627606752731
"225 LAFAYETTE STREET, 9A",2005-04-11,1359363,2016-11-30,2900000,1540637,4251,362.41754881204423
"205 EAST 85TH   STREET, PH1B",2010-08-09,4516246,2017-04-14,5400000,883754,2440,362.19426229508196
"2 COLUMBUS AVENUE, 6B",2012-01-17,1310000,2014-12-29,1700000,390000,1077,362.116991643454
"2250 BROADWAY, 15B",2005-04-22,2225000,2018-07-16,3975000,1750000,4833,362.0939375129319
"350 WEST 50 STREET, 7I",2003-08-26,375180,2005-09-23,650000,274820,759,362.0816864295125
"240 WEST 98TH STREET, 3K",2015-02-12,1642028,2018-07-31,2100000,457972,1265,362.03320158102764
"320 ALBANY STREET, 7D",2004-11-05,925000,2006-06-22,1140000,215000,594,361.95286195286195
"145 EAST 48TH STREET, 29G",2006-01-19,570000,2007-07-12,765000,195000,539,361.7810760667904
"350 WEST 42ND   STREET, 31C",2006-12-28,1395000,2010-07-06,1860000,465000,1286,361.5863141524106
"350 WEST 42 STREET, 43C",2006-09-19,1084436,2008-09-17,1348000,263564,729,361.54183813443075
"2628 BROADWAY, 10A",2007-12-03,2291062,2014-06-06,3150000,858938,2377,361.3538073201515
"38 LAIGHT STREET, PH-A",2005-12-02,3050000,2016-11-28,4500000,1450000,4014,361.23567513702045
"38 DELANCEY STREET, 9D",2010-11-05,1109892,2016-06-15,1850000,740108,2049,361.20448999511956
"200 RIVERSIDE BOULEVARD, 3M",2012-12-18,1380000,2016-05-03,1825000,445000,1232,361.2012987012987
"408 GREENWICH STREET, RES 8",2008-04-17,7850000,2012-06-18,8400000,550000,1523,361.12934996717007
"210 LAFAYETTE STREET, 3B",2012-05-31,1240000,2014-12-01,1570000,330000,914,361.05032822757113
"153 EAST 87TH   STREET, 14A",2011-08-08,876331,2015-12-14,1450000,573669,1589,361.02517306482065
"1 MORTON SQUARE, 14A E",2004-12-16,941881,2016-01-07,2400000,1458119,4039,361.0099034414459
"212 WARREN STREET, 4C",2015-12-28,2932560,2017-10-02,3165000,232440,644,360.93167701863354
"225 5 AVENUE, 8S",2007-05-09,1608835,2015-08-20,2700000,1091165,3025,360.71570247933886
"225 LAFAYETTE STREET, 12D",2005-02-17,2173690,2018-06-05,3925000,1751310,4856,360.6486820428336
"195 BOWERY, 6",2006-06-26,1729294,2014-03-27,2750000,1020706,2831,360.54609678558813
"78 RIDGE STREET, 5B",2012-07-10,372138,2014-02-07,580000,207862,577,360.2461005199307
"21 SOUTH END AVENUE, 414",2004-05-06,570000,2005-09-18,750000,180000,500,360.0
"540 WEST 28TH STREET, 3E",2011-04-04,750000,2015-01-23,1250000,500000,1390,359.71223021582733
"27 NORTH MOORE STREET, 5A",2005-08-31,2700000,2011-10-03,3500000,800000,2224,359.71223021582733
"27 WEST 72ND   STREET, 1608",2011-06-17,850000,2015-05-12,1362500,512500,1425,359.64912280701753
"52 EAST END AVENUE, 17A",2005-04-19,203038,2012-11-20,1199850,996812,2772,359.6002886002886
"240 RIVERSIDE BOULEVARD, 17 C",2005-10-17,1954750,2016-10-19,3400000,1445250,4020,359.5149253731343
"200 RIVERSIDE BOULEVARD, 45B",2008-07-02,2950000,2016-05-20,3985000,1035000,2879,359.4998263285863
"1845 ADAM C POWELL BLVD, A6D",2010-07-20,953623,2015-05-01,1581000,627377,1746,359.32245131729667
"450 WEST 17TH   STREET, 2005",2008-12-12,1160805,2016-09-06,2175000,1014195,2825,359.0070796460177
"150 WEST 51 STREET, 20-31",2004-12-07,447000,2005-09-06,545000,98000,273,358.97435897435895
"205 EAST 85TH   STREET, 14J",2010-06-09,1442137,2015-06-16,2100000,657863,1833,358.8996181123841
"100 READE STREET, 2-C",2013-06-25,1465000,2018-03-19,2085000,620000,1728,358.7962962962963
"1178 2 AVENUE, 2503",2003-05-16,499000,2005-06-10,770000,271000,756,358.46560846560845
"443 BROADWAY, 2A",2006-12-29,2146888,2009-11-18,2525000,378112,1055,358.4
"8 WARREN STREET, 3W",2010-10-18,2600000,2017-06-26,3475000,875000,2443,358.1661891117478
"505 WEST 47TH   STREET, 4B-N",2010-08-20,970000,2014-06-17,1470000,500000,1397,357.9098067287044
"520 WEST 19TH STREET, 7A",2008-09-29,2100000,2014-05-01,2830000,730000,2040,357.84313725490193
"677 WASHINGTON STREET, 9D",2003-05-12,572500,2007-10-12,1150000,577500,1614,357.80669144981414
"121 WEST 19TH STREET, 2C",2011-07-14,2150000,2015-01-15,2608000,458000,1281,357.53317720530833
"335 EAST 51ST   STREET, 4H",2013-07-15,430000,2014-01-27,500000,70000,196,357.14285714285717
"25 CENTRAL PARK WEST, 8U",2004-01-15,555000,2005-07-14,750000,195000,546,357.14285714285717
"211 ELIZABETH STREET, 3S",2010-04-12,2201965,2017-07-19,3150000,948035,2655,357.075329566855
"845 UNITED NATIONS PLAZA, 40A",2004-04-05,2175000,2015-03-10,3600000,1425000,3991,357.05337008268606
"15 WILLIAM STREET, 43A",2009-10-20,1525000,2016-07-07,2400000,875000,2452,356.8515497553018
"71 PARK AVENUE, 12B",2011-12-15,631315,2014-03-18,925000,293685,824,356.4138349514563
"88 JANE STREET, 2E",2003-03-26,1117650,2011-07-20,2200000,1082350,3038,356.2705727452271
"1 MORTON SQUARE, 2D E",2004-11-01,1094618,2011-03-22,1925000,830382,2332,356.08147512864497
"150 NASSAU STREET, 19C",2004-05-14,1693350,2006-07-14,1975000,281650,791,356.06826801517064
"90 EAST END AVENUE, 15B",2003-07-24,2275000,2010-09-03,3200000,925000,2598,356.0431100846805
"515 EAST 72ND   STREET, 24B",2010-01-19,1069162,2016-09-30,1940000,870838,2446,356.02534750613245
"234 WEST 20TH STREET, 5B",2010-07-01,1300000,2015-07-29,1960000,660000,1854,355.9870550161812
"446 WEST 47TH   STREET, 2F",2011-03-24,250000,2012-01-13,355000,105000,295,355.93220338983053
"211 EAST 46TH   STREET, 7B",2010-04-30,346120,2012-11-09,675000,328880,924,355.9307359307359
"79 LAIGHT STREET, 1B",2003-05-08,1155714,2013-04-11,2445000,1289286,3626,355.56701599558744
"70 BATTERY PLACE, 25D",2009-09-01,2291062,2013-05-10,2770000,478938,1347,355.55902004454344
"150 WEST 51 STREET, 16-31",2005-01-18,422000,2006-01-13,550000,128000,360,355.55555555555554
"421 HUDSON STREET, 301",2013-06-07,1522283,2016-09-22,1950000,427717,1203,355.5419783873649
"272 WEST 107 STREET, 10D",2011-08-17,1595000,2015-09-17,2125000,530000,1492,355.2278820375335
"635 WEST 42ND STREET, 33A",2007-06-28,1221900,2010-03-04,1570000,348100,980,355.2040816326531
"230 RIVERSIDE DRIVE, 19O",2008-06-30,414000,2010-12-21,735000,321000,904,355.08849557522126
"80 RIVERSIDE BOULEVARD, 17F",2009-12-18,1934675,2015-10-30,2695000,760325,2142,354.96031746031747
"304 WEST 115TH STREET, 1B",2011-09-01,695000,2017-11-16,1500000,805000,2268,354.9382716049383
"123 WASHINGTON STREET, 36B",2013-09-19,2026875,2016-06-24,2385000,358125,1009,354.93062438057484
"200 CHAMBERS STREET, 12C",2007-04-30,1812485,2017-01-11,3070000,1257515,3544,354.82928893905193
"505 GREENWICH STREET, 11A",2005-03-11,2036500,2014-07-22,3250000,1213500,3420,354.82456140350877
"200 CHAMBERS STREET, 26E",2007-06-15,1781937,2014-05-08,2675000,893063,2519,354.5307661770544
"462 WEST 58TH STREET, 2D",2011-02-15,1165000,2014-06-26,1600000,435000,1227,354.52322738386306
"19-21 WARREN STREET, 2W",2005-06-22,1515000,2014-12-09,2739000,1224000,3457,354.06421752964997
"5 EAST 22ND STREET, 5M",2012-09-19,900000,2018-04-10,1618000,718000,2029,353.8689009364219
"5 WEST 127 STREET, 5A",2013-01-03,620611,2015-10-30,985000,364389,1030,353.7757281553398
"165 WEST 91ST   STREET, 10D",2014-01-22,1680112,2016-02-24,1950000,269888,763,353.71952817824376
"251 WEST 19TH STREET, 9C",2005-09-12,2075000,2016-09-23,3500000,1425000,4029,353.6857781087118
"630 1 AVENUE, 19C",2003-12-02,640000,2007-11-14,1150000,510000,1443,353.4303534303534
"40 BROAD STREET, PH1A",2013-07-18,1125166,2014-12-23,1310000,184834,523,353.4110898661568
"350 WEST 50 STREET, 3GG",2003-07-24,436020,2005-07-26,695000,258980,733,353.3151432469304
"59 JOHN STREET, 4A",2012-08-20,830000,2015-05-22,1185000,355000,1005,353.23383084577114
"225 LAFAYETTE STREET, 8C",2005-01-26,1578287,2017-09-26,3212127,1633840,4626,353.18633808906185
"1437 3 AVENUE, 22B",2006-06-08,2200000,2013-02-08,3060000,860000,2437,352.89290110791956
"3 WOOSTER STREET, 4B",2005-09-29,1675021,2016-10-19,3100000,1424979,4038,352.8922734026746
"111 FULTON STREET, 506",2010-05-12,972428,2013-11-15,1425000,452572,1283,352.7451286048324
"2112 BROADWAY, 6E",2007-04-18,2443800,2014-09-19,3400000,956200,2711,352.71117668756915
"240 PARK AVENUE SOUTH, 2B",2008-07-10,3283856,2013-09-11,3950000,666144,1889,352.64372683959766
"161 GRAND STREET, 5B",2005-06-20,1995000,2016-06-15,3410000,1415000,4013,352.6040368801396
"4260 BROADWAY, 208",2006-08-24,180000,2007-10-18,328000,148000,420,352.3809523809524
"211 EAST 46TH   STREET, 20B",2008-08-08,577210,2009-11-13,740000,162790,462,352.35930735930737
"401 EAST 84 STREET, 17B",2003-06-20,675000,2006-04-21,1040000,365000,1036,352.3166023166023
"237 EAST 88TH STREET, 302",2007-11-07,402208,2008-09-08,510000,107792,306,352.26143790849676
"151 WEST 17 STREET, 11G",2003-12-19,1781938,2012-08-14,2895000,1113062,3161,352.12337867763364
"508 BROADWAY, 5",2006-05-19,1550000,2015-02-17,2675000,1125000,3196,352.00250312891114
"1890 ADAM C POWELL BLVD, 2E",2014-05-15,1139000,2017-12-15,1600000,461000,1310,351.9083969465649
"354 BROADWAY, 2",2005-05-12,2600000,2017-10-23,4200000,1600000,4547,351.8803606773697
"143 AVENUE B, 7E",2004-02-02,435000,2006-02-10,695000,260000,739,351.82679296346413
"401 EAST 60TH   STREET, 37A",2010-05-28,2725000,2016-06-08,3500000,775000,2203,351.79300953245576
"350 WEST 50 STREET, 4PP",2003-12-29,207100,2005-09-29,432000,224900,640,351.40625
"505 GREENWICH STREET, PHC",2005-05-27,2036500,2010-05-19,2675000,638500,1818,351.2101210121012
"225 5 AVENUE, 3C",2008-06-05,1552831,2015-10-26,2500000,947169,2699,350.933308632827
"1641 3 AVENUE, 29H",2003-02-20,431914,2006-10-16,900000,468086,1334,350.88905547226386
"121 WEST 20TH   STREET, 5D",2008-08-08,1675000,2016-12-28,2750000,1075000,3064,350.84856396866843
"425 CENTRAL PARK WEST, 6A",2008-04-23,788707,2015-08-28,1730000,941293,2683,350.8360044726053
"725 RIVERSIDE DRIVE, 2E",2007-06-25,161700,2008-10-31,335000,173300,494,350.80971659919027
"240 RIVERSIDE BOULEVARD, 27 B",2006-04-25,3288188,2017-05-04,4700000,1411812,4027,350.58654084926746
"2628 BROADWAY, 22B",2009-12-11,1782091,2016-12-02,2675000,892909,2548,350.43524332810046
"160 WEST 66TH STREET, 50D",2008-05-29,3850000,2011-07-15,4250000,400000,1142,350.2626970227671
"100 UNITED NATIONS PLAZA, 17F",2004-04-15,525000,2005-08-22,698000,173000,494,350.2024291497976
"514 CATHEDRAL PARKWAY, 10A",2006-01-13,962246,2008-04-14,1250000,287754,822,350.06569343065695
"160 WEST 66TH STREET, 40E",2006-11-28,2718000,2016-07-18,3950000,1232000,3520,350.0
"150 WEST 51 STREET, 41170",2003-05-22,400000,2005-12-20,730000,330000,943,349.9469777306469
"2109 BROADWAY, 5-131",2009-11-18,875000,2013-08-08,1350000,475000,1359,349.5217071376012
"1619 3 AVENUE, 19G",2003-02-20,291374,2005-07-22,600000,308626,883,349.519818799547
"120 RIVERSIDE BOULEVARD, 7J",2006-01-09,656404,2007-06-04,835000,178596,511,349.50293542074365
"519 WEST 135 STREET, 7A+ATT",2003-08-18,500000,2007-07-05,995000,495000,1417,349.32956951305573
"363 GREENWICH STREET, 4A",2004-07-30,3800000,2013-03-14,4900000,1100000,3149,349.31724356938713
"60 RIVERSIDE BOULEVARD, 1510",2011-07-06,858330,2013-10-18,1150000,291670,835,349.3053892215569
"252 SEVENTH AVENUE, 5W",2006-07-20,1710000,2013-12-02,2650000,940000,2692,349.1827637444279
"60 RIVERSIDE BOULEVARD, 1210",2011-07-07,817600,2013-09-23,1100000,282400,809,349.0729295426452
"88 JANE STREET, 5E",2003-10-15,985000,2015-09-03,2500000,1515000,4341,348.9979267449896
"123 WASHINGTON STREET, PH54B",2011-12-28,2158690,2017-05-31,2850000,691310,1981,348.97021706208983
"514 CATHEDRAL PARKWAY, 3D",2005-05-23,458773,2008-06-20,851000,392227,1124,348.95640569395016
"150 EAST 86TH   STREET, 9D",2010-05-12,3764346,2014-07-11,4295000,530654,1521,348.8849441157133
"163 WEST 18TH   STREET, 8C",2008-02-04,1550000,2014-12-17,2425000,875000,2508,348.8835725677831
"45 WEST 67TH STREET, 18A",2004-10-07,1300000,2015-12-15,2725000,1425000,4086,348.7518355359765
"324 PEARL STREET, 4J/K",2003-07-24,380000,2010-09-29,1295000,915000,2624,348.7042682926829
"515 EAST 72ND   STREET, 37B",2012-12-14,3825000,2014-04-30,4000000,175000,502,348.60557768924303
"350 WEST 50 STREET, 17C",2003-08-08,357561,2005-08-16,615000,257439,739,348.36129905277403
"505 GREENWICH STREET, 12C",2005-03-29,896060,2013-05-13,1929583,1033523,2967,348.3394000674082
"200 CHAMBERS STREET, 4B/C",2007-02-22,3436593,2016-05-11,4608888,1172295,3366,348.2754010695187
"706 RIVERSIDE DRIVE, 5B",2012-04-17,60000,2017-10-18,760000,700000,2010,348.2587064676617
"257 WEST 117 STREET, 2E",2012-07-24,613495,2015-05-29,975000,361505,1039,347.93551491819056
"238 EAST 47 STREET, 10A",2004-09-30,390000,2005-05-18,470000,80000,230,347.82608695652175
"250 EAST 53RD STREET, 504",2008-07-21,1641553,2010-01-14,1830000,188447,542,347.68819188191884
"217 2 AVENUE, 3",2004-03-18,960000,2008-05-06,1485000,525000,1510,347.682119205298
"22 WEST 15TH STREET, 4J",2005-07-08,525000,2006-11-09,695000,170000,489,347.6482617586912
"333 RECTOR PLACE, 301",2011-05-24,329550,2013-05-28,585000,255450,735,347.55102040816325
"322 WEST 57TH   STREET, 18G",2011-02-08,785000,2016-11-10,1515000,730000,2102,347.2882968601332
"1 MORTON SQUARE, 5D W",2004-10-27,1807468,2010-09-27,2557500,750032,2161,347.07635354002775
"327 CENTRAL PARK WEST, 6D",2005-05-27,11753,2016-02-02,1366305,1354552,3903,347.0540609787343
"250 EAST 49TH   STREET, 12C",2011-04-13,1349181,2014-12-01,1810000,460819,1328,347.00225903614455
"225 WEST 83 STREET, 8I",2003-06-09,530000,2005-06-13,785000,255000,735,346.9387755102041
"845 UNITED NATIONS PLAZA, 63A",2004-08-30,2367431,2011-08-18,3250000,882569,2544,346.9217767295597
"905 WEST END AVENUE, 124",2010-05-21,1705568,2013-07-01,2100000,394432,1137,346.905892700088
"255 HUDSON STREET, 10B",2009-08-03,1410000,2014-05-14,2015000,605000,1745,346.7048710601719
"1485 5 AVENUE, 1819B",2012-08-21,1105000,2017-05-01,1699000,594000,1714,346.5577596266044
"240 RIVERSIDE BOULEVARD, 24 C",2005-10-27,2248078,2007-10-24,2500000,251922,727,346.52269601100414
"101 WEST 24TH STREET, 17E",2011-02-08,1567500,2017-06-27,2375000,807500,2331,346.4178464178464
"415 EAST 37TH   STREET, 14F",2011-10-27,770000,2016-08-22,1380000,610000,1761,346.39409426462237
"422 WEST 20TH   STREET, 2G",2013-01-17,1221900,2017-10-25,1825000,603100,1742,346.21125143513206
"300 ALBANY STREET, 9I",2005-03-16,650000,2007-04-19,914500,264500,764,346.2041884816754
"1 RIVER TERRACE, 10N",2008-12-29,1713205,2017-05-23,2775000,1061795,3067,346.1998695793935
"401 WASHINGTON STREET, 4A",2015-09-28,3900000,2017-04-28,4100000,200000,578,346.02076124567475
"200 CHAMBERS STREET, 4A",2007-06-21,2560898,2010-07-20,2950000,389102,1125,345.86844444444444
"817 WEST END AVENUE, 11B",2007-10-18,967972,2013-04-10,1660000,692028,2001,345.84107946026984
"140 WEST 23RD   STREET, C2",2016-02-18,1950000,2016-08-24,2015000,65000,188,345.74468085106383
"25 MURRAY STREET, 4E",2008-09-23,1929583,2014-08-19,2675000,745417,2156,345.74072356215214
"200 WEST END AVENUE, 4C",2008-08-06,1809808,2014-06-17,2550000,740192,2141,345.72255955161137
"77 READE STREET, 2B",2012-03-26,2125000,2018-06-01,2905500,780500,2258,345.65987599645706
"225 LAFAYETTE STREET, 5B",2005-01-25,1074253,2015-09-24,2420000,1345747,3894,345.5950179763739
"706 RIVERSIDE DRIVE, 5C",2012-04-17,204000,2018-07-24,995000,791000,2289,345.565749235474
"150 EAST 85 STREET, 9F",2004-01-27,446160,2005-05-05,606500,160340,464,345.5603448275862
"360 EAST 88TH STREET, 30A",2010-05-04,1450000,2015-06-29,2100000,650000,1882,345.3772582359192
"212 EAST 95TH   STREET, 7B",2012-12-11,1085000,2018-02-05,1735000,650000,1882,345.3772582359192
"350 WEST 42ND   STREET, 24L",2006-12-28,750000,2009-05-15,1050000,300000,869,345.22439585730723
"25 CENTRAL PARK WEST, 2A",2003-10-21,685000,2006-04-06,995000,310000,898,345.21158129175944
"985 PARK AVENUE, 1213",2007-12-24,5702200,2012-09-20,6300000,597800,1732,345.15011547344113
"27 WEST 72ND   STREET, 607",2010-03-17,123232,2017-12-15,1100000,976768,2830,345.14770318021203
"1400 FIFTH AVENUE, 2K",2004-11-18,273215,2007-06-20,599000,325785,944,345.1112288135593
"15 CHARLES STREET, PHB",2015-10-16,1700000,2018-05-15,2025000,325000,942,345.0106157112526
"250 EAST 65TH STREET, 10C",2012-06-15,1100000,2016-08-15,1625000,525000,1522,344.94086727989486
"64 NORTH MOORE STREET, 2W",2003-05-27,940000,2008-06-10,1575000,635000,1841,344.9212384573601
"311 WEST BROADWAY, 5H",2011-08-02,2371443,2015-10-13,2900000,528557,1533,344.7860404435747
"1641 3 AVENUE, 23G",2003-02-20,269371,2006-01-30,640000,370629,1075,344.7711627906977
"1 MORTON SQUARE, 2B W",2004-11-08,992793,2018-04-05,2680000,1687207,4896,344.609272875817
"203 WEST 90 STREET, 3F",2003-02-28,431000,2006-05-01,830000,399000,1158,344.559585492228
"1485 FIFTH AVENUE, 13H",2012-05-10,882000,2018-01-23,1600000,718000,2084,344.5297504798464
"255 EAST 74TH STREET, 16B",2009-01-13,2336883,2013-10-31,2940000,603117,1752,344.24486301369865
"1 RIVER TERRACE, 22B",2010-04-06,1545000,2013-06-11,1945000,400000,1162,344.2340791738382
"252 WEST 30TH STREET, 5A",2010-04-15,1325000,2017-03-31,2200000,875000,2542,344.2171518489378
"350 WEST 42ND   STREET, PH C",2007-03-19,1522283,2014-12-30,2500000,977717,2843,343.90327119240237
"115 MERCER STREET, 2B",2007-10-15,2700000,2013-02-28,3375000,675000,1963,343.8614365766684
"110 WEST 86 STREET, 16E",2003-07-10,530000,2004-06-23,650000,120000,349,343.8395415472779
"630 1 AVENUE, 25S",2003-06-27,400000,2005-11-01,695000,295000,858,343.8228438228438
"65 WORTH STREET, 3A",2005-10-11,2367431,2007-03-26,2550000,182569,531,343.8210922787194
"160 WADSWORTH AVENUE, 200",2003-09-12,90000,2004-06-29,190000,100000,291,343.64261168384877
"845 UNITED NATIONS PLAZA, 63D",2004-04-02,1654656,2014-12-22,3000000,1345344,3916,343.55056179775283
"200 WEST END AVENUE, 15F",2008-05-01,4938512,2013-02-20,5541667,603155,1756,343.48234624145783
"1641 3 AVENUE, 27H",2003-02-20,423398,2007-04-19,945000,521602,1519,343.38512179065174
"393 WEST 49 STREET, 2I",2003-12-17,275808,2006-01-10,535000,259192,755,343.30066225165564
"220 WEST 148 STREET, 4F",2012-02-23,720000,2016-01-21,1210000,490000,1428,343.1372549019608
"350 WEST 42ND STREET, 15I",2006-06-13,501930,2007-11-14,680000,178070,519,343.10211946050094
"200 EAST 66TH STREET, E1204",2013-08-02,2582663,2016-12-01,3000000,417337,1217,342.9227608874281
"1965 BROADWAY, 14H",2005-01-18,1798000,2015-06-12,3100000,1302000,3797,342.90229128259153
"2250 BROADWAY, 3J",2003-10-30,465000,2005-10-31,716000,251000,732,342.89617486338796
"1623 3 AVENUE, 17E",2003-02-20,125635,2004-04-22,272000,146365,427,342.7751756440281
"263 9 AVENUE, 2E",2006-03-23,1221900,2013-08-21,2150000,928100,2708,342.725258493353
"15 BROAD STREET, 2024",2006-12-28,631315,2010-08-13,1085000,453685,1324,342.66238670694867
"21 ASTOR PLACE, 6A",2003-12-30,911334,2014-09-10,2250000,1338666,3907,342.63271051958026
"30 WEST 63RD   STREET, 8U",2010-03-22,560037,2016-02-19,1300000,739963,2160,342.57546296296294
"70 BATTERY PLACE, 19G",2011-09-07,1315000,2014-02-28,1625000,310000,905,342.5414364640884
"146 CHAMBERS STREET, 3",2008-01-04,1822667,2015-06-04,2750000,927333,2708,342.442023633678
"21 SOUTH END AVENUE, PH1Y",2011-03-01,1225000,2016-11-16,1939030,714030,2087,342.13224724484905
"200 EAST 89 STREET, 16A",2003-11-18,375000,2004-05-26,440000,65000,190,342.10526315789474
"225 FIFTH AVENUE, 3A",2007-07-24,2100000,2014-11-19,3015000,915000,2675,342.05607476635515
"150 WEST 56TH STREET, 4103",2009-10-01,1250000,2012-10-16,1630000,380000,1111,342.034203420342
"2077 5 AVENUE, 3C",2012-04-11,697501,2015-11-25,1150000,452499,1323,342.0249433106576
"473 BROADWAY, 5E",2005-04-25,2100000,2011-04-28,2850000,750000,2194,341.84138559708293
"99 JOHN STREET, 1502",2011-04-19,900000,2015-05-20,1410000,510000,1492,341.8230563002681
"15 BROAD STREET, 1120",2006-08-31,1210000,2017-12-01,2614150,1404150,4110,341.64233576642334
"21 ASTOR PLACE, 6B",2004-05-21,1120075,2017-10-12,2790000,1669925,4892,341.3583401471791
"350 WEST 50 STREET, 4Z",2003-11-26,214271,2005-10-17,450000,235729,691,341.14182344428366
"80 JOHN STREET, 3B",2007-05-23,910293,2007-12-28,985000,74707,219,341.12785388127855
"305 EAST 85TH   STREET, 8B",2010-04-09,1622072,2014-04-23,2125000,502928,1475,340.9681355932203
"100 WEST 58TH   STREET, 13F",2009-08-17,1196443,2014-04-25,1780000,583557,1712,340.8627336448598
"99 JOHN STREET, 922",2010-12-29,895000,2015-04-17,1430000,535000,1570,340.7643312101911
"220, 5E",2003-02-12,535000,2004-05-12,690000,155000,455,340.65934065934067
"259 EAST 7TH STREET, 2A",2007-10-12,1629200,2013-11-08,2385000,755800,2219,340.6038756196485
"205 EAST 68 STREET, T6B",2003-07-31,315000,2005-08-03,565000,250000,734,340.59945504087193
"161 WEST 61ST   STREET, 12C",2014-02-21,860000,2017-01-13,1220000,360000,1057,340.58656575212865
"51 WALKER STREET, 5B",2007-01-10,1853215,2016-03-31,3000000,1146785,3368,340.49435866983373
"425 FIFTH AVENUE, 30E",2004-05-05,631315,2008-03-11,1110000,478685,1406,340.4587482219061
"129 LAFAYETTE STREET, 8A",2004-12-21,2087412,2013-02-12,3100000,1012588,2975,340.36571428571426
"301 EAST 79TH   STREET, 14 H",2009-11-03,837500,2013-07-24,1300000,462500,1359,340.3237674760854
"150 NASSAU STREET, 12B",2003-03-27,1619017,2017-05-31,3380000,1760983,5179,340.0237497586407
"1838 2 AVENUE, 5B",2003-10-16,399000,2005-03-02,570000,171000,503,339.96023856858847
"367 BLEECKER STREET, 5",2008-07-28,203615,2014-09-03,960000,756385,2228,339.4905745062837
"121 EAST 23RD STREET, 19B",2009-06-30,997885,2014-09-30,1649000,651115,1918,339.4760166840459
"55 WALL STREET, 715",2009-07-10,450000,2010-01-22,516525,66525,196,339.41326530612247
"15 BROAD STREET, 3910",2008-03-14,2952925,2017-06-15,4100000,1147075,3380,339.3713017751479
"21 MERCER STREET, 5",2006-11-10,4769000,2012-10-03,5500000,731000,2154,339.3686165273909
"2000 BROADWAY, 9G",2010-08-12,699000,2011-07-20,815000,116000,342,339.1812865497076
"380 RECTOR PLACE, 12H",2003-05-30,850000,2008-08-28,1500000,650000,1917,339.0714658320292
"408 EAST 79TH STREET, 8B",2005-12-02,1899036,2014-05-29,2950000,1050964,3100,339.0206451612903
"157 EAST 74 STREET, 3C",2003-01-28,1500000,2003-11-19,1600000,100000,295,338.9830508474576
"66 LEONARD STREET, 12A",2003-05-21,2250000,2018-05-01,4100000,1850000,5459,338.889906576296
"400 CENTRAL PARK WEST, 6K",2004-08-12,610000,2006-02-09,795000,185000,546,338.82783882783883
"70 BATTERY PLACE, 28C",2010-05-13,1822667,2013-05-31,2200000,377333,1114,338.7190305206463
"311 WEST BROADWAY, 3I",2010-01-04,2472356,2017-08-31,3419000,946644,2796,338.57081545064375
"14 EAST 33RD   STREET, 5N",2010-07-21,1390000,2017-11-29,2300000,910000,2688,338.5416666666667
"1485 FIFTH AVENUE, 25C",2012-07-26,816000,2016-05-04,1282500,466500,1378,338.5341074020319
"1623 3 AVENUE, 7E",2003-02-20,117117,2005-01-05,349000,231883,685,338.51532846715327
"845 UNITED NATIONS PLAZA, 60A",2003-10-24,2341975,2012-07-13,3420000,1078025,3185,338.46938775510205
"450 WEST 17TH   STREET, 2301",2009-01-07,987702,2016-03-15,1875000,887298,2624,338.1471036585366
"455 CENTRAL PARK WEST, 9",2006-02-15,5089468,2010-08-31,5650000,560532,1658,338.07720144752716
"115 4 AVENUE, 7F",2008-05-01,2020000,2015-06-17,2900000,880000,2603,338.0714560122935
"302 WEST 12TH   STREET, 15D",2008-03-31,1280000,2017-04-26,2400000,1120000,3313,338.06217929369154
"260 PARK AVENUE SOUTH, 4G",2009-07-23,1695000,2012-09-04,2080000,385000,1139,338.01580333625986
"53 NORTH MOORE STREET, 3A",2003-12-16,1330000,2011-10-25,2300000,970000,2870,337.97909407665503
"421 HUDSON STREET, 501",2003-09-22,605000,2008-10-15,1230000,625000,1850,337.8378378378378
"344 BOWERY, 4",2007-12-05,2265606,2013-11-04,2995000,729394,2161,337.5261453031004
"311 WEST BROADWAY, 8A",2010-06-17,3750000,2013-04-19,4100000,350000,1037,337.5120540019286
"1619 3 AVENUE, 9J",2003-02-20,268660,2005-05-19,545000,276340,819,337.4114774114774
"1 MORTON SQUARE, 14C W",2004-12-15,1883762,2011-06-02,2680000,796238,2360,337.38898305084746
"835 BROADWAY, 5E",2005-06-27,1985587,2012-04-27,2827500,841913,2496,337.3048878205128
"407 EAST 12TH   STREET, 1RNE",2012-04-24,1350000,2017-02-07,1940000,590000,1750,337.14285714285717
"421 HUDSON STREET, 306",2004-08-16,1450000,2018-03-28,3125000,1675000,4972,336.88656476267096
"416 WASHINGTON STREET, 5K",2006-01-17,941881,2014-08-25,2000000,1058119,3142,336.76607256524505
"30 EAST 37TH STREET, 7G",2007-02-16,177187,2008-09-26,375180,197993,588,336.72278911564626
"450 WEST 17TH   STREET, 1702",2008-12-22,913624,2011-04-22,1200000,286376,851,336.51703877790834
"30 LITTLE WEST STREET, 12B",2011-06-07,1200000,2017-06-29,1945000,745000,2214,336.4950316169828
"88 CHAMBERS STREET, 401",2007-06-08,1680112,2015-09-25,2700000,1019888,3031,336.4856483008908
"171 EAST 84 STREET, 6D2",2004-06-07,600000,2006-06-20,850000,250000,743,336.47375504710635
"310 WEST 52ND STREET, PHB",2008-06-13,3614787,2015-12-09,4535000,920213,2735,336.4581352833638
"77 READE STREET, 2F",2012-04-13,2087413,2018-04-30,2830000,742587,2208,336.3165760869565
"285 LAFAYETTE STREET, 3E",2004-06-07,3551000,2012-03-01,4500000,949000,2824,336.04815864022663
"200 CHAMBERS STREET, 4H",2007-03-21,1288086,2017-07-28,2558500,1270414,3782,335.91062929666845
"33 WEST 56TH   STREET, 9C",2010-12-14,3300000,2014-03-19,3700000,400000,1191,335.8522250209908
"220 RIVERSIDE BOULEVARD, 45A",2005-12-08,3175000,2015-01-04,4287500,1112500,3314,335.69704284852145
"260 PARK AVENUE SOUTH, 12G",2006-09-07,1588470,2016-12-21,2850000,1261530,3758,335.691857370942
"53 NORTH MOORE STREET, 5B",2003-01-08,1050000,2015-08-31,2600000,1550000,4618,335.64313555651796
"40 WEST 116TH STREET, A1203",2014-08-13,1393750,2017-09-07,1770000,376250,1121,335.63782337198927
"200 WEST END AVENUE, 9A",2008-02-11,1659747,2016-05-24,2675000,1015253,3025,335.620826446281
"235 WEST END AVENUE, 3D",2006-10-12,675000,2007-08-06,775000,100000,298,335.5704697986577
"52 THOMAS STREET, 3A",2008-06-27,1883762,2017-07-07,2990000,1106238,3297,335.52866242038215
"43 EAST 25TH   STREET, 21C",2013-09-23,900000,2015-06-11,1110000,210000,626,335.4632587859425
"220 EAST 65 STREET, 5D",2004-02-10,475000,2006-07-24,775000,300000,895,335.195530726257
"124 WEST 24TH STREET, 2A",2007-10-30,1014686,2014-06-13,1825000,810314,2418,335.1174524400331
"57 READE STREET, 17C",2012-08-22,1558000,2015-06-09,1900000,342000,1021,334.9657198824682
"2 COLUMBUS AVENUE, 14B",2010-04-28,1550000,2014-04-30,2040000,490000,1463,334.9282296650718
"1049 FIFTH AVENUE, 7A",2007-02-01,4300000,2012-10-22,5000000,700000,2090,334.9282296650718
"235 EAST 40 STREET, 41G",2003-11-25,645000,2004-07-06,720000,75000,224,334.82142857142856
"280 PARK AVENUE SOUTH, 3D",2010-02-25,795000,2012-01-13,1025000,230000,687,334.78893740902475
"224 WEST 18 STREET, 4C",2003-08-08,501930,2006-05-11,839000,337070,1007,334.7269116186693
"99 JANE STREET, 5E",2003-02-28,1150000,2010-12-09,2100000,950000,2841,334.3892995424146
"133 2 AVENUE, 9",2009-02-20,800000,2014-10-02,1485000,685000,2050,334.1463414634146
"30 LITTLE WEST STREET, 24C",2013-05-06,1180000,2016-10-14,1600000,420000,1257,334.1288782816229
"1 MORTON SQUARE, 6C E",2004-11-04,1578287,2011-02-01,2340000,761713,2280,334.08464912280704
"200 CHAMBERS STREET, PHB",2007-08-31,2064501,2013-09-10,2800000,735499,2202,334.0140781108084
"505 GREENWICH STREET, PHD",2005-05-10,2341975,2017-09-19,3850000,1508025,4515,334.0033222591362
"22 WEST 66TH   STREET, 15",2007-01-30,3450000,2015-09-09,4500000,1050000,3144,333.96946564885496
"114 EAST 13TH STREET, 4D",2015-07-16,1271415,2017-03-17,1475000,203585,610,333.74590163934425
"1 BOND STREET, 4D",2006-08-30,1565000,2013-08-20,2415000,850000,2547,333.7259521005104
"112 WEST 18TH   STREET, 17-4D",2009-11-19,1070000,2016-04-14,1850000,780000,2338,333.6184773310522
"252 7 AVENUE, 4J",2003-12-10,1075000,2014-11-24,2410000,1335000,4002,333.5832083958021
"780 WEST END AVENUE, 2A",2004-08-12,2118000,2013-08-29,3220000,1102000,3304,333.5351089588378
"425 FIFTH AVENUE, 33B",2005-02-09,677136,2008-04-02,1060000,382864,1148,333.50522648083626
"252 SEVENTH AVENUE, 17B",2004-09-24,1750000,2011-12-01,2625000,875000,2624,333.4603658536585
"72-74 EAST 3RD STREET, 3D",2014-06-25,899000,2015-02-20,979000,80000,240,333.3333333333333
"350 WEST 57 STREET, 10G",2003-05-08,730000,2005-07-11,995000,265000,795,333.3333333333333
"215 WEST 95 STREET, 15E",2004-05-18,350000,2006-10-11,642000,292000,876,333.3333333333333
"150 WEST 51 STREET, 15-1",2003-07-17,280000,2005-09-01,539000,259000,777,333.3333333333333
"88 JANE STREET, C",2008-12-23,1700000,2017-03-14,2700000,1000000,3003,333.000333000333
"400 CENTRAL PARK WEST, 1B",2004-06-02,454000,2006-03-10,669100,215100,646,332.9721362229102
"25 CENTRAL PARK WEST, 7N",2007-01-09,3900000,2012-09-06,4588000,688000,2067,332.8495403967102
"350 ALBANY STREET, 12C",2014-11-20,705000,2016-07-28,910000,205000,616,332.7922077922078
"340 EAST 64TH   STREET, 10C",2014-03-28,1300000,2016-09-12,1599000,299000,899,332.5917686318131
"354 BROADWAY, 5",2005-05-10,2850000,2013-10-04,3870000,1020000,3069,332.355816226784
"1 MORTON SQUARE, 4B W",2004-10-29,1043781,2013-07-12,2100000,1056219,3178,332.35336689741973
"845 UNITED NATIONS PLAZA, 9A",2004-02-04,1895000,2015-09-02,3300000,1405000,4228,332.3084200567644
"1178 2 AVENUE, 2103",2004-03-31,577500,2005-01-26,677500,100000,301,332.22591362126246
"303 EAST 33RD   STREET, 4P",2011-03-23,1150622,2015-08-26,1687500,536878,1617,332.02102659245514
"147 WAVERLY PLACE, 1E",2008-06-13,911333,2009-02-05,990000,78667,237,331.9282700421941
"100 RIVERSIDE BOULEVARD, 31A",2008-08-15,1428956,2014-12-10,2195000,766044,2308,331.90814558058923
"101 WARREN STREET, 1430",2008-09-18,2011043,2017-12-12,3130000,1118957,3372,331.83778173190984
"101 WARREN STREET, 1160M",2008-09-04,3171848,2014-06-24,3875000,703152,2119,331.8319962246343
"416 WASHINGTON STREET, 2H",2005-12-02,1934675,2017-09-06,3360000,1425325,4296,331.77956238361264
"655 6 AVENUE, 5L",2007-07-10,1186261,2007-12-19,1240000,53739,162,331.72222222222223
"300 EAST 77TH STREET, 24B",2009-09-17,2000000,2016-09-23,2850000,850000,2563,331.6426063207179
"295 GREENWICH STREET, 2GN",2004-06-18,570000,2007-08-08,950000,380000,1146,331.58813263525303
"11 EAST 70TH   STREET, 4B",2007-01-18,1610000,2013-05-14,2375000,765000,2308,331.4558058925477
"124 WEST 24TH STREET, 2D",2007-10-30,1454973,2015-03-23,2350000,895027,2701,331.36875231395777
"99 JANE STREET, 6L",2004-05-06,1125000,2015-09-16,2500000,1375000,4150,331.32530120481925
"260 PARK AVENUE SOUTH, 3G",2006-08-21,1650000,2014-02-27,2560000,910000,2747,331.2704768838733
"301 CATHEDRAL PARKWAY, 7N",2007-05-25,250000,2011-05-13,730000,480000,1449,331.26293995859214
"200 CHAMBERS STREET, 21F",2007-05-15,2102686,2016-11-08,3250000,1147314,3465,331.1151515151515
"350 WEST 50 STREET, 4M",2003-10-09,245781,2005-02-01,405000,159219,481,331.016632016632
"502 PARK AVENUE, 15C",2005-01-27,1290122,2013-03-22,2275000,984878,2976,330.940188172043
"101 WARREN STREET, 2330",2009-02-27,2326701,2016-08-05,3225000,898299,2716,330.74337260677464
"200 EAST 89TH STREET, 27B",2010-06-30,1120000,2015-08-03,1735000,615000,1860,330.64516129032256
"354 BOWERY, 3",2003-10-10,164450,2015-01-15,1525000,1360550,4115,330.6318347509113
"30 EAST 85TH STREET, 9C",2007-02-21,1535000,2014-02-05,2375000,840000,2541,330.57851239669424
"10 EAST 14TH   STREET, 1",2007-01-04,920400,2012-03-08,1545000,624600,1890,330.4761904761905
"15 BROAD STREET, 2124",2006-08-21,595676,2015-10-15,1700000,1104324,3342,330.43806104129266
"27 WEST 72ND STREET, 205",2012-04-13,2400000,2018-04-17,3125000,725000,2195,330.29612756264237
"817 WEST END AVENUE, 7D",2007-12-13,1045561,2011-04-21,1450000,404439,1225,330.1542857142857
"133 WEST 22ND   STREET, 3C",2009-08-19,840056,2012-03-15,1150000,309944,939,330.0788072417465
"400 CENTRAL PARK WEST, 18A",2017-01-18,1395000,2017-11-17,1495000,100000,303,330.03300330033005
"52 PARK AVENUE, 3",2003-04-15,655000,2014-06-13,2000000,1345000,4077,329.89943585970076
"25 MURRAY STREET, 6E",2010-12-30,1883762,2013-03-01,2145000,261238,792,329.8459595959596
"330 EAST 38TH STREET, 37L",2011-10-13,995000,2015-04-24,1420000,425000,1289,329.7129557796742
"21 SOUTH END AVENUE, 424",2004-10-08,555000,2007-01-05,825000,270000,819,329.6703296703297
"200 RIVERSIDE BOULEVARD, PH2B",2007-07-25,3395000,2014-09-02,4250000,855000,2596,329.35285053929124
"240 WEST 98TH   STREET, 6D",2011-02-08,988942,2013-11-25,1325000,336058,1021,329.14593535749265
"25 CENTRAL PARK WEST, 10C",2006-02-24,2088430,2012-01-26,2800000,711570,2162,329.12580943570765
"655 AVENUE OF THE AMER, 5H",2016-09-12,4000000,2018-07-13,4220000,220000,669,328.8490284005979
"421 HUDSON STREET, 307",2013-06-24,1624108,2016-10-26,2025000,400892,1220,328.6
"58 WALKER STREET, 3",2003-06-30,1308451,2012-10-18,2425000,1116549,3398,328.59005297233665
"540 WEST 28TH   STREET, 4D",2011-07-28,1150000,2017-10-27,1900000,750000,2283,328.515111695138
"555 WEST 59TH   STREET, TH-3D",2008-12-12,3024202,2016-05-31,3920000,895798,2727,328.4921158782545
"58 WALKER STREET, 1",2003-09-05,1919401,2016-09-22,3484785,1565384,4766,328.44817456986993
"150 CHARLES STREET, 2DS",2016-01-08,1126176,2017-11-20,1350000,223824,682,328.1876832844575
"195 BOWERY, 12",2006-06-30,1595105,2018-06-05,3025000,1429895,4358,328.108077099587
"515 EAST 72ND   STREET, 20F",2011-04-27,1450000,2016-04-29,2050000,600000,1829,328.0481137233461
"275 WEST 96 STREET, 3B-1",2003-05-07,405000,2005-09-07,685000,280000,854,327.8688524590164
"108 5 AVENUE, 2B",2003-09-19,937500,2008-08-21,1527000,589500,1798,327.8642936596218
"15 BROAD STREET, 1526",2006-12-05,570220,2011-12-09,1170000,599780,1830,327.74863387978144
"404 EAST 66TH STREET, 3D",2004-11-10,650000,2005-06-27,725000,75000,229,327.51091703056767
"280 RECTOR PLACE, 2I",2003-11-13,290000,2004-06-29,365000,75000,229,327.51091703056767
"200 EAST 89TH STREET, 45A",2010-02-23,1600000,2011-10-27,1800000,200000,611,327.33224222585926
"220 RIVERSIDE BOULEVARD, 20L",2005-04-08,1500000,2010-01-29,2075000,575000,1757,327.26237905520776
"380 RECTOR PLACE, 8A",2004-04-02,685000,2007-07-23,1080000,395000,1207,327.25766362883184
"52 PARK AVENUE, 10",2004-05-11,890969,2014-11-24,2150000,1259031,3849,327.10600155884646
"203 WEST 81ST STREET, 7C",2005-11-16,800000,2014-01-14,1775000,975000,2981,327.07145253270716
"5 EAST 22ND   STREET, 4-G",2012-03-16,800000,2015-10-22,1230000,430000,1315,326.99619771863115
"350 EAST 82ND   STREET, 10A",2010-03-04,1690000,2017-05-11,2547500,857500,2625,326.6666666666667
"15 BROAD STREET, 3200",2006-12-08,1680112,2016-09-30,2850000,1169888,3584,326.41964285714283
"90 WILLIAM STREET, 3C",2008-11-13,683245,2017-01-25,1660000,976755,2995,326.1285475792988
"15 BROAD STREET, 1224",2007-01-26,595676,2011-08-15,1137500,541824,1662,326.00722021660647
"2 COLUMBUS AVENUE, 39B",2004-10-19,1900000,2011-06-24,2695000,795000,2439,325.9532595325953
"502 PARK AVENUE, 10F",2004-07-09,924571,2015-03-27,2200000,1275429,3913,325.9465882954255
"14 PRINCE STREET, 6D",2007-05-16,1592000,2013-10-03,2352000,760000,2332,325.9005145797599
"450 WEST 17TH   STREET, 2203",2009-02-20,1491736,2018-01-12,2550000,1058264,3248,325.820197044335
"68 BRADHURST AVENUE, 9-L",2010-12-14,705000,2017-03-16,1449000,744000,2284,325.74430823117336
"15 BROAD STREET, 1426",2007-01-18,542523,2014-01-17,1375000,832477,2556,325.6952269170579
"530 EAST 76 STREET, 10B",2003-03-26,499900,2004-04-29,630000,130100,400,325.25
"225 5 AVENUE, 7A",2007-01-11,1720842,2015-09-11,2750000,1029158,3165,325.1684044233807
"150 WEST 51 STREET, 41125",2004-03-11,330000,2005-05-31,475000,145000,446,325.11210762331837
"181 EAST 90 STREET, 16C",2004-06-25,2311427,2012-05-22,3250000,938573,2888,324.9906509695291
"700 RIVERSIDE DRIVE, 6D",2011-10-25,295210,2014-05-20,600000,304790,938,324.93603411513857
"845 UNITED NATIONS PLAZA, 15G",2004-07-19,341321,2015-04-06,1612500,1271179,3913,324.86046511627904
"15 WEST 53RD   STREET, 39A",2008-02-28,6150000,2018-04-10,7350000,1200000,3694,324.85110990795886
"188 EAST 70 STREET, 6B",2003-11-14,2250000,2012-04-19,3250000,1000000,3079,324.78077297823967
"255 EAST 49 STREET, 17B",2003-05-29,525000,2005-08-22,790000,265000,816,324.7549019607843
"1 IRVING PLACE, P11B",2008-12-19,999000,2010-03-29,1150000,151000,465,324.73118279569894
"1 MORTON SQUARE, 3G W",2004-10-05,1476537,2015-07-02,2750000,1273463,3922,324.6973482916879
"40 BROAD STREET, 24G",2011-07-06,735607,2013-06-27,970000,234393,722,324.64404432132966
"80 RIVERSIDE BOULEVARD, 5T",2009-08-27,766131,2011-05-17,970000,203869,628,324.63216560509557
"421 HUDSON STREET, 719",2003-02-13,68455,2012-12-31,1240000,1171545,3609,324.6176226101413
"715 PARK AVENUE, 2D",2003-11-18,1210000,2011-10-25,2150000,940000,2898,324.3616287094548
"171 EAST 84TH   STREET, 12B",2013-05-29,1600000,2015-12-10,1900000,300000,925,324.3243243243243
"205 EAST 85TH   STREET, 16E",2009-07-15,1994396,2013-05-20,2450000,455604,1405,324.2733096085409
"39 VESTRY STREET, 3B",2006-02-03,1450000,2014-07-18,2451000,1001000,3087,324.26303854875283
"333 EAST 34 STREET, 2J",2004-02-27,367575,2006-02-13,600000,232425,717,324.163179916318
"210 LAFAYETTE STREET, 2G",2006-03-06,2240150,2014-09-16,3250000,1009850,3116,324.0853658536585
"220 EAST 65 STREET, 3E",2004-02-13,255000,2005-08-03,429000,174000,537,324.0223463687151
"117 EAST 57TH   STREET, 34H",2008-09-25,1850000,2014-08-26,2550000,700000,2161,323.9241092086997
"77 PARK AVENUE, 14E",2003-04-18,1350000,2014-04-14,2650000,1300000,4014,323.86646736422523
"381 LENOX AVENUE, 6-A",2011-09-28,615000,2017-04-28,1275000,660000,2039,323.6880823933301
"25 COLUMBUS CIRCLE, ST59B",2004-01-27,3717856,2014-10-24,4987500,1269644,3923,323.64109100178433
"444 EAST 57TH STREET, 6B",2007-01-11,400000,2017-03-09,1600000,1200000,3710,323.45013477088946
"220, 18G",2003-01-17,656771,2003-12-30,769000,112229,347,323.42651296829973
"1 BOND STREET, 6B",2004-12-01,2996000,2016-05-20,4350000,1354000,4188,323.30468003820437
"50 FRANKLIN STREET, 9E",2012-02-14,865324,2014-02-10,1100000,234676,727,322.8005502063274
"138 READE STREET, 3",2007-01-23,3003837,2012-07-18,3650000,646163,2003,322.5976035946081
"505 GREENWICH STREET, 12A",2005-03-22,1807393,2011-12-13,2600000,792607,2457,322.59137159137157
"150 WEST 56TH   STREET, 6102",2009-09-09,1560000,2014-04-07,2099000,539000,1671,322.5613405146619
"200 WEST END AVENUE, 9G",2008-02-12,3563875,2016-01-25,4500000,936125,2904,322.3570936639118
"200 RIVERSIDE BOULEVARD, 31B",2010-02-12,1300000,2016-09-13,2075000,775000,2405,322.24532224532226
"15 WEST 20TH STREET, 4A",2007-06-25,2341975,2014-03-07,3130000,788025,2447,322.0371883939518
"28 EAST 10TH   STREET, 5G",2011-11-29,750000,2014-04-03,1025500,275500,856,321.8457943925234
"366 WEST 11 STREET, 6D",2003-04-01,555250,2005-05-16,805000,249750,776,321.8427835051546
"311 EAST 11TH   STREET, 1A",2010-06-03,1120075,2017-04-10,1925000,804925,2503,321.5840990811027
"230 RIVERSIDE DRIVE, 16O",2008-06-30,294000,2015-07-13,1120075,826075,2569,321.5550797975866
"350 WEST 50 STREET, 28D",2003-12-23,460000,2006-07-10,759000,299000,930,321.505376344086
"395 BROADWAY, 14E",2003-04-10,780000,2017-06-30,2450000,1670000,5195,321.4629451395573
"60 RIVERSIDE BOULEVARD, 2703",2012-03-06,3134118,2018-04-11,3850000,715882,2227,321.45577009429724
"450 WEST 17TH   STREET, 1509",2008-10-30,3665700,2017-08-22,4700000,1034300,3218,321.4108141702921
"372 CENTRAL PARK WEST, 10W",2016-03-10,1125000,2017-12-08,1330000,205000,638,321.3166144200627
"418 CENTRAL PARK WEST, 98",2003-04-10,400000,2007-06-07,888000,488000,1519,321.2639894667544
"366 WEST 11TH   STREET, 5E",2012-09-13,2700000,2018-03-15,3345000,645000,2009,321.05525136884023
"150 WEST 26TH STREET, 901",2005-07-14,1375000,2010-11-12,2000000,625000,1947,321.00667693888033
"25 MURRAY STREET, 5C",2008-08-13,1664838,2014-01-13,2300000,635162,1979,320.9509853461344
"240 EAST 10TH   STREET, 4A",2008-02-15,995000,2016-05-10,1960000,965000,3007,320.917858330562
"505 WEST 47TH   STREET, PH5-S",2011-02-03,2275000,2015-07-15,2795737,520737,1623,320.8484288354898
"835 BROADWAY, 2W",2005-05-26,1323725,2010-12-16,1975000,651275,2030,320.82512315270935
"80 RIVERSIDE BOULEVARD, 4D",2010-09-24,1364455,2013-08-02,1699000,334545,1043,320.75263662511986
"1 MORTON SQUARE, 2D W",2004-11-17,2138325,2014-05-15,3250000,1111675,3466,320.73716099249856
"40 BROAD STREET, 28A",2012-06-20,919000,2014-11-10,1199000,280000,873,320.7331042382589
"2 EAST 55TH   STREET, 815",2006-12-04,511161,2007-04-10,551891,40730,127,320.70866141732284
"133 WEST 22ND   STREET, 6C",2009-08-21,916425,2013-04-03,1340000,423575,1321,320.64723694171084
"350 WEST 42 STREET, 25A",2006-07-20,676118,2008-04-16,880000,203882,636,320.5691823899371
"15 BROAD STREET, 2030",2006-10-16,623301,2009-10-27,978000,354699,1107,320.4146341463415
"424 WEST 49TH   STREET, 6B",2009-07-24,920000,2015-11-20,1660000,740000,2310,320.34632034632034
"240 PARK AVENUE SOUTH, 2D2",2008-07-11,1527375,2014-07-23,2233000,705625,2203,320.30186109850206
"220 RIVERSIDE BOULEVARD, 16LT",2010-06-29,2150000,2016-01-20,2800000,650000,2031,320.03938946331857
"300 EAST 23RD   STREET, 9B",2011-08-12,916425,2015-08-31,1390000,473575,1480,319.9831081081081
"27 NORTH MOORE STREET, 4D",2006-03-15,2069500,2009-11-05,2495000,425500,1331,319.68444778362135
"1 YORK STREET, 9B",2011-02-08,3563875,2017-05-30,4300000,736125,2303,319.637429439861
"93 WORTH STREET, 307",2014-04-07,490370,2017-12-27,925000,434630,1360,319.58088235294116
"181 EAST 90 STREET, 10C",2004-05-04,1766816,2007-03-13,2100000,333184,1043,319.4477468839885
"1 MORTON SQUARE, 5C E",2004-10-21,1400093,2012-07-09,2300000,899907,2818,319.34244144783537
"800 TENTH AVENUE, 2E",2011-08-04,799611,2014-10-07,1170000,370389,1160,319.3008620689655
"411 EAST 53RD   STREET, 5K",2010-12-28,725000,2014-02-14,1090000,365000,1144,319.05594405594405
"160 CENTRAL PARK SOUTH, 2708",2004-06-28,825000,2013-08-19,1890000,1065000,3339,318.95777178796044
"525 EAST 80TH STREET, 1B",2006-03-06,1275000,2014-07-23,2250000,975000,3061,318.5233583796145
"233 EAST 17TH   STREET, 4",2011-12-06,2850000,2015-10-19,3300000,450000,1413,318.47133757961785
"188 EAST 70TH   STREET, 8C",2014-12-09,2200000,2015-10-19,2300000,100000,314,318.47133757961785
"473 BROADWAY, 6E",2004-06-02,2150000,2010-06-10,2850000,700000,2199,318.32651205093225
"835 RIVERSIDE DRIVE, 4H",2012-04-03,550000,2015-01-19,875000,325000,1021,318.31537708129287
"111 FULTON STREET, 418",2010-04-20,960000,2015-11-24,1610000,650000,2044,318.00391389432485
"70 BATTERY PLACE, 26C",2010-05-24,1975405,2012-10-04,2250000,274595,864,317.818287037037
"1031 6 AVENUE, 37I",2006-08-30,514216,2008-01-18,675000,160784,506,317.75494071146244
"27 WEST 72ND   STREET, G4",2010-03-17,91582,2016-06-09,814600,723018,2276,317.67047451669595
"416 WASHINGTON STREET, 4J",2005-12-14,1170987,2013-12-19,2100000,929013,2927,317.3942603348138
"251 WEST 89TH STREET, 9B",2007-08-31,1675000,2015-08-21,2599000,924000,2912,317.3076923076923
"405 GREENWICH STREET, 4",2004-11-09,1825000,2006-05-15,2000000,175000,552,317.0289855072464
"2 RIVER TERRACE, 14D",2014-04-24,3800000,2018-03-14,4250000,450000,1420,316.90140845070425
"1 MORTON SQUARE, 6B E",2004-11-04,1603743,2013-05-29,2595000,991257,3128,316.8980179028133
"115 4 AVENUE, 6F",2003-06-09,1250000,2010-07-26,2075000,825000,2604,316.82027649769583
"845 WEST END AVENUE, 5D",2012-05-18,2060000,2018-08-09,2780000,720000,2274,316.62269129287597
"300 EAST 55TH STREET, 10B",2005-02-25,1430641,2010-07-06,2050000,619359,1957,316.48390393459374
"260 WEST BROADWAY, 3A",2004-03-15,1300000,2006-10-19,1600000,300000,948,316.45569620253167
"200 EAST 66TH   STREET, E0505",2011-06-20,2545625,2017-06-07,3235000,689375,2179,316.3721890775585
"333 EAST 34TH   STREET, 15A",2007-10-17,690000,2016-06-15,1690000,1000000,3164,316.05562579013906
"455 CENTRAL PARK WEST, 20A",2004-11-19,2072138,2014-09-30,3210000,1137862,3602,315.89727928928374
"15 BROAD STREET, 1612",2006-06-08,972428,2010-06-08,1433888,461460,1461,315.8521560574949
"200 WEST 24TH   STREET, 3A",2012-12-20,1542500,2017-05-15,2050000,507500,1607,315.80584940883637
"101 WARREN STREET, 5E",2008-04-09,2632176,2017-10-16,3730000,1097824,3477,315.738855335059
"252 SEVENTH AVENUE, 9E",2007-07-23,1925000,2015-07-31,2850000,925000,2930,315.6996587030717
"220 EAST 65 STREET, 4E",2004-10-14,265000,2006-05-23,450000,185000,586,315.6996587030717
"71 LUDLOW STREET, 4A",2008-11-14,1379465,2018-06-19,2485000,1105535,3504,315.50656392694066
"66 LEONARD STREET, 2D-3D",2003-10-16,1740000,2012-12-27,2800000,1060000,3360,315.4761904761905
"318 WEST 100 STREET, 5B",2003-08-27,680000,2005-02-16,850000,170000,539,315.3988868274583
"253 WEST 73RD   STREET, 17H",2008-09-10,999900,2010-08-25,1225000,225100,714,315.26610644257704
"249 EAST 48 STREET, 3C",2003-12-22,548000,2005-12-27,780000,232000,736,315.2173913043478
"1965 BROADWAY, 10H",2005-05-26,1900000,2015-08-10,3075000,1175000,3728,315.1824034334764
"350 WEST 50 STREET, 4X",2003-10-03,215792,2005-11-16,460000,244208,775,315.10709677419356
"257 WEST 117 STREET, 1C",2009-11-04,822436,2014-06-06,1350000,527564,1675,314.96358208955223
"260 PARK AVENUE SOUTH, 7I",2008-12-23,1720000,2016-02-25,2545000,825000,2620,314.8854961832061
"425 5 AVENUE, 29A",2004-04-19,575311,2007-05-21,930000,354689,1127,314.71960958296364
"15 BROAD STREET, 3600",2007-06-01,2438708,2017-01-31,3550000,1111292,3532,314.63533408833524
"395 BROADWAY, 6E",2014-06-17,1550000,2018-07-20,2020000,470000,1494,314.5917001338688
"322 WEST 57TH   STREET, 25B2",2008-03-07,1827758,2013-04-17,2415000,587242,1867,314.5377611140868
"350 WEST 50 STREET, 2AA",2003-10-06,296088,2005-09-01,515000,218912,696,314.5287356321839
"210 LAFAYETTE STREET, 5D",2013-01-29,2000000,2017-06-07,2500000,500000,1590,314.4654088050315
"21 ASTOR PLACE, 6F",2004-01-15,1043706,2011-07-01,1900000,856294,2724,314.35168869309837
"59 JOHN STREET, 3D",2012-10-24,1060000,2017-04-04,1570000,510000,1623,314.2329020332717
"200 WEST END AVENUE, 8A",2008-02-14,1649565,2012-06-25,2150000,500435,1593,314.1462649089768
"1485 FIFTH AVENUE, 12E",2012-06-12,763687,2016-04-01,1200000,436313,1389,314.12023038156946
"360 EAST 88TH   STREET, 28B",2012-09-05,1210000,2016-06-21,1645000,435000,1385,314.07942238267145
"2 COLUMBUS AVENUE, 12C",2012-06-07,1720000,2017-06-28,2300000,580000,1847,314.0227395776936
"40 BROAD STREET, 16H",2011-05-04,993214,2015-02-23,1430000,436786,1391,314.0086268871316
"350 WEST 42ND STREET, 36E",2006-09-06,796780,2008-06-11,999000,202220,644,314.00621118012424
"150 NASSAU STREET, 10C",2003-03-28,1323725,2016-02-10,2800000,1476275,4702,313.9674606550404
"23 WEST 116 STREET, 5H",2015-03-20,570220,2017-12-01,880000,309780,987,313.86018237082067
"141 5 AVENUE, 30/31",2009-12-28,4915000,2013-07-11,5320000,405000,1291,313.710302091402
"330 EAST 49TH STREET, 7D",2015-10-05,620000,2017-05-01,800000,180000,574,313.588850174216
"130 BARROW STREET, PH7",2013-11-22,1800000,2017-10-27,2250000,450000,1435,313.588850174216
"300 EAST 77 STREET, 9C",2003-01-17,1415114,2006-08-17,1825000,409886,1308,313.36850152905197
"425 WEST 53RD STREET, 603",2011-05-18,815000,2015-10-30,1324432,509432,1626,313.3038130381304
"57 READE STREET, 6C",2012-08-17,900000,2015-12-29,1285000,385000,1229,313.2628152969894
"247 WEST 46TH   STREET, 4004",2010-08-05,1200000,2015-04-09,1735000,535000,1708,313.23185011709603
"63 WEST 17TH STREET, 4A",2005-04-21,1650000,2015-05-29,2805000,1155000,3690,313.0081300813008
"327 CENTRAL PARK WEST, PHB",2005-05-27,16907,2017-09-26,1426800,1409893,4505,312.961820199778
"131 WATTS STREET, R-2",2005-08-03,1250000,2013-11-25,2200000,950000,3036,312.9117259552042
"154 ATTORNEY STREET, 602",2011-01-11,704000,2014-01-06,1045000,341000,1091,312.55728689275895
"59 WEST 12TH   STREET, 16B-T",2007-07-02,1775000,2012-10-03,2375000,600000,1920,312.5
"400 CENTRAL PARK WEST, 17H",2003-09-23,420000,2005-09-28,650000,230000,736,312.5
"340 EAST 23RD   STREET, PH1E",2010-08-27,1700000,2014-12-12,2190000,490000,1568,312.5
"52 PARK AVENUE, 5",2003-06-06,750000,2014-10-28,2050000,1300000,4162,312.34983181162903
"715 PARK AVENUE, 12A",2013-06-25,1527375,2016-09-30,1900000,372625,1193,312.34283319362953
"101 WARREN STREET, 9D",2008-07-22,3156575,2014-03-13,3800000,643425,2060,312.34223300970876
"1965 BROADWAY, 18H",2003-06-26,1475000,2011-09-14,2412500,937500,3002,312.2918054630247
"243 WEST 60TH   STREET, 2A",2008-12-15,2765567,2015-05-26,3500000,734433,2353,312.1262218444539
"111 FULTON STREET, 714",2009-10-05,1200000,2015-03-31,1825000,625000,2003,312.03195207189214
"275 WEST 96 STREET, 33B",2004-04-22,750000,2006-01-23,950000,200000,641,312.01248049922
"220 WEST 93RD   STREET, 15A",2009-07-20,2075356,2014-08-05,2650000,574644,1842,311.9674267100977
"300 EAST 90 STREET, 7D",2004-04-07,590000,2007-03-01,920000,330000,1058,311.9092627599244
"112 WEST 18TH   STREET, 17-5C",2010-01-21,1275000,2014-11-20,1825000,550000,1764,311.79138321995464
"188 EAST 70TH STREET, 12D",2010-11-17,1120000,2016-08-18,1775000,655000,2101,311.7563065207044
"510 EAST 80 STREET, 7F",2004-06-10,630000,2005-06-30,750000,120000,385,311.68831168831167
"100 UNITED NATIONS PLAZA, 24B",2004-06-16,1152000,2008-08-12,1625000,473000,1518,311.59420289855075
"393 WEST 49 STREET, 4A",2003-10-03,324480,2005-12-15,575000,250520,804,311.59203980099505
"1623 3 AVENUE, 28J",2003-02-20,296343,2004-05-10,435000,138657,445,311.58876404494384
"190 RIVERSIDE DRIVE, 2D",2005-02-22,1225000,2017-04-25,2610000,1385000,4445,311.58605174353204
"322 WEST 57TH STREET, 46D2",2009-01-16,2392887,2016-07-29,3250000,857113,2751,311.5641584878226
"150 WEST 56TH   STREET, 3410",2011-09-15,920000,2015-03-06,1315000,395000,1268,311.51419558359623
"48 LAIGHT STREET, 5S",2006-05-30,1883762,2016-08-30,3050000,1166238,3745,311.4120160213618
"264 WATER STREET, 5A",2014-08-05,1242265,2017-09-27,1600000,357735,1149,311.3446475195822
"45 PARK AVENUE, 1001",2007-11-13,2011043,2013-12-04,2700000,688957,2213,311.32263895164937
"327 CENTRAL PARK WEST, 14C",2005-05-27,26121,2017-06-29,1400000,1373879,4416,311.11390398550725
"220 RIVERSIDE BOULEVARD, 7N",2005-01-13,2126000,2014-12-05,3250000,1124000,3613,311.0988098533075
"845 UNITED NATIONS PLAZA, 10A",2004-01-05,1698500,2013-06-27,2775000,1076500,3461,311.0372724646056
"525 WEST 22ND   STREET, 3E",2008-01-14,2200000,2016-03-07,3125000,925000,2975,310.92436974789916
"235 WEST END AVENUE, 6J",2004-03-30,753505,2007-05-15,1108000,354495,1141,310.6879929886065
"27 WEST 72ND   STREET, 1607",2008-01-23,549855,2014-09-03,1300000,750145,2415,310.6190476190476
"88 GREENWICH STREET, 708",2016-08-18,905000,2017-01-26,955000,50000,161,310.55900621118013
"100 RIVERSIDE BOULEVARD, 26E",2008-08-05,1237173,2012-03-27,1650000,412827,1330,310.39624060150373
"160 WEST 66 STREET, 25B",2004-03-09,925000,2006-07-25,1194375,269375,868,310.33986175115206
"200 EAST 79TH   STREET, 12A",2013-11-26,8904596,2016-01-26,9150000,245404,791,310.24525916561316
"1485 FIFTH AVENUE, 17E",2012-07-11,764000,2014-10-08,1018000,254000,819,310.1343101343101
"60 WEST 13TH   STREET, 6F",2011-04-28,990000,2017-05-16,1675000,685000,2210,309.9547511312217
"225 5 AVENUE, 10M",2007-02-21,2744183,2011-08-11,3250000,505817,1632,309.93688725490193
"205 EAST 85TH   STREET, 11E",2009-05-12,1785589,2013-11-27,2300000,514411,1660,309.88614457831324
"350 WEST 42ND STREET, 40H",2006-09-13,946972,2008-05-12,1135000,188028,607,309.7660626029654
"443 WEST 151 STREET, 2C",2004-03-03,107000,2004-09-16,168000,61000,197,309.6446700507614
"170 EAST END AVENUE, 16C",2009-08-04,7150000,2017-07-20,8050000,900000,2907,309.59752321981426
"166 EAST 63RD   STREET, 1819D",2013-07-02,1965000,2018-03-27,2500000,535000,1729,309.42741469057256
"16 EAST 12TH   STREET, 6A",2008-01-31,1161000,2014-06-12,1880000,719000,2324,309.3803786574871
"80 CHAMBERS STREET, 13E",2014-04-04,1228000,2017-06-01,1585000,357000,1154,309.3587521663778
"140 WEST 22ND STREET, 2A",2011-05-03,1107346,2016-05-11,1675000,567654,1835,309.3482288828338
"425 5 AVENUE, 31A",2004-05-04,595676,2007-10-15,985000,389324,1259,309.23272438443206
"130 WEST 30TH   STREET, 8B",2007-07-16,1825000,2017-08-11,2962500,1137500,3679,309.18727915194347
"123 WASHINGTON STREET, 49F",2011-06-09,1527375,2015-12-07,2035000,507625,1642,309.1504263093788
"243 WEST 98TH STREET, 4C",2006-01-16,870000,2018-07-13,2280000,1410000,4561,309.1427318570489
"1623 3 AVENUE, 3J",2003-02-20,206198,2006-06-23,583000,376802,1219,309.10746513535685
"330 EAST 75TH   STREET, 19A",2013-03-07,1895000,2017-11-16,2425000,530000,1715,309.03790087463557
"203 WEST 81ST STREET, 3A",2004-08-19,995000,2016-03-28,2305000,1310000,4239,309.035149799481
"110 3 AVENUE, 7C",2010-01-07,2000000,2017-02-08,2800000,800000,2589,308.9996137504828
"70 BATTERY PLACE, 9K",2009-01-22,1593561,2013-07-19,2100000,506439,1639,308.9926784624771
"170 EAST END AVENUE, 11F",2009-06-19,4022087,2017-03-31,4900000,877913,2842,308.90675580577056
"450 WEST 17TH   STREET, 2101",2008-12-15,1033523,2016-04-29,1865000,831477,2692,308.86961367013373
"472 BROADWAY, 4",2007-01-30,807300,2014-09-25,1670000,862700,2795,308.6583184257603
"90 WILLIAM STREET, 15B",2009-10-22,950000,2014-09-08,1500000,550000,1782,308.641975308642
"201 WEST 17 STREET, PH-H",2006-05-18,3900000,2007-11-20,4070000,170000,551,308.529945553539
"429 GREENWICH STREET, 4D",2006-08-16,3325000,2015-09-21,4350000,1025000,3323,308.45621426421906
"402 EAST 90TH   STREET, 3E",2013-02-25,518000,2014-04-29,650000,132000,428,308.41121495327104
"520 WEST 19 STREET, 7B",2010-03-23,2500000,2018-05-24,3420000,920000,2984,308.31099195710453
"200 RIVERSIDE BOULEVARD, 6D",2004-12-14,1525000,2014-03-11,2565000,1040000,3374,308.2394783639597
"240 PARK AVENUE SOUTH, 3A",2008-04-08,2672906,2015-07-30,3495000,822094,2669,308.01573623079804
"140 WEST 22ND   STREET, 4C",2010-09-07,953623,2014-12-18,1435000,481377,1563,307.9827255278311
"421 HUDSON STREET, 607",2007-01-19,362000,2017-11-17,1580000,1218000,3955,307.9646017699115
"350 WEST 50TH   STREET, 5C",2008-08-05,1555000,2015-08-31,2350000,795000,2582,307.90085205267235
"53 LEONARD STREET, 4",2005-07-18,4800000,2016-03-21,6000000,1200000,3899,307.771223390613
"255 HUDSON STREET, 6A",2006-10-10,1893945,2014-05-23,2750000,856055,2782,307.7120776419842
"641 FIFTH AVENUE, 32D",2008-01-11,3350000,2016-11-02,4340000,990000,3218,307.644499689248
"630 1 AVENUE, 23P",2003-12-10,495000,2006-01-12,730000,235000,764,307.5916230366492
"372 CENTRAL PARK WEST, 10R",2010-03-09,1250000,2016-01-07,1905000,655000,2130,307.51173708920186
"125 WEST 22ND STREET, 6C",2008-05-14,1498550,2016-05-24,2400000,901450,2932,307.45225102319233
"160 CENTRAL PARK SOUTH, 915",2006-01-24,3995000,2010-02-12,4450000,455000,1480,307.43243243243245
"780 WEST END AVENUE, 8E",2012-09-05,974000,2014-02-27,1140000,166000,540,307.4074074074074
"312 EAST 22ND   STREET, 1-B",2011-05-05,630000,2016-10-26,1245000,615000,2001,307.3463268365817
"100 11TH   AVENUE, 3B",2011-07-26,560000,2015-01-15,950000,390000,1269,307.3286052009456
"343 EAST 30 STREET, 8-D",2003-08-01,105891,2006-08-25,450000,344109,1120,307.24017857142854
"200 WEST END AVENUE, 11E",2008-06-26,1914310,2014-08-06,2600000,685690,2232,307.2087813620072
"90 PRINCE STREET, 6A",2006-08-11,1560000,2008-07-11,1775000,215000,700,307.14285714285717
"505 GREENWICH STREET, 9H",2005-02-04,1807393,2014-05-23,2850000,1042607,3395,307.10073637702504
"40 EAST 78 STREET, 4E",2003-10-15,1450000,2005-12-28,1697000,247000,805,306.832298136646
"2000 BROADWAY, 8E",2003-11-24,1100000,2013-09-18,2200000,1100000,3586,306.7484662576687
"130 BARROW STREET, PH6",2006-04-27,1500000,2012-02-14,2150000,650000,2119,306.7484662576687
"77 PARK AVENUE, 15F",2007-11-15,499500,2018-02-21,1650000,1150500,3751,306.71820847773927
"393 WEST 49 STREET, 2KK",2003-10-22,261690,2005-06-27,450000,188310,614,306.6938110749186
"200 EAST 66TH   STREET, E0503",2009-12-23,962246,2016-05-04,1675000,712754,2324,306.6927710843373
"471 WASHINGTON STREET, 1C",2011-11-22,2291062,2016-08-29,2825000,533938,1742,306.5086107921929
"1601 3 AVENUE, 11J",2003-02-20,261208,2006-04-03,610000,348792,1138,306.4956063268893
"40 BROAD STREET, 20H",2011-07-19,1170000,2015-10-16,1645000,475000,1550,306.4516129032258
"254 PARK AVENUE SOUTH, 6B",2010-02-12,1099710,2013-09-11,1500000,400290,1307,306.26625860749806
"215 EAST 81ST   STREET, 5F",2012-01-30,362520,2013-04-23,500000,137480,449,306.1915367483296
"127 MERCER STREET, 3B",2003-07-21,1450000,2010-04-05,2200000,750000,2450,306.1224489795918
"150 EAST 85 STREET, 8C",2003-08-06,250000,2005-04-18,440000,190000,621,305.9581320450886
"407 EAST 12TH STREET, 1FNE",2006-08-28,398440,2013-10-31,1200000,801560,2621,305.82220526516596
"333 EAST 34 STREET, 15K",2004-02-02,600768,2006-04-27,850000,249232,815,305.80613496932517
"93 WORTH STREET, 504",2014-09-05,511384,2018-07-24,945000,433616,1418,305.7940761636107
"309 WEST 118 STREET, 1LTPL",2005-03-30,682227,2012-07-26,1500000,817773,2675,305.70953271028037
"416 WASHINGTON STREET, 4K",2005-12-16,911333,2016-08-10,2100000,1188667,3890,305.5699228791774
"45 PARK AVENUE, 1201",2007-12-05,2082321,2014-05-12,2800000,717679,2350,305.39531914893615
"16 WEST 19TH   STREET, 8-C",2007-09-19,1089527,2008-08-13,1190000,100473,329,305.3890577507599
"455 CENTRAL PARK WEST, 22C",2005-09-16,3288947,2015-03-23,4350000,1061053,3475,305.33899280575537
"200 CHAMBERS STREET, 10E",2007-04-13,957155,2014-10-27,1798000,840845,2754,305.3177196804648
"425 WEST 53RD   STREET, 401",2010-10-22,793000,2015-05-26,1305000,512000,1677,305.3070960047704
"303 EAST 33RD   STREET, 11G",2010-10-12,928644,2015-06-17,1450000,521356,1709,305.06495026331186
"157 EAST 72ND   STREET, 8G/H",2009-12-07,1800000,2017-05-05,2625000,825000,2706,304.8780487804878
"455 MAIN STREET, 3A",2009-04-16,113750,2014-06-03,685000,571250,1874,304.82924226254005
"27 LEONARD STREET, 3",2004-08-17,1632500,2017-05-03,3047500,1415000,4642,304.8255062473072
"100 WEST 58TH   STREET, 9G",2010-04-22,988500,2012-12-28,1287500,299000,981,304.7910295616718
"1628 2 AVENUE, 3N",2004-02-02,223100,2005-01-26,332500,109400,359,304.7353760445682
"21 ASTOR PLACE, 5F",2004-03-09,1018250,2013-11-27,2100000,1081750,3550,304.71830985915494
"121 EAST 23RD   STREET, 16D",2009-09-25,990000,2013-03-12,1375000,385000,1264,304.5886075949367
"85 WEST BROADWAY, 10S",2011-03-01,2341975,2018-06-05,3150000,808025,2653,304.5702977761025
"311 WEST BROADWAY, 5F",2009-07-28,2270188,2015-03-27,2900000,629812,2068,304.5512572533849
"1031 6 AVENUE, 39B",2006-07-19,498942,2007-05-14,590000,91058,299,304.5418060200669
"31 EAST 28TH   STREET, PH-E",2007-08-20,3380590,2013-03-15,4000000,619410,2034,304.5280235988201
"150 WEST 51 STREET, 17-22",2003-07-15,235000,2004-07-27,350000,115000,378,304.23280423280426
"800 10TH   AVENUE, 4F",2011-07-13,773500,2014-12-18,1155000,381500,1254,304.22647527910686
"257 WEST 117 STREET, 4H",2012-02-10,569392,2015-09-11,967500,398108,1309,304.131398013751
"63 WEST 17 STREET, 4C",2003-12-16,865513,2004-12-10,975000,109487,360,304.13055555555553
"64 NORTH MOORE STREET, 4W",2003-06-27,1250000,2017-07-13,2810000,1560000,5130,304.093567251462
"462 WEST 58TH   STREET, 3D",2010-06-23,1175000,2014-04-21,1600000,425000,1398,304.0057224606581
"275 WEST 96 STREET, 6H",2003-08-05,425000,2006-08-08,759000,334000,1099,303.91264786169245
"99 JOHN STREET, 1401",2011-03-29,650000,2014-02-14,970000,320000,1053,303.89363722697055
"502 PARK AVENUE, 12G",2004-04-29,2036500,2018-05-31,3600000,1563500,5145,303.88726919339166
"395 BROADWAY, 8C",2004-11-10,950000,2017-01-10,2300000,1350000,4444,303.78037803780376
"101 WEST 24TH   STREET, 30C",2008-12-03,1206626,2014-10-24,1860000,653374,2151,303.7536029753603
"205 EAST 85TH   STREET, 17E",2009-09-01,5056418,2016-10-27,5850000,793582,2613,303.70531955606583
"88 WEST WASHINGTON PLCE, 4D",2007-08-01,1746298,2010-04-27,2050000,303702,1000,303.702
"1049 FIFTH AVENUE, 6C",2005-11-10,1389911,2011-08-03,2025000,635089,2092,303.57982791587
"140 WEST 22ND STREET, 4F",2010-09-27,1167000,2017-06-27,1915000,748000,2465,303.44827586206895
"170 EAST 87 STREET, W19D",2003-08-13,480000,2004-08-26,595000,115000,379,303.43007915567284
"250 EAST 40TH STREET, 34B",2010-10-15,500000,2018-02-05,1310000,810000,2670,303.3707865168539
"5 EAST 22ND   STREET, 30L",2011-03-14,995000,2014-04-08,1335000,340000,1121,303.3006244424621
"350 WEST 50 STREET, 2HH",2003-09-25,266175,2004-11-23,395000,128825,425,303.11764705882354
"200 RIVERSIDE BOULEVARD, 16K",2008-01-28,2270000,2014-07-31,2990000,720000,2376,303.030303030303
"117 EAST 57 STREET, 34F",2003-10-15,345000,2004-12-17,475000,130000,429,303.030303030303
"344 BOWERY, 2",2007-12-06,2062630,2014-05-15,2775000,712370,2352,302.8784013605442
"333 RECTOR PLACE, 713",2011-06-30,405600,2016-07-20,965000,559400,1847,302.8695181375203
"1965 BROADWAY, 21K",2011-09-27,1159000,2014-05-15,1450000,291000,961,302.8095733610822
"225 5 AVENUE, 2T",2007-07-25,697501,2014-04-28,1445000,747499,2469,302.75374645605507
"1-2 RIVER TERRACE, 25D",2008-10-07,3375498,2017-07-31,4350000,974502,3219,302.7343895619758
"240 RIVERSIDE BOULEVARD, 7LM",2005-11-18,588000,2008-05-21,865000,277000,915,302.73224043715845
"312 BLEECKER STREET, B1",2004-11-29,805000,2008-06-24,1199000,394000,1303,302.37912509593247
"2250 BROADWAY, 4E",2013-04-03,775000,2016-04-15,1110000,335000,1108,302.3465703971119
"161 GRAND STREET, 2B",2007-07-13,2200000,2013-11-14,2900000,700000,2316,302.2452504317789
"1623 3 AVENUE, 19B",2003-02-20,158996,2005-12-15,470000,311004,1029,302.2390670553936
"205 WEST 76TH STREET, 602",2013-12-10,2150000,2016-12-06,2480000,330000,1092,302.1978021978022
"20 PINE STREET, 2706",2011-04-11,850000,2014-11-26,1250000,400000,1325,301.8867924528302
"117 WEST 123 STREET, 6D",2011-06-08,745000,2017-05-18,1400000,655000,2171,301.7042837402119
"393 WEST 49 STREET, 5FF",2003-11-04,281960,2005-01-18,415000,133040,441,301.6780045351474
"62 COOPER SQUARE, 3C",2005-08-16,2000000,2015-02-27,3050000,1050000,3482,301.55083285468123
"393 WEST 49 STREET, 2H",2003-08-11,268710,2005-05-23,465000,196290,651,301.52073732718895
"15 BROAD STREET, 1514",2006-05-22,1048797,2014-01-28,1895000,846203,2808,301.35434472934475
"1 MORTON SQUARE, 11C E",2004-12-06,1552831,2011-09-21,2300000,747169,2480,301.27782258064514
"101 WARREN STREET, 2710",2008-12-23,3991540,2010-06-02,4150000,158460,526,301.25475285171103
"161 GRAND STREET, 2A",2005-01-04,1680112,2010-03-11,2250000,569888,1892,301.2093023255814
"44 WEST 22ND   STREET, 2R",2009-07-24,662500,2013-04-26,1075000,412500,1372,300.65597667638485
"2101 BROADWAY, 3-157",2003-05-01,415000,2003-10-31,470000,55000,183,300.5464480874317
"205 WEST 76TH   STREET, 6E",2009-10-06,1868052,2016-08-29,2625000,756948,2519,300.49543469630805
"15 BROAD STREET, 1416",2006-06-16,885877,2010-04-28,1310000,424123,1412,300.37039660056655
"333 EAST 34 STREET, 4L",2004-01-30,707684,2006-09-26,999000,291316,970,300.3257731958763
"418 CENTRAL PARK WEST, 54",2012-05-24,936000,2018-06-13,1600000,664000,2211,300.3165988240615
"111 FULTON STREET, 801",2009-09-09,1147000,2012-08-03,1465000,318000,1059,300.2832861189802
"1 MORTON SQUARE, 8C E",2004-11-19,1731025,2010-10-04,2375000,643975,2145,300.2214452214452
"205 WEST 76TH   STREET, 702",2009-10-01,1486662,2017-09-18,2360000,873338,2909,300.2193193537298
"15 BROAD STREET, 1124",2007-03-23,595676,2016-02-11,1570000,974324,3247,300.0689867570065
"500 WEST END AVENUE, 5C",2008-09-26,5250000,2015-01-13,5940000,690000,2300,300.0
"44 LISPENARD STREET, 4",2007-05-21,1675000,2013-07-18,2350000,675000,2250,300.0
"16 WEST 19TH   STREET, 9-E",2007-12-06,1104801,2008-09-15,1190000,85199,284,299.9964788732394
"109 GREENE STREET, 5A",2008-08-25,2875000,2017-02-03,3800000,925000,3084,299.935149156939
"135 WEST 52ND STREET, 11B",2015-11-25,2056865,2017-05-22,2220000,163135,544,299.8805147058824
"297 WEST 137 STREET, 2570C",2005-07-12,450000,2007-06-29,665000,215000,717,299.860529986053
"167 EAST 82ND   STREET, 2C",2010-10-14,835000,2014-07-29,1250000,415000,1384,299.8554913294798
"13 EAST 30TH   STREET, 5",2007-06-26,1221900,2014-05-12,1975000,753100,2512,299.8009554140127
"363 MANHATTAN AVENUE, C",2012-03-02,665000,2018-06-04,1350000,685000,2285,299.781181619256
"200 CHAMBERS STREET, 29D",2007-07-27,2708545,2017-12-29,3850000,1141455,3808,299.75183823529414
"250 EAST 53RD STREET, 1602",2008-02-07,1694680,2014-06-09,2388000,693320,2314,299.61970613656007
"60 RIVERSIDE BOULEVARD, 1707",2011-07-18,1046706,2016-08-08,1600000,553294,1848,299.4015151515151
"49 WARREN STREET, 2E",2005-04-26,1380000,2016-06-22,2600000,1220000,4075,299.3865030674847
"15 CHARLES STREET, 8A",2003-11-24,661863,2017-01-19,2100000,1438137,4805,299.3001040582726
"203 WEST 81ST STREET, 3C",2006-09-13,1175000,2016-04-22,2225000,1050000,3509,299.23055001424905
"1965 BROADWAY, 18A",2004-07-30,2900000,2017-08-14,4325000,1425000,4763,299.1811883266849
"520 WEST 19TH STREET, 2B",2008-09-24,2927468,2015-05-07,3650000,722532,2416,299.0612582781457
"318 WEST 100 STREET, 7C",2003-05-27,650000,2007-07-10,1100000,450000,1505,299.0033222591362
"392 CENTRAL PARK WEST, 20R",2013-09-10,1638000,2016-07-20,1950000,312000,1044,298.85057471264366
"150 WEST 56TH   STREET, 4201",2007-03-26,3350000,2014-07-24,4150000,800000,2677,298.84198729921553
"101 WARREN STREET, 2440",2009-01-21,2632176,2015-03-06,3300000,667824,2235,298.80268456375836
"188 EAST 78TH   STREET, 18B",2007-08-06,5400000,2015-11-05,6300000,900000,3013,298.70560902754727
"22 RENWICK STREET, 3B",2014-01-03,1525000,2016-07-12,1800000,275000,921,298.5884907709012
"60 RIVERSIDE BOULEVARD, 1104",2011-10-18,776870,2013-10-31,999000,222130,744,298.56182795698925
"1485 FIFTH AVENUE, 10E",2011-06-17,682227,2016-06-08,1225000,542773,1818,298.55500550055007
"300 EAST 93 STREET, 14F",2003-08-26,355000,2005-07-13,560000,205000,687,298.39883551673944
"462 WEST 58TH   STREET, 9A",2010-05-20,1750000,2017-04-07,2500000,750000,2514,298.32935560859187
"18 WEST 48TH STREET, 29B",2007-07-20,1888853,2014-01-28,2600000,711147,2384,298.29991610738256
"150 WEST 51 STREET, 17-26",2004-01-30,230000,2005-11-14,425000,195000,654,298.1651376146789
"400 EAST 54 STREET, 4D",2003-05-30,332000,2004-07-29,459000,127000,426,298.1220657276995
"117 EAST 57TH STREET, 40B",2004-12-02,1400000,2009-12-21,1950000,550000,1845,298.1029810298103
"200 CHAMBERS STREET, 22D",2007-05-22,2662723,2016-12-01,3700000,1037277,3481,297.9824762999138
"220 RIVERSIDE BOULEVARD, 37D",2007-11-20,3370000,2010-06-17,3650000,280000,940,297.8723404255319
"153 BOWERY, 3",2004-06-28,992794,2018-07-30,2525000,1532206,5145,297.8048590864917
"155 PERRY STREET, 5B",2013-08-19,2340000,2016-07-12,2655000,315000,1058,297.73156899810965
"220 WEST 148 STREET, 5E",2012-02-10,670000,2016-06-07,1140000,470000,1579,297.65674477517416
"25 CENTRAL PARK WEST, 7S",2011-10-28,1200000,2016-08-26,1725000,525000,1764,297.6190476190476
"200 RECTOR PLACE, 11H",2003-08-14,545000,2004-07-15,645000,100000,336,297.6190476190476
"2101 BROADWAY, 41031",2006-02-16,625000,2007-09-24,799000,174000,585,297.43589743589746
"404 PARK AVENUE SOUTH, 2C",2015-01-28,3141301,2017-12-01,3450000,308699,1038,297.39788053949906
"450 WEST 17TH STREET, 1005",2008-09-16,1013158,2010-01-06,1155000,141842,477,297.36268343815516
"150 NASSAU STREET, 10A",2003-03-18,903167,2016-03-17,2315000,1411833,4748,297.35320134793596
"70 BATTERY PLACE, 7N",2009-06-25,1170990,2013-11-22,1650000,479010,1611,297.3370577281192
"212 WARREN STREET, 4A",2016-01-08,1736116,2018-05-11,1990000,253884,854,297.288056206089
"250 SOUTH END AVENUE, 4C",2013-05-16,352118,2015-08-28,600000,247882,834,297.22062350119904
"435 EAST 76 STREET, 4A",2003-05-22,442712,2005-06-08,665000,222288,748,297.1764705882353
"250 WEST 90TH   STREET, 18H",2013-06-12,1585000,2016-06-10,1910000,325000,1094,297.07495429616085
"150 WEST 56TH   STREET, 2804",2008-03-27,700000,2009-05-22,825000,125000,421,296.91211401425176
"1623 3 AVENUE, 16G",2004-02-20,264757,2008-02-25,700000,435243,1466,296.89154160982264
"60 RIVERSIDE BOULEVARD, 2401",2011-10-11,2851100,2018-07-02,3580000,728900,2456,296.78338762214986
"456 WEST 19TH   STREET, 4/5D",2011-04-11,1975000,2017-12-18,2700000,725000,2443,296.7662709783054
"15 CENTRAL PARK WEST, S705",2009-10-07,1654656,2012-12-14,2000000,345344,1164,296.6872852233677
"201 EAST 80TH   STREET, 6F",2007-04-16,650000,2009-04-10,865000,215000,725,296.55172413793105
"200 CHAMBERS STREET, 5B",2007-03-02,1496827,2015-06-18,2395000,898173,3030,296.42673267326734
"333 RECTOR PLACE, 1109",2011-08-09,1135265,2014-10-15,1480000,344735,1163,296.41874462596735
"139 WOOSTER STREET, 2A",2007-08-23,2107777,2009-01-26,2262500,154723,522,296.40421455938696
"540 WEST 28TH   STREET, 6E",2011-11-07,804417,2016-03-14,1275000,470583,1589,296.1504090623033
"15 BROAD STREET, 2116",2006-07-06,985000,2016-08-24,2080000,1095000,3702,295.78606158833065
"80 RIVERSIDE BOULEVARD, 7J",2012-04-02,3428911,2017-06-29,3995000,566089,1914,295.76227795193313
"333 RECTOR PLACE, 809",2012-12-18,2179710,2018-03-31,2750000,570290,1929,295.64022809745984
"80 PARK AVENUE, 3D",2006-04-13,580000,2007-05-24,700000,120000,406,295.5665024630542
"240 RIVERSIDE BOULEVARD, 18 C",2006-03-31,2120000,2010-03-25,2550000,430000,1455,295.53264604810994
"630 FIRST AVENUE, 26S",2004-08-05,490000,2006-05-10,680000,190000,643,295.48989113530325
"448 GREENWICH STREET, 4",2004-02-10,896060,2015-09-24,2150000,1253940,4244,295.46182846371346
"55 WALL STREET, 612",2007-03-21,100000,2014-06-12,880000,780000,2640,295.45454545454544
"520 WEST 19TH STREET, 6A",2008-10-10,2096905,2017-05-03,3020000,923095,3127,295.20147105852254
"150 WEST 51 STREET, 41135",2004-03-04,343000,2006-02-10,552000,209000,708,295.1977401129943
"519 WEST 135 STREET, 5B",2003-04-23,349830,2004-01-23,431000,81170,275,295.1636363636364
"220, 18B",2003-03-28,555000,2004-02-13,650000,95000,322,295.03105590062114
"200 CHAMBERS STREET, 7D",2007-04-04,1573196,2015-04-21,2440000,866804,2939,294.9316093909493
"530 PARK AVENUE, 15D",2014-01-06,4875000,2017-01-12,5200000,325000,1102,294.91833030852996
"340 EAST 23RD   STREET, PH4B",2011-06-01,2625000,2015-10-29,3100000,475000,1611,294.84792054624455
"39 VESTRY STREET, 2A",2006-08-11,2456437,2010-06-18,2871287,414850,1407,294.84719260838665
"40 BROAD STREET, 12D",2011-05-19,662755,2013-06-28,890000,227245,771,294.74059662775613
"80 PARK AVENUE, 19N",2009-10-27,885000,2012-09-13,1195000,310000,1052,294.6768060836502
"40 EAST 78TH   STREET, 12C",2008-02-08,1619018,2015-10-30,2450000,830982,2821,294.57001063452674
"555 WEST 59TH   STREET, PH-B",2009-09-16,4225737,2018-04-20,5150000,924263,3138,294.5388782664117
"350 ALBANY STREET, 3H",2013-06-14,500000,2015-08-21,735000,235000,798,294.4862155388471
"311 EAST 38TH   STREET, 8C",2012-11-13,275000,2016-06-09,659000,384000,1304,294.47852760736197
"100 WEST 18TH STREET, 9D",2008-05-28,1629200,2016-01-15,2450000,820800,2788,294.40459110473455
"340 EAST 23RD STREET, 10M",2008-05-05,1883762,2014-07-17,2550000,666238,2264,294.2747349823322
"2 CORNELIA STREET, 41066",2003-04-21,580000,2006-02-07,881000,301000,1023,294.23264907135876
"32 WEST 18TH   STREET, 7A",2007-09-20,3589331,2017-02-14,4600000,1010669,3435,294.2267831149927
"225 FIFTH AVENUE, PHX",2007-11-19,2255000,2017-02-21,3250000,995000,3382,294.2046126552336
"825 WEST END AVENUE, 9-C",2006-04-07,1500000,2015-02-09,2450000,950000,3230,294.11764705882354
"715 PARK AVENUE, 12D",2003-12-15,1450000,2017-06-15,2900000,1450000,4931,294.0580004055972
"56 CROSBY STREET, 2A",2005-06-08,3875000,2010-04-30,4400000,525000,1787,293.78847229994403
"455 MAIN STREET, 11A",2006-03-27,534581,2007-02-08,628000,93419,318,293.7704402515723
"240 WEST END AVENUE, PHB",2010-06-07,730000,2016-11-28,1425000,695000,2366,293.7447168216399
"80 CHAMBERS STREET, 10D",2010-07-06,1545000,2018-06-25,2400005,855005,2911,293.7152181380969
"321 CATHEDRAL PARKWAY, 6B",2014-10-09,585493,2016-12-16,820000,234507,799,293.50062578222776
"2109 BROADWAY, 13-10",2009-10-29,950000,2013-07-23,1350000,400000,1363,293.470286133529
"151 EAST 58TH   STREET, 39E",2007-09-28,8000000,2010-06-30,8295000,295000,1006,293.2405566600398
"15 BROAD STREET, 2114",2006-06-28,1170987,2016-02-09,2200000,1029013,3513,292.9157415314546
"30 EAST 37TH STREET, 11C",2007-01-25,590585,2016-12-20,1650000,1059415,3617,292.8988111694775
"517 WEST 46TH   STREET, 601",2009-08-21,818000,2014-05-01,1320000,502000,1714,292.8821470245041
"416 WASHINGTON STREET, 3J",2005-12-14,997885,2018-08-06,2350000,1352115,4618,292.7923343438718
"200 WEST END AVENUE, 19B",2008-05-12,2721782,2013-10-08,3300000,578218,1975,292.7686075949367
"200 CHAMBERS STREET, 3B",2007-02-16,1466280,2013-07-11,2150000,683720,2337,292.5631151048353
"222 WEST 14TH STREET, 6F",2005-04-26,300000,2007-05-18,520000,220000,752,292.5531914893617
"211 EAST 13TH   STREET, 6C",2014-06-25,2287971,2016-09-01,2521695,233724,799,292.5206508135169
"47 EAST 91ST   STREET, TH-2",2007-04-05,1781937,2013-06-19,2445000,663063,2267,292.4847816497574
"420 WEST 25TH   STREET, 7K",2011-07-06,865512,2016-09-30,1425000,559488,1913,292.46628332462103
"350 WEST 53RD STREET, 5C",2012-05-08,1265000,2016-03-10,1675000,410000,1402,292.4393723252496
"4260 BROADWAY, 406",2015-02-06,539881,2015-10-21,615000,75119,257,292.2918287937743
"15 EAST 69TH STREET, 12A",2005-03-11,7200000,2017-05-15,8500000,1300000,4448,292.2661870503597
"2 RIVER TERRACE, 14C",2013-03-27,1370000,2017-12-19,1875000,505000,1728,292.2453703703704
"303 EAST 33RD   STREET, 8G",2010-11-30,1435732,2017-07-06,2140000,704268,2410,292.22738589211616
"45 GREENE STREET, 4",2005-07-11,2900000,2016-08-18,4085000,1185000,4056,292.15976331360946
"65 COOPER SQUARE, 2C",2006-01-17,680000,2008-06-25,940000,260000,890,292.13483146067415
"845 UNITED NATIONS PLAZA, 53A",2004-07-07,2280880,2013-05-30,3230000,949120,3249,292.12680824869193
"345 GRAND STREET, 3R",2005-06-02,628769,2014-06-24,1595000,966231,3309,292.0009066183137
"157 EAST 32ND STREET, 15D",2011-06-13,440000,2011-10-28,480000,40000,137,291.97080291970804
"136 SULLIVAN STREET, 5",2005-05-26,1825000,2015-06-25,2900000,1075000,3682,291.96089082020643
"2 COLUMBUS AVENUE, 4C",2003-03-01,344708,2017-09-27,1898888,1554180,5324,291.91960931630354
"300 EAST 77TH STREET, 16C",2011-06-17,1910000,2016-10-05,2475000,565000,1937,291.68817759421785
"15 BROAD STREET, 1824",2006-09-19,621132,2011-12-01,1175000,553868,1899,291.6629805160611
"415 GREENWICH STREET, 3A",2008-05-20,3105662,2013-05-09,3635000,529338,1815,291.6462809917355
"311 WEST BROADWAY, 7H",2011-03-09,2472356,2016-08-11,3050000,577644,1982,291.44500504540866
"259 BOWERY, 3",2005-05-12,3869350,2017-05-24,5150000,1280650,4395,291.38794084186577
"200 WEST END AVENUE, 23B",2008-05-22,2927468,2014-07-28,3585000,657532,2258,291.20106288751106
"7 HUBERT STREET, 3D",2004-09-23,1476462,2009-08-26,2000000,523538,1798,291.17797552836487
"425 WEST 53RD   STREET, PH4",2012-06-07,2410000,2017-12-18,2998000,588000,2020,291.08910891089107
"260 PARK AVENUE SOUTH, 8K",2010-11-22,1060000,2014-07-25,1450000,390000,1341,290.82774049217
"130 WEST 30TH STREET, 7C",2006-04-25,1750000,2014-09-29,2645320,895320,3079,290.7827216628776
"228 1 AVENUE, 2A",2003-07-10,565000,2005-08-18,788800,223800,770,290.64935064935065
"350 WEST 42ND STREET, 19L",2006-06-28,1053888,2008-07-11,1270000,216112,744,290.4731182795699
"15 BROAD STREET, 2230",2006-11-27,616041,2010-06-24,995000,378959,1305,290.39003831417625
"186 WEST 80 STREET, 7M",2004-01-30,290000,2005-05-16,427000,137000,472,290.2542372881356
"30 WEST 63RD STREET, 8T",2009-11-19,560037,2016-12-16,1310000,749963,2584,290.23335913312695
"15 WEST 53RD   STREET, 49F",2007-03-09,2850000,2012-07-31,3422000,572000,1971,290.2080162354135
"100 UNITED NATIONS PLAZA, 19A/B",2003-09-05,2000000,2017-11-03,3500000,1500000,5173,289.96713705780013
"39 EAST 29TH STREET, 8A",2008-09-19,1379728,2014-12-22,2042000,662272,2285,289.8345733041576
"117 BEEKMAN STREET, 3E",2013-05-10,1050000,2018-05-30,1585000,535000,1846,289.81581798483205
"270 WEST 17TH   STREET, 3G",2009-07-14,985000,2016-10-07,1750000,765000,2642,289.553368660106
"203 WEST 81ST STREET, 4C",2007-06-21,1695000,2007-12-28,1750000,55000,190,289.4736842105263
"200 CHAMBERS STREET, 8D",2007-04-24,1944857,2017-03-30,2995000,1050143,3628,289.4550716648291
"330 EAST 33 STREET, 17-D",2003-03-21,200000,2004-05-26,325000,125000,432,289.35185185185185
"272 WEST 107 STREET, 4D",2009-11-30,1475000,2015-10-30,2100000,625000,2160,289.35185185185185
"200 RIVERSIDE BOULEVARD, 5M",2010-03-23,1225000,2013-10-09,1600000,375000,1296,289.35185185185185
"45 WEST 67TH STREET, 26B",2007-03-13,1662000,2017-12-21,2800000,1138000,3936,289.1260162601626
"677 WASHINGTON STREET, 9C",2004-02-11,655000,2014-03-31,1725000,1070000,3701,289.1110510672791
"225 5 AVENUE, 3R",2007-05-14,1048797,2014-12-15,1850000,801203,2772,289.0342712842713
"845 UNITED NATIONS PLAZA, 82D",2005-11-01,3250000,2011-01-20,3800000,550000,1906,288.56243441762854
"2112 BROADWAY, 5E",2007-04-18,2403070,2015-09-08,3287500,884430,3065,288.557911908646
"220, 16B",2003-03-19,605859,2003-10-10,665000,59141,205,288.4926829268293
"200 CHAMBERS STREET, 5H",2007-05-11,1277510,2010-07-07,1610000,332490,1153,288.3694709453599
"15 BROAD STREET, 1924",2006-11-10,633603,2016-06-20,1645000,1011397,3510,288.14729344729346
"150 NASSAU STREET, 3F",2003-05-28,400681,2006-04-01,700000,299319,1039,288.0837343599615
"401 EAST 84 STREET, 6C",2003-12-22,590000,2006-02-17,817000,227000,788,288.07106598984774
"519 WEST 23RD STREET, R4",2007-09-20,1832850,2016-11-29,2800000,967150,3358,288.013698630137
"120 RIVERSIDE BOULEVARD, 12E",2006-03-09,1613926,2015-07-24,2600000,986074,3424,287.9889018691589
"200 RECTOR PLACE, 18C",2003-11-07,439000,2005-03-28,585000,146000,507,287.9684418145957
"230 WEST 56TH STREET, 50E",2014-01-07,2725000,2018-01-22,3150000,425000,1476,287.94037940379405
"305 2 AVENUE, 532",2004-01-09,825000,2014-06-26,1925000,1100000,3821,287.88275320596705
"80 PARK AVENUE, 6N",2003-09-04,569202,2006-09-19,889000,319798,1111,287.84698469846984
"199 BOWERY, 5B",2006-05-31,461370,2008-12-02,725000,263630,916,287.8056768558952
"32 WEST 18TH   STREET, 8A",2007-08-15,3869350,2013-08-15,4500000,630650,2192,287.70529197080293
"150 NASSAU STREET, 11A",2003-03-17,936790,2015-09-18,2250000,1313210,4568,287.4802977232925
"105 WEST 117 STREET, 105A",2006-08-04,417160,2013-06-14,1137500,720340,2506,287.4461292897047
"255 EAST 49 STREET, 12B",2003-08-01,510000,2004-01-22,560000,50000,174,287.35632183908046
"450 WEST 17TH STREET, 1908",2010-05-19,2600000,2014-11-03,3068000,468000,1629,287.292817679558
"402 EAST 90TH STREET, 7G",2011-10-05,589150,2018-06-28,1295000,705850,2458,287.1643612693247
"25 CENTRAL PARK WEST, 10S",2010-03-01,1280000,2014-05-29,1725000,445000,1550,287.0967741935484
"330 EAST 38TH   STREET, 49L",2010-12-30,1060000,2015-07-29,1540000,480000,1672,287.08133971291863
"122 GREENWICH AVENUE, 26",2009-10-30,3075000,2017-12-08,3925000,850000,2961,287.06518068220197
"157 EAST 32 STREET, 11B",2004-04-06,1150000,2006-08-25,1400000,250000,871,287.0264064293915
"90 FRANKLIN STREET, 2N",2004-10-01,1575000,2018-04-19,2995000,1420000,4948,286.9846402586904
"350 WEST 57TH   STREET, 7A",2014-06-05,951000,2018-01-16,1330000,379000,1321,286.9038607115821
"49 WARREN STREET, 6E",2005-03-28,1137500,2012-12-28,1950000,812500,2832,286.8997175141243
"150 WEST 51 STREET, 15-21",2004-09-14,460000,2005-09-15,565000,105000,366,286.88524590163934
"322 WEST 57TH   STREET, 43V",2011-12-22,824782,2014-03-21,1060000,235218,820,286.85121951219514
"101 WARREN STREET, 2230",2008-12-01,2296153,2016-08-04,3100000,803847,2803,286.78094898323224
"241 WEST 19TH   STREET, 2N",2009-06-11,999000,2012-01-12,1270000,271000,945,286.7724867724868
"280 PARK AVENUE SOUTH, 23C",2004-03-31,845000,2005-06-10,970000,125000,436,286.697247706422
"135 EAST 54 STREET, 9C",2004-12-20,360000,2006-03-01,485000,125000,436,286.697247706422
"260 PARK AVENUE SOUTH, 11I",2006-04-26,1237173,2013-05-14,1975000,737827,2575,286.5347572815534
"444 WEST 19TH   STREET, 301",2007-08-09,1675000,2014-04-18,2375000,700000,2444,286.41571194762685
"340 WEST 57TH   STREET, 5G",2010-12-06,910000,2017-10-24,1630000,720000,2514,286.3961813842482
"220 WEST 148 STREET, 2C",2011-06-30,685000,2012-12-31,842500,157500,550,286.3636363636364
"150 WEST 56TH   STREET, 4503",2009-11-23,1450000,2015-02-26,2000000,550000,1921,286.30921395106714
"1601 3 AVENUE, 6K",2003-02-20,389681,2007-08-14,858000,468319,1636,286.2585574572127
"502 PARK AVENUE, 7H",2004-08-18,734000,2009-04-30,1225000,491000,1716,286.13053613053614
"300 RECTOR PLACE, 8P",2006-05-11,1250000,2015-09-10,2225000,975000,3409,286.0076268700499
"105 NORFOLK STREET, 12B",2013-04-01,2940000,2016-06-17,3275000,335000,1173,285.5924978687127
"15 CENTRAL PARK WEST, 8K",2007-11-29,2504895,2017-12-07,3550000,1045105,3661,285.46981698989345
"188 EAST 70TH STREET, 10D",2006-11-28,1250000,2012-10-05,1860000,610000,2138,285.3133769878391
"524 EAST 72 STREET, 26B",2003-03-11,660000,2006-08-24,1019875,359875,1262,285.16244057052296
"15 BROAD STREET, 1500",2006-06-16,839653,2012-10-18,1500000,660347,2316,285.123920552677
"25 CENTRAL PARK WEST, 15I",2006-10-26,1909218,2009-08-11,2200000,290782,1020,285.08039215686273
"381 BROOME STREET, 4",2004-02-06,763688,2015-07-01,1950100,1186412,4163,284.9896709104012
"60 RIVERSIDE BOULEVARD, 1608",2011-07-08,919425,2014-09-10,1250000,330575,1160,284.9784482758621
"78 RIDGE STREET, 4F",2011-09-09,354900,2015-05-05,735000,380100,1334,284.9325337331334
"505 GREENWICH STREET, 10E",2005-03-04,1170987,2012-01-13,1885000,714013,2506,284.9213886671987
"400 CENTRAL PARK WEST, 1G",2005-07-14,415000,2006-06-30,515000,100000,351,284.9002849002849
"502 PARK AVENUE, 15F",2004-11-16,1094618,2008-10-09,1500000,405382,1423,284.87842586085736
"18 PINE STREET, 2202",2010-07-02,1580000,2016-06-17,2200000,620000,2177,284.7955902618282
"350 WEST 50 STREET, 3ZZ",2003-11-20,380250,2006-08-16,665000,284750,1000,284.75
"366 WEST 11TH   STREET, 1C",2007-07-26,1755000,2015-10-07,2607500,852500,2995,284.64106844741235
"505 GREENWICH STREET, 7E",2004-12-21,1481553,2007-12-10,1790000,308447,1084,284.5452029520295
"129 DUANE STREET, 3T",2003-12-09,1610000,2013-08-28,2620000,1010000,3550,284.50704225352115
"200 RIVERSIDE BOULEVARD, 22C",2004-07-14,1450000,2008-05-20,1850000,400000,1406,284.4950213371266
"101 WARREN STREET, 1280",2008-09-04,1928628,2012-09-25,2350000,421372,1482,284.32658569500677
"15 BROAD STREET, 1716",2006-06-22,916425,2017-10-30,2095000,1178575,4148,284.130906460945
"635 WEST 42ND   STREET, 18A",2008-10-14,267818,2015-10-30,998500,730682,2572,284.0909797822706
"52 THOMAS STREET, 4C",2008-01-10,1680112,2016-11-22,2600000,919888,3239,284.0037048471751
"29 WEST 85 STREET, 1",2003-03-03,795000,2006-08-04,1150000,355000,1250,284.0
"260 WEST BROADWAY, 3C",2006-04-20,1781000,2017-07-28,2950000,1169000,4117,283.9446198688365
"1600 BROADWAY, 14E",2006-08-07,722957,2008-10-15,950000,227043,800,283.80375
"80 RIVERSIDE BOULEVARD, 3S",2010-05-10,1693512,2015-10-13,2256000,562488,1982,283.7981836528759
"382 CENTRAL PARK WEST, 14X",2010-01-26,745000,2015-03-09,1275000,530000,1868,283.7259100642398
"2000 BROADWAY, 12F",2010-09-13,1675000,2016-12-21,2325000,650000,2291,283.71890004364906
"10 WEST END AVENUE, 7H",2007-07-17,1441842,2008-06-27,1540000,98158,346,283.6936416184971
"374 BROADWAY, 2B",2005-06-24,618000,2007-09-20,850000,232000,818,283.61858190709046
"400 CENTRAL PARK WEST, 16S",2003-07-01,300000,2004-09-14,425000,125000,441,283.4467120181406
"39 EAST 29TH   STREET, 22D",2013-04-18,1450000,2016-12-01,1825000,375000,1323,283.4467120181406
"175 WEST 12TH   STREET, 18A",2009-09-17,975000,2014-06-12,1465000,490000,1729,283.4008097165992
"130 WEST 20TH   STREET, PH11A",2009-10-16,2055000,2013-04-26,2420000,365000,1288,283.3850931677019
"230 RIVERSIDE DRIVE, 15D",2007-04-25,1164878,2016-05-25,2105000,940122,3318,283.3399638336347
"62 BEACH STREET, 4E",2007-06-29,3200000,2016-11-30,4175000,975000,3442,283.2655432887856
"129 LAFAYETTE STREET, 2B",2005-01-25,763687,2008-12-23,1168000,404313,1428,283.13235294117646
"15 BROAD STREET, 2226",2006-08-21,573783,2016-09-16,1615000,1041217,3679,283.01630877955967
"200 CHAMBERS STREET, 24E",2007-07-16,1832850,2012-03-15,2315000,482150,1704,282.9518779342723
"160 WEST 66TH STREET, 31D",2004-03-22,950000,2014-05-21,2000000,1050000,3712,282.8663793103448
"1400 5 AVENUE, TH-A1",2006-11-16,1426841,2017-03-03,2490000,1063159,3760,282.75505319148937
"2098 FREDRICK DOUGLASS BL, 5I",2013-02-14,413560,2013-10-07,480000,66440,235,282.72340425531917
"100 READE STREET, 7-B",2008-06-03,2206000,2014-08-29,2850000,644000,2278,282.7041264266901
"148 MADISON STREET, 8C",2004-01-28,310284,2004-04-28,336000,25716,91,282.5934065934066
"250 EAST 53RD STREET, 1202",2008-01-24,1671729,2014-11-17,2375000,703271,2489,282.55162715950183
"20 WEST 53RD STREET, 18A",2015-02-27,12000000,2017-07-31,12250000,250000,885,282.4858757062147
"1438 THIRD AVENUE, 7E",2009-12-03,2123333,2013-07-11,2495000,371667,1316,282.42173252279633
"333 RECTOR PLACE, 501",2011-05-24,370110,2013-08-15,600000,229890,814,282.42014742014743
"252 7 AVENUE, 7J",2003-10-01,1111000,2018-08-15,2645000,1534000,5432,282.40058910162
"225 FIFTH AVENUE, 10C",2007-08-20,1613926,2013-06-04,2211000,597074,2115,282.30449172576834
"110 EAST 71ST STREET, 5",2005-06-10,2400000,2016-08-05,3550000,1150000,4074,282.2778595974472
"99 JOHN STREET, 306",2011-08-18,785000,2015-11-24,1225000,440000,1559,282.2322001282874
"2000 BROADWAY, 3A",2004-06-08,26000,2010-02-24,615000,589000,2087,282.22328701485384
"235 EAST 40 STREET, 5F",2003-11-24,425000,2005-02-09,550000,125000,443,282.16704288939053
"157 EAST 32 STREET, 19B",2003-06-26,640000,2006-10-13,980000,340000,1205,282.15767634854774
"88 GREENWICH STREET, 2301",2009-08-05,1125000,2014-11-17,1669500,544500,1930,282.1243523316062
"150 WEST 56TH STREET, 4602",2005-03-17,975000,2011-04-14,1601000,626000,2219,282.10905813429474
"333 RECTOR PLACE, 206",2011-05-12,655000,2014-08-12,990000,335000,1188,281.986531986532
"500 WEST END AVENUE, 12A",2004-06-08,763687,2014-04-30,1782500,1018813,3613,281.9853307500692
"50 FRANKLIN STREET, 10D",2010-04-28,1089527,2015-12-17,1670000,580473,2059,281.91986401165616
"44 LISPENARD STREET, 3",2003-09-22,1100000,2015-05-19,2300000,1200000,4257,281.88865398167724
"2545 FREDRICK DOUGLASS BL, 2545D",2013-06-19,471000,2018-05-30,980000,509000,1806,281.83831672203763
"32 WEST 18TH STREET, 4A",2007-05-01,3207487,2017-10-13,4283333,1075846,3818,281.7826086956522
"59 WEST 12TH   STREET, 2D",2011-10-20,1300000,2016-03-04,1750000,450000,1597,281.7783343769568
"133 WEST 22ND   STREET, 7D",2009-01-06,1934675,2012-11-09,2330000,395325,1403,281.7712045616536
"100 UNITED NATIONS PLAZA, 49A",2003-12-17,1550000,2013-04-24,2512500,962500,3416,281.76229508196724
"525 EAST 11TH STREET, 5A",2010-10-22,1225000,2013-09-03,1520000,295000,1047,281.75740210124167
"200 CHAMBERS STREET, 14B",2007-05-18,1669930,2015-06-04,2498000,828070,2939,281.7522966995577
"217 WEST 14 STREET, 2F",2005-02-10,605858,2016-02-01,1735000,1129142,4008,281.72205588822357
"215 WEST 95TH STREET, 11E",2004-08-20,549000,2005-11-28,680000,131000,465,281.7204301075269
"462 WEST 58TH STREET, PHD",2009-11-03,1030000,2014-11-24,1550000,520000,1847,281.53762858689765
"15 BROAD STREET, 3330",2006-12-27,1425550,2011-08-09,1900000,474450,1686,281.4056939501779
"77 PARK AVENUE, 10F",2004-02-04,1100000,2013-11-01,2100000,1000000,3558,281.0567734682406
"2109 BROADWAY, 16-02",2011-02-01,950000,2015-04-29,1385000,435000,1548,281.0077519379845
"36 GRAMERCY PARK EAST, 2E",2010-10-29,915024,2013-05-29,1180000,264976,943,280.99257688229056
"845 UNITED NATIONS PLAZA, 47D",2003-01-31,1323725,2011-08-16,2200000,876275,3119,280.94741904456555
"62 BEACH STREET, 2D",2008-03-20,3600000,2013-07-30,4150000,550000,1958,280.8988764044944
"382 LAFAYETTE STREET, 5",2003-02-03,1150000,2009-11-30,1850000,700000,2492,280.8988764044944
"1235 PARK AVENUE, 9A",2011-07-06,1425000,2016-02-22,1900000,475000,1692,280.73286052009456
"325 5 AVENUE, 35B",2012-05-17,2000000,2016-10-06,2450000,450000,1603,280.723643169058
"15 BROAD STREET, 2016",2006-05-18,982611,2016-03-08,1988000,1005389,3582,280.678112786153
"525 EAST 11TH STREET, 3A",2012-08-29,1450000,2018-01-10,2000000,550000,1960,280.61224489795916
"322 WEST 57TH   STREET, 33F1",2010-06-01,1440000,2017-11-03,2200000,760000,2712,280.23598820059
"1 MORTON SQUARE, 3B W",2004-11-03,1374637,2015-11-03,2500000,1125363,4017,280.15011202389843
"150 WEST 51ST STREET, 18-27",2010-11-19,555000,2013-10-25,855000,300000,1071,280.1120448179272
"111 CENTRAL PARK NORTH, 5B",2008-07-11,2018250,2017-06-09,2930000,911750,3255,280.10752688172045
"38 DELANCEY STREET, 7E",2010-11-08,738231,2016-01-20,1270000,531769,1899,280.0258030542391
"404 PARK AVENUE SOUTH, 10C",2014-11-06,4078091,2016-07-12,4250000,171909,614,279.98208469055373
"347 WEST 57 STREET, 8F",2004-05-07,600000,2006-04-04,795000,195000,697,279.77044476327114
"60 ORCHARD STREET, 6",2012-01-25,1354272,2014-04-11,1580000,225728,807,279.71251548946714
"245 EAST 93 STREET, 25F",2004-01-15,445000,2006-01-17,650000,205000,733,279.6725784447476
"15 BROAD STREET, 3830",2007-03-19,2459073,2015-07-09,3307500,848427,3034,279.63974950560316
"150 EAST 85 STREET, 4H",2003-07-18,312566,2006-05-11,600000,287434,1028,279.60505836575874
"25 MURRAY STREET, 5E",2008-07-14,2031408,2016-10-18,2875000,843592,3018,279.52021206096754
"224 EAST 60TH   STREET, 11K",2007-12-20,435000,2008-05-29,480000,45000,161,279.5031055900621
"515 EAST 72ND   STREET, 16F",2011-05-09,1375000,2017-07-28,2010000,635000,2272,279.48943661971833
"253 WEST 73RD   STREET, 13B",2014-07-14,650000,2016-11-04,885877,235877,844,279.4751184834123
"22 MERCER STREET, 4D",2008-02-14,3614787,2016-03-16,4440000,825213,2953,279.44903487978326
"225 5 AVENUE, 9B",2007-03-27,1547740,2014-11-07,2325000,777260,2782,279.3889288281812
"161 GRAND STREET, PH-B",2005-08-03,1069162,2012-12-12,1820000,750838,2688,279.3296130952381
"100 WEST 58TH STREET, 6B",2016-03-10,2000000,2017-03-03,2100000,100000,358,279.3296089385475
"15 BROAD STREET, 1516",2006-05-30,875695,2013-08-28,1615000,739305,2647,279.29920664903665
"372 CENTRAL PARK WEST, 7E",2003-03-24,292032,2003-08-07,330000,37968,136,279.1764705882353
"71 PARK AVENUE, PH-A",2003-07-03,1120075,2012-08-15,2050000,929925,3331,279.1729210447313
"15 BROAD STREET, 1424",2006-12-27,600767,2013-05-10,1250000,649233,2326,279.11994840928634
"150 EAST 85 STREET, 7A",2003-07-15,430950,2005-12-20,679000,248050,889,279.02137232845894
"120 RIVERSIDE BOULEVARD, 15L",2006-08-10,1397853,2011-06-09,1890000,492147,1764,278.9948979591837
"520 EAST 81ST STREET, 1M",2004-07-12,225000,2005-07-20,329000,104000,373,278.8203753351206
"333 RECTOR PLACE, 511",2011-06-20,446160,2013-07-26,660000,213840,767,278.8005215123859
"220 RIVERSIDE BOULEVARD, 33C",2010-05-07,2100000,2015-10-01,2650000,550000,1973,278.7633046122656
"101 ALLEN STREET, 2C",2003-08-21,14000,2005-03-10,172000,158000,567,278.6596119929453
"150 EAST 85 STREET, 6I",2003-07-16,312566,2006-07-06,615000,302434,1086,278.4843462246777
"120 RIVERSIDE BOULEVARD, PH1D",2006-12-20,1320000,2014-08-21,2100000,780000,2801,278.47197429489466
"393 WEST 49 STREET, 5K",2003-11-04,233220,2005-06-07,395000,161780,581,278.4509466437177
"160 CENTRAL PARK SOUTH, 1115",2006-06-01,2125000,2013-07-19,2850000,725000,2605,278.3109404990403
"1619 3 AVENUE, 16G",2003-02-20,282856,2007-09-26,750000,467144,1679,278.2275163787969
"133 WEST 22ND   STREET, 4L",2009-08-31,712775,2014-06-18,1200000,487225,1752,278.09646118721463
"1641 3 AVENUE, 9A",2003-02-20,423751,2015-12-14,1725000,1301249,4680,278.0446581196581
"200 CHAMBERS STREET, 27D",2007-06-19,2470122,2012-08-20,2995000,524878,1889,277.86024351508735
"60 RIVERSIDE BOULEVARD, 1710",2011-07-08,858330,2015-05-18,1250000,391670,1410,277.78014184397165
"845 UNITED NATIONS PLAZA, 58E",2006-09-28,2000000,2009-12-11,2325000,325000,1170,277.77777777777777
"500 WEST 43RD   STREET, 8J",2016-03-31,770000,2017-04-13,875000,105000,378,277.77777777777777
"233 EAST 17TH   STREET, PH2",2014-07-07,2600000,2016-03-28,2775000,175000,630,277.77777777777777
"393 WEST 49 STREET, 2OO",2003-10-22,262000,2005-06-27,432500,170500,614,277.6872964169381
"303 EAST 33RD   STREET, 8N",2011-03-15,1318633,2017-06-05,1950000,631367,2274,277.645998240985
"845 WEST END AVENUE, 9C",2011-11-01,2575000,2016-10-06,3075000,500000,1801,277.623542476402
"311 EAST 11TH   STREET, 4C",2010-05-13,784052,2015-03-17,1275000,490948,1769,277.5285472018089
"322 WEST 57TH   STREET, 50S1",2011-04-19,2423435,2017-12-14,3098000,674565,2431,277.4845742492801
"58 THOMAS STREET, 3",2004-09-13,1410000,2011-07-06,2100000,690000,2487,277.44270205066346
"420 CENTRAL PARK WEST, 4B",2004-11-19,649000,2016-11-01,1860000,1211000,4365,277.43413516609394
"133 WEST 22ND   STREET, 6F",2009-10-13,1242265,2017-05-12,2010000,767735,2768,277.3609104046243
"117 BEEKMAN STREET, 7A",2004-01-12,1345000,2015-06-10,2500000,1155000,4167,277.1778257739381
"15 BROAD STREET, 2312",2006-07-19,880786,2008-09-17,1100000,219214,791,277.1352718078382
"11 EAST 29TH STREET, 25A",2011-11-03,1850000,2018-04-06,2500000,650000,2346,277.0673486786019
"845 UNITED NATIONS PLAZA, 55B",2005-02-16,3562050,2012-11-30,4350000,787950,2844,277.05696202531647
"692 BROADWAY, 1113",2005-04-29,1921000,2017-12-19,3200000,1279000,4617,277.01970976824776
"250 EAST 53RD STREET, 2404",2008-04-30,2688646,2012-05-24,3100000,411354,1485,277.0060606060606
"117 WEST 123 STREET, 4D",2011-05-04,690000,2017-06-16,1309000,619000,2235,276.95749440715883
"245 7 AVENUE, 10C",2003-12-08,785000,2005-02-17,906000,121000,437,276.8878718535469
"135 WEST 52ND STREET, 9C",2015-12-01,1568105,2017-11-15,1766000,197895,715,276.7762237762238
"80 PARK AVENUE, 14C",2003-03-14,315000,2005-04-20,527500,212500,768,276.6927083333333
"845 UNITED NATIONS PLAZA, 41C",2003-07-09,2171418,2013-03-15,3150000,978582,3537,276.67005937234944
"41 WEST 72 STREET, 11C",2003-09-15,560038,2005-10-31,775000,214962,777,276.65637065637065
"15 EAST 26TH STREET, 11C",2008-08-01,1247356,2017-01-09,2100000,852644,3083,276.56308790139474
"35 EAST 38TH STREET, 12E",2011-07-07,522000,2014-02-12,785000,263000,951,276.5509989484753
"33 RECTOR STREET, 12",2006-06-26,1950000,2016-05-20,2950000,1000000,3616,276.5486725663717
"1760 2 AVENUE, 28C",2013-03-18,2375000,2015-09-08,2625000,250000,904,276.5486725663717
"21 SOUTH END AVENUE, PH2Y",2013-09-13,1475000,2017-08-30,1875000,400000,1447,276.43400138217
"39 EAST 29TH STREET, 5A",2008-09-18,1344090,2014-08-14,1940000,595910,2156,276.3961038961039
"225 5 AVENUE, 10H",2007-01-24,1160805,2015-05-19,2000000,839195,3037,276.3236746789595
"401 EAST 60TH STREET, 21C",2012-04-20,1050000,2016-11-10,1510000,460000,1665,276.2762762762763
"205 WEST 76TH   STREET, 603",2011-01-31,999000,2016-01-19,1500000,501000,1814,276.18522601984563
"66 LEONARD STREET, 6D",2003-12-11,1625000,2015-02-05,2750000,1125000,4074,276.14138438880707
"502 PARK AVENUE, 16F",2005-04-18,1170987,2008-04-23,1475000,304013,1101,276.1244323342416
"333 WEST 56TH STREET, 3A",2004-11-23,690000,2006-12-20,899000,209000,757,276.0898282694848
"845 UNITED NATIONS PLAZA, 16E",2004-12-16,1600000,2013-11-20,2500000,900000,3261,275.9889604415823
"181 EAST 90TH STREET, 19C",2004-05-07,2634212,2011-03-16,3325000,690788,2504,275.8738019169329
"5 EAST 22 STREET, 14-J",2003-06-30,1150000,2004-04-15,1230000,80000,290,275.86206896551727
"18 WEST 48TH   STREET, 25C",2007-07-03,1152253,2008-12-16,1299000,146747,532,275.84022556390977
"350 WEST 57TH STREET, 8B",2008-09-19,1265000,2015-10-07,1975000,710000,2574,275.8352758352758
"182 EAST 2ND   STREET, 3G",2006-12-21,159000,2012-08-03,725000,566000,2052,275.82846003898635
"327 CENTRAL PARK WEST, 10E",2003-03-14,700000,2005-02-18,895000,195000,707,275.8132956152758
"237 EAST 88TH STREET, 202",2007-08-28,395460,2008-03-31,455000,59540,216,275.64814814814815
"845 UNITED NATIONS PLAZA, 7B",2004-01-30,735000,2008-05-08,1165000,430000,1560,275.64102564102564
"252 7 AVENUE, 4Q",2003-01-24,965000,2010-07-26,1720000,755000,2740,275.54744525547443
"161 WEST 61 STREET, 26C",2003-01-03,1025000,2006-09-07,1395000,370000,1343,275.50260610573343
"25 CENTRAL PARK WEST, 20R",2010-04-27,1832850,2014-12-18,2300000,467150,1696,275.44221698113205
"1641 THIRD AVENUE, 9K",2011-05-10,919500,2015-02-20,1300000,380500,1382,275.3256150506512
"209 EAST 2ND   STREET, 3",2010-04-28,1405185,2014-04-01,1800000,394815,1434,275.3242677824268
"60 ORCHARD STREET, 8",2011-10-14,1858306,2017-12-01,2475000,616694,2240,275.3098214285714
"100 WEST 18TH STREET, 5F",2008-06-05,1323725,2013-03-01,1800000,476275,1730,275.3034682080925
"15 BROAD STREET, 1116",2006-09-07,814600,2014-07-01,1600000,785400,2854,275.1927119831815
"52 PARK AVENUE, 15",2005-06-16,1075000,2015-08-28,2100000,1025000,3725,275.1677852348993
"253 WEST 73RD   STREET, 13G",2011-05-26,950000,2014-11-18,1300000,350000,1272,275.15723270440253
"425 FIFTH AVENUE, 50A",2004-08-26,1512101,2007-08-14,1810000,297899,1083,275.0683287165282
"319 EAST 105TH STREET, 1B",2004-10-01,402000,2006-03-14,547500,145500,529,275.04725897920605
"80 PARK AVENUE, 12E",2010-12-14,612500,2013-09-18,890000,277500,1009,275.02477700693754
"350 EAST 72 STREET, 15A",2003-03-21,825000,2004-11-10,990000,165000,600,275.0
"119 EAST 101 STREET, 2A",2012-04-18,580000,2017-06-22,1100000,520000,1891,274.98677948175566
"77 PARK AVENUE, 2G",2003-07-29,685000,2006-09-13,999000,314000,1142,274.9562171628722
"1601 3 AVENUE, 18D",2003-02-20,272564,2007-09-11,730000,457436,1664,274.9014423076923
"101 WARREN STREET, 2130",2008-11-14,2199420,2018-02-02,3125000,925580,3367,274.8975348975349
"417 MANHATTAN AVENUE, B-7",2013-08-06,473000,2017-05-09,850000,377000,1372,274.7813411078717
"545 CATHEDRAL PARKWAY, 3A",2012-11-15,1400000,2016-11-10,1800000,400000,1456,274.72527472527474
"150 WEST 51ST STREET, 41247",2004-10-27,320000,2007-07-25,595000,275000,1001,274.72527472527474
"150 WEST 51 STREET, 41133",2004-03-17,340000,2006-03-15,540000,200000,728,274.72527472527474
"225 LAFAYETTE STREET, 7B",2005-01-14,1181170,2010-06-17,1725000,543830,1980,274.66161616161617
"2077 5 AVENUE, 5A",2011-06-02,707683,2016-07-11,1220000,512317,1866,274.55359056806003
"1619 3 AVENUE, 5C",2003-02-20,242399,2007-06-15,675000,432601,1576,274.4930203045685
"1255 5 AVENUE, 5L",2012-10-03,435000,2013-11-26,550000,115000,419,274.4630071599045
"505 GREENWICH STREET, 2B",2005-01-13,987702,2009-08-25,1450000,462298,1685,274.3608308605341
"188 EAST 76TH STREET, 19A",2005-04-22,3250000,2016-10-14,4400000,1150000,4193,274.2666348676365
"1601 3 AVENUE, 9G",2003-02-20,253046,2007-06-14,685000,431954,1575,274.25650793650794
"400 EAST 54TH STREET, 24G",2006-04-18,525000,2007-07-27,652500,127500,465,274.19354838709677
"272 WEST 107 STREET, 6B",2009-05-28,1150000,2015-09-30,1785000,635000,2316,274.1796200345423
"300 EAST 55TH STREET, 23B",2005-03-15,1613926,2010-01-21,2100000,486074,1773,274.1534122955443
"101 WARREN STREET, 11H",2008-08-19,2683088,2014-12-30,3320000,636912,2324,274.05851979345954
"80 RIVERSIDE BOULEVARD, 15D",2010-04-16,859403,2012-06-29,1080000,220597,805,274.0335403726708
"120 RIVERSIDE BOULEVARD, 15S",2006-04-25,1435200,2014-07-22,2260000,824800,3010,274.01993355481727
"505 GREENWICH STREET, 1D",2005-03-15,845147,2013-02-05,1635000,789853,2884,273.874133148405
"101 WARREN STREET, 1230",2008-09-03,1633145,2014-11-04,2250000,616855,2253,273.79272081668887
"263 9 AVENUE, 3D",2006-01-18,1323725,2015-05-04,2252200,928475,3393,273.64426760978483
"250 EAST 53RD STREET, 1102",2008-02-05,1664082,2014-06-17,2300000,635918,2324,273.6308089500861
"15 BROAD STREET, 1530",2006-12-19,570220,2011-11-28,1064000,493780,1805,273.5623268698061
"181 SULLIVAN STREET, 4",2007-05-15,2341975,2012-09-14,2875000,533025,1949,273.4864032837352
"146 WEST 57TH STREET, 49C",2005-10-26,1200000,2011-10-31,1800000,600000,2196,273.224043715847
"975 1 AVENUE, 4D",2003-02-07,410000,2005-04-04,625000,215000,787,273.18932655654385
"19 BEACH STREET, 5",2005-06-20,2950000,2011-12-07,3595000,645000,2361,273.18932655654385
"2148 BROADWAY, 11G",2012-07-31,1525000,2015-10-27,1848000,323000,1183,273.0346576500423
"2000 BROADWAY, 7B",2003-08-06,350000,2006-04-21,620000,270000,989,273.0030333670374
"121 EAST 23RD STREET, 5A",2013-03-25,770000,2015-06-09,990000,220000,806,272.9528535980149
"372 CENTRAL PARK WEST, 19S",2003-10-09,350000,2005-10-11,550000,200000,733,272.8512960436562
"201 WEST 17 STREET, 3C",2004-02-04,1100000,2006-02-06,1300000,200000,733,272.8512960436562
"10 UNION SQUARE EAST, U7F",2003-01-16,505000,2005-01-18,705000,200000,733,272.8512960436562
"350 WEST 50 STREET, 26I",2003-01-29,440000,2005-09-08,700000,260000,953,272.8226652675761
"1965 BROADWAY, 23D",2006-09-22,1730000,2009-12-28,2055450,325450,1193,272.7996647108131
"250 EAST 53RD STREET, 804",2008-05-29,1733225,2016-02-08,2500000,766775,2811,272.7765919601565
"1760 2 AVENUE, 27C",2003-06-09,926608,2007-03-09,1300000,373392,1369,272.7479912344777
"322 WEST 57TH   STREET, 53U",2011-02-14,830000,2015-11-04,1300000,470000,1724,272.62180974477957
"150 WEST 51 STREET, 41271",2005-05-23,335000,2006-07-19,450000,115000,422,272.5118483412322
"500 WEST 43RD STREET, 14A",2010-05-15,225000,2012-08-14,449000,224000,822,272.5060827250608
"505 WEST 47TH   STREET, 3G-S",2011-03-18,987000,2015-04-16,1393000,406000,1490,272.48322147651004
"141 5 AVENUE, 38",2010-08-27,3700000,2011-07-27,3791000,91000,334,272.45508982035926
"310 WEST 52ND   STREET, PHA",2007-09-04,3512962,2016-08-03,4400000,887038,3256,272.4318181818182
"15 BROAD STREET, 1926",2006-10-06,590585,2013-02-21,1225000,634415,2330,272.28111587982835
"240 RIVERSIDE BOULEVARD, 15 C",2006-02-15,1104801,2009-08-06,1450000,345199,1268,272.2389589905363
"343 EAST 30 STREET, 21-M",2003-09-17,950000,2005-03-21,1100000,150000,551,272.2323049001815
"415 EAST 54TH STREET, 12F",2011-01-10,1055000,2016-06-16,1595000,540000,1984,272.1774193548387
"1641 3 AVENUE, 2J",2003-02-20,234234,2007-12-05,710000,475766,1749,272.021726700972
"11 LISPENARD STREET, 5",2010-08-04,1780000,2013-04-19,2049000,269000,989,271.9919110212336
"55 WHITE STREET, 2A",2005-06-24,915000,2007-12-21,1162500,247500,910,271.97802197802196
"1400 FIFTH AVENUE, 7N",2005-05-10,385500,2007-10-26,630000,244500,899,271.96885428253614
"30 ORCHARD STREET, 2",2013-09-18,1665000,2018-03-22,2112500,447500,1646,271.87120291616037
"5 EAST 22 STREET, 6-S",2003-07-29,535000,2005-11-21,765000,230000,846,271.8676122931442
"260 PARK AVENUE SOUTH, 11G",2006-05-10,1527375,2018-03-02,2700000,1172625,4314,271.81849791376914
"52 RIVINGTON STREET, 4",2003-04-09,520000,2010-08-18,1250000,730000,2688,271.57738095238096
"400 EAST 51ST STREET, 5A",2010-03-30,1030000,2011-12-16,1200000,170000,626,271.5654952076677
"360 EAST 88TH STREET, 16C",2011-01-14,1500000,2017-09-06,2159000,659000,2427,271.5286361763494
"235 EAST 40 STREET, 30H",2003-05-14,565000,2005-06-07,770000,205000,755,271.52317880794703
"140 CHARLES STREET, 9A",2009-10-21,1400000,2018-03-05,2230000,830000,3057,271.50801439319594
"49 EAST 21ST   STREET, 3B",2009-08-25,1300000,2013-01-10,1635000,335000,1234,271.47487844408425
"462 WEST 58TH   STREET, 1A",2010-07-28,1480000,2017-05-01,2150000,670000,2469,271.3649250708789
"263 NINTH AVENUE, 6B",2012-07-05,1825000,2018-04-24,2400000,575000,2119,271.3544124587069
"140 WEST 22ND   STREET, 9A",2011-03-07,1050000,2015-09-02,1495000,445000,1640,271.3414634146341
"404 EAST 76TH   STREET, 15A",2010-12-20,1900000,2016-01-06,2400000,500000,1843,271.2967986977754
"404 EAST 76 STREET, 6M",2004-04-20,370000,2005-02-09,450000,80000,295,271.1864406779661
"154 ATTORNEY STREET, 702",2006-12-22,2100000,2013-10-16,2775000,675000,2490,271.0843373493976
"55 WHITE STREET, 2B",2008-07-08,3490000,2013-09-03,4000000,510000,1883,270.8443972384493
"7 ESSEX STREET, 8",2004-02-02,880786,2013-11-21,1850000,969214,3580,270.7301675977654
"200 RIVERSIDE BOULEVARD, 40A",2006-06-13,3250000,2015-04-20,4125000,875000,3233,270.64645839777296
"780 WEST END AVENUE, 11D",2003-03-12,585000,2013-06-18,1600000,1015000,3751,270.594508131165
"150 NASSAU STREET, 2C",2003-05-27,997885,2014-07-21,2100000,1102115,4073,270.5904738521974
"640 WEST END AVENUE, 5A",2003-06-26,1235000,2010-09-20,1950000,715000,2643,270.525917517972
"77 PARK AVENUE, 15G",2011-06-14,960000,2015-05-26,1350000,390000,1442,270.4576976421637
"249 EAST 48 STREET, 7E",2004-02-06,565000,2006-05-18,790000,225000,832,270.4326923076923
"1623 3 AVENUE, 14D",2003-02-20,246657,2007-07-30,685000,438343,1621,270.4151758173967
"195 HUDSON STREET, 1A",2006-04-05,2900000,2015-11-18,3850000,950000,3514,270.3471826977803
"39 NORTH MOORE STREET, 2A",2004-11-03,1800000,2016-12-20,2995000,1195000,4430,269.75169300225735
"447 WEST 18TH STREET, 6C",2011-08-02,1731025,2018-05-17,2400000,668975,2480,269.74798387096774
"404 EAST 76 STREET, 7G",2003-05-09,941881,2006-01-27,1210000,268119,994,269.7374245472837
"21 SOUTH END AVENUE, PH1M",2005-02-09,615000,2015-12-03,1680000,1065000,3949,269.6885287414535
"146 WEST 57 STREET, 40E",2004-06-25,680000,2006-10-26,910000,230000,853,269.6365767878077
"40 EAST 78TH STREET, 4H",2005-12-16,2450000,2017-08-21,3600000,1150000,4266,269.5733708391936
"445 WEST 19TH STREET, 6E",2015-08-05,660000,2017-01-24,805000,145000,538,269.5167286245353
"1623 3 AVENUE, 29G",2003-02-20,293858,2006-08-28,640000,346142,1285,269.3712062256809
"350 WEST 42ND STREET, 23E",2010-11-19,660000,2013-10-31,950000,290000,1077,269.2664809656453
"245 EAST 93RD STREET, 5A",2013-08-08,1360000,2017-07-27,1750000,390000,1449,269.1511387163561
"23 WEST 116 STREET, 7B",2015-01-22,1186261,2017-02-17,1390000,203739,757,269.14002642007927
"133 WEST 22ND   STREET, 9C",2009-01-20,1064071,2015-06-08,1691000,626929,2330,269.0682403433476
"311 WEST BROADWAY, 4G",2010-09-08,2087412,2016-12-02,2700000,612588,2277,269.0329380764163
"52 PARK AVENUE, 1",2004-04-29,1665056,2015-05-15,2750000,1084944,4033,269.01661294321843
"422 EAST 72ND   STREET, 17E",2009-07-30,1135000,2015-08-20,1730000,595000,2212,268.9873417721519
"45 CHRISTOPHER STREET, 15G",2003-03-26,762500,2016-05-31,2057500,1295000,4815,268.95119418483904
"404 EAST 76 STREET, 32C",2004-01-20,1527375,2006-04-27,1750000,222625,828,268.8707729468599
"144 WEST 18TH   STREET, 600E",2007-06-29,3705121,2015-01-29,4450000,744879,2771,268.81234211476004
"421 HUDSON STREET, 613",2003-10-16,670000,2016-04-26,1900000,1230000,4576,268.7937062937063
"380 RECTOR PLACE, 6C",2009-11-30,215273,2016-09-19,883000,667727,2485,268.7030181086519
"317 WEST 95 STREET, GG",2003-03-28,325000,2005-08-19,560000,235000,875,268.57142857142856
"1623 3 AVENUE, 39J",2003-02-20,338222,2006-04-26,650000,311778,1161,268.5426356589147
"345 WEST 14TH   STREET, 4B",2013-06-04,2214693,2017-05-09,2600000,385307,1435,268.50662020905924
"1623 3 AVENUE, 17H",2003-02-20,402104,2008-09-03,945000,542896,2022,268.49455984174085
"199 BOWERY, 2A",2006-05-24,717866,2017-05-19,1795000,1077134,4013,268.4111637179168
"845 UNITED NATIONS PLAZA, 37C",2004-04-29,2011044,2011-05-10,2700000,688956,2567,268.3895597974289
"310 WEST 52ND   STREET, 23H",2007-04-09,1853215,2015-05-26,2650000,796785,2969,268.36813742000675
"27 WEST 72ND   STREET, PHC",2009-01-16,4268504,2015-12-31,4950000,681496,2540,268.3055118110236
"1255 5 AVENUE, 4H",2004-06-14,534581,2006-02-02,695000,160419,598,268.25919732441474
"15 BROAD STREET, 1026",2010-12-22,999500,2013-05-03,1231000,231500,863,268.25028968713787
"210 LAFAYETTE STREET, 2B",2006-04-21,860421,2015-11-24,1800000,939579,3504,268.1446917808219
"347 WEST 57 STREET, 8E",2003-10-16,290000,2004-12-03,401000,111000,414,268.1159420289855
"1601 3 AVENUE, 16G",2003-02-20,264757,2007-07-10,694000,429243,1601,268.1093066833229
"447 WEST 18TH   STREET, 6D",2009-12-04,1500000,2017-01-27,2200000,700000,2611,268.0965147453083
"280 PARK AVENUE SOUTH, 22M",2009-07-27,830000,2015-08-25,1425000,595000,2220,268.01801801801804
"148 EAST 24TH   STREET, 10D",2012-01-31,879000,2015-06-19,1210000,331000,1235,268.0161943319838
"52 THOMAS STREET, 3C",2008-01-18,1654656,2017-09-15,2600000,945344,3528,267.9546485260771
"21 ASTOR PLACE, 3A",2004-04-29,890969,2016-09-06,2100000,1209031,4513,267.89962331043654
"250 EAST 49TH   STREET, 17A",2011-04-06,763687,2012-07-02,885000,121313,453,267.7991169977925
"333 RECTOR PLACE, 603",2011-06-01,420810,2015-09-25,843000,422190,1577,267.71718452758404
"76 MADISON AVENUE, 8B",2007-09-28,1751390,2015-05-27,2500000,748610,2798,267.5518227305218
"415 MAIN STREET, 10-C",2009-09-30,672045,2016-09-07,1350000,677955,2534,267.543409629045
"108 5 AVENUE, 12A",2003-06-30,785000,2018-06-27,2250000,1465000,5476,267.5310445580716
"415 MAIN STREET, 15-G",2013-07-17,1476462,2016-05-05,1750000,273538,1023,267.3880742913001
"200 EAST 66TH   STREET, C0603",2011-11-07,2265000,2016-10-25,2750000,485000,1814,267.3649393605292
"1 MORTON SQUARE, 4D E",2005-01-11,1654656,2008-07-07,1995000,340344,1273,267.3558523173606
"350 WEST 42ND   STREET, 42G",2006-12-11,1334173,2016-11-01,2300000,965827,3613,267.3199557154719
"655 SIXTH AVENUE, 3C",2007-06-13,3150000,2014-03-18,3810000,660000,2470,267.20647773279353
"2 BLEECKER STREET, 2",2013-04-16,3034385,2018-01-23,3500000,465615,1743,267.1342512908778
"240 WEST 98TH STREET, 5K",2010-03-25,1185721,2018-07-30,2000000,814279,3049,267.06428337159724
"120 RIVERSIDE BOULEVARD, PH3K",2006-03-28,1303360,2015-06-09,2200000,896640,3360,266.85714285714283
"25 CENTRAL PARK WEST, 2H",2003-07-03,45874,2015-05-07,1200000,1154126,4326,266.788257050393
"311 EAST 38TH   STREET, 27C",2012-06-06,1160000,2015-08-31,1475000,315000,1181,266.72311600338696
"115 4 AVENUE, 3B",2010-05-04,990000,2013-07-10,1300000,310000,1163,266.5520206362855
"393 WEST 49 STREET, 2N",2003-12-29,220038,2004-09-09,288000,67962,255,266.5176470588235
"2101 BROADWAY, 16102",2004-10-08,365000,2005-08-23,450000,85000,319,266.4576802507837
"75 WALL STREET, 21C",2011-07-15,1354272,2016-01-25,1795000,440728,1655,266.30090634441086
"510 EAST 80TH STREET, 5C",2011-05-24,735000,2014-08-19,1050000,315000,1183,266.2721893491124
"170 EAST END AVENUE, 5J",2008-06-05,2952925,2016-01-22,3695000,742075,2787,266.2630068173663
"211 ELIZABETH STREET, 4E",2010-02-08,1568105,2012-06-28,1800000,231895,871,266.23995407577496
"56 PINE STREET, 7F",2005-08-24,461370,2007-07-11,644000,182630,686,266.2244897959184
"21 ASTOR PLACE, 4F",2004-01-22,967338,2016-03-22,2150000,1182662,4443,266.1854602745892
"150 NASSAU STREET, 8G",2003-04-07,482664,2004-12-22,649000,166336,625,266.1376
"374 BROADWAY, 8A",2003-12-19,333000,2006-04-27,561800,228800,860,266.04651162790697
"333 RECTOR PLACE, 303",2011-05-24,324480,2013-05-28,520000,195520,735,266.01360544217687
"200 RECTOR PLACE, 21E",2005-05-20,1180000,2007-09-13,1405000,225000,846,265.9574468085106
"263 9 AVENUE, 5E",2006-01-13,1680122,2014-06-05,2495000,814878,3065,265.8655791190865
"45 PARK AVENUE, PH02",2008-02-05,2184146,2015-03-19,2875000,690854,2599,265.815313582147
"30 EAST 37TH STREET, 8B",2007-02-13,314968,2015-03-17,1100000,785032,2954,265.75220040622884
"240 PARK AVENUE SOUTH, 5C",2008-04-02,2265606,2016-05-02,3050000,784394,2952,265.7161246612466
"100 11TH   AVENUE, 9C",2010-12-29,1538915,2015-09-11,1995000,456085,1717,265.6290040768783
"250 EAST 53RD STREET, 2604",2008-05-09,2626821,2009-11-18,2775000,148179,558,265.5537634408602
"419 EAST 84TH   STREET, 4",2013-05-09,950000,2018-03-14,1420000,470000,1770,265.5367231638418
"500 WEST 43 STREET, 17C",2004-08-25,535000,2004-12-16,565000,30000,113,265.4867256637168
"630 1 AVENUE, 35A",2003-02-10,445000,2006-05-31,765000,320000,1206,265.33996683250416
"200 CHAMBERS STREET, 20B",2007-05-09,1709388,2013-10-03,2330000,620612,2339,265.3321932449765
"15 BROAD STREET, 1826",2006-09-22,636406,2016-07-25,1590000,953594,3594,265.3294379521425
"1 MORTON SQUARE, 8A E",2004-12-23,494963,2011-01-06,1080000,585037,2205,265.32290249433106
"311 EAST 11TH   STREET, 1B",2010-06-02,1715000,2017-06-28,2400000,685000,2583,265.1955090979481
"2000 BROADWAY, 12G",2003-10-29,704000,2016-12-12,1975000,1271000,4793,265.1783851450031
"27 WEST 72ND   STREET, 207",2007-09-06,1191352,2009-10-13,1395000,203648,768,265.1666666666667
"1 MORTON SQUARE, 10A E",2004-11-30,763687,2017-11-21,2020000,1256313,4739,265.10086516142644
"133 WEST 22ND   STREET, 5J",2009-08-19,801362,2017-07-28,1570000,768638,2900,265.04758620689654
"505 GREENWICH STREET, 11C",2005-03-22,997885,2014-07-17,1900000,902115,3404,265.01615746180966
"250 WEST STREET, 6L",2013-04-02,1934675,2018-07-30,2450000,515325,1945,264.9485861182519
"299 WEST 12TH   STREET, 15F",2007-04-06,1620000,2010-09-03,1950000,330000,1246,264.8475120385233
"32 WEST 18TH   STREET, 5B",2007-08-15,3818437,2016-12-28,4725000,906563,3423,264.8445807770961
"44 EAST 12 STREET, 9B",2003-08-29,755000,2015-04-16,1880000,1125000,4248,264.8305084745763
"211 EAST 46TH   STREET, 27F",2009-08-04,1100000,2012-09-10,1400000,300000,1133,264.783759929391
"315 7TH AVENUE, 12A",2010-10-14,620000,2016-04-07,1150000,530000,2002,264.73526473526476
"1623 3 AVENUE, 28C",2003-02-20,281791,2007-10-11,730000,448209,1694,264.586186540732
"993 LEXINGTON AVENUE, 3S",2013-10-30,5350000,2017-12-20,5750000,400000,1512,264.55026455026456
"505 GREENWICH STREET, 9E",2005-02-03,1120075,2018-01-30,2375000,1254925,4744,264.52887858347384
"45 EAST 80TH STREET, 8A",2010-03-31,2600000,2016-12-22,3250000,650000,2458,264.4426362896664
"641 FIFTH AVENUE, 39C",2006-12-15,1925000,2009-10-20,2200000,275000,1040,264.4230769230769
"195 HUDSON STREET, 6D",2003-09-10,1107347,2009-10-30,1700000,592653,2242,264.3412132024978
"252 7 AVENUE, 10R",2003-08-07,1550000,2011-12-28,2360000,810000,3065,264.2740619902121
"350 WEST 42ND   STREET, 54G",2006-12-07,1461188,2018-03-02,2545000,1083812,4103,264.1511089446746
"39 EAST 29TH STREET, 21B",2011-09-15,1215000,2016-09-09,1696000,481000,1821,264.1405820977485
"205 EAST 85TH   STREET, 6K",2010-01-20,1206584,2014-03-04,1603750,397166,1504,264.07313829787233
"516 WEST 47TH STREET, N2H",2006-03-10,448000,2007-06-15,570000,122000,462,264.0692640692641
"1641 3 AVENUE, 33F",2003-02-20,456048,2007-03-23,850000,393952,1492,264.0428954423592
"41 WEST 72 STREET, 3D",2003-09-10,738231,2006-05-25,999000,260769,988,263.9362348178138
"420 EAST 86 STREET, 4F",2006-01-31,150000,2010-11-09,610000,460000,1743,263.912794033276
"350 WEST 50 STREET, 2NN",2003-07-29,258063,2004-12-10,390000,131937,500,263.874
"400 EAST 51ST   STREET, 24B",2008-11-13,3800000,2013-01-07,4200000,400000,1516,263.85224274406335
"1 IRVING PLACE, V7D",2013-03-20,845000,2017-12-12,1300000,455000,1728,263.31018518518516
"42 WOOSTER STREET, 4NOFR",2007-06-26,3600000,2015-04-15,4350000,750000,2850,263.1578947368421
"201 EAST 36 STREET, 12E",2003-05-28,385000,2006-07-11,685000,300000,1140,263.1578947368421
"502 PARK AVENUE, 14A",2004-05-17,926608,2010-04-16,1495000,568392,2160,263.14444444444445
"127 MADISON AVENUE, 2",2010-09-24,1250920,2018-01-03,1950000,699080,2658,263.00978179082017
"845 UNITED NATIONS PLAZA, 23G",2004-11-09,1175000,2007-09-21,1450000,275000,1046,262.90630975143404
"120 RIVERSIDE BOULEVARD, 11V",2006-01-26,596287,2008-07-22,835000,238713,908,262.89977973568284
"350 WEST 42ND STREET, 43G",2006-09-21,1277510,2013-05-31,1920000,642490,2444,262.88461538461536
"1965 BROADWAY, 21J",2009-06-26,682500,2010-10-05,805000,122500,466,262.8755364806867
"502 PARK AVENUE, 9H",2003-12-03,779980,2008-07-22,1225000,445020,1693,262.85883047844067
"2250 BROADWAY, 12C",2004-02-23,899000,2008-12-12,1360000,461000,1754,262.8278221208666
"1438 THIRD AVENUE, 27B",2007-08-15,2204511,2015-11-09,2995000,790489,3008,262.79554521276594
"311 EAST 11TH   STREET, 2C",2010-05-03,716848,2014-05-01,1100000,383152,1459,262.61274845784783
"425 WEST 53RD   STREET, 402",2010-11-22,999921,2017-03-22,1607000,607079,2312,262.57742214532874
"779 RIVERSIDE DRIVE, C-33",2013-10-10,953623,2017-08-25,1325000,371377,1415,262.4572438162544
"900 PARK AVENUE, 10B",2006-09-06,1100000,2014-06-06,1842500,742500,2830,262.36749116607774
"295 GREENWICH STREET, 7HN",2005-01-05,875000,2016-06-27,1974000,1099000,4191,262.22858506323075
"8 UNION SQUARE SOUTH, 2A",2007-11-16,2474347,2009-09-16,2650000,175653,670,262.1686567164179
"321 5 AVENUE, 8D",2006-11-01,829873,2007-03-15,865000,35127,134,262.14179104477614
"163 WEST 18TH STREET, 10B",2011-05-12,1675000,2018-05-30,2350000,675000,2575,262.13592233009706
"240 EAST 47TH   STREET, 9D",2013-08-22,1205000,2015-07-10,1385000,180000,687,262.0087336244541
"200 WEST END AVENUE, 14C",2009-06-29,1700000,2018-08-22,2575000,875000,3341,261.8976354384915
"130 FULTON STREET, 11A",2007-07-12,1496827,2014-02-04,2125000,628173,2399,261.84785327219674
"502 PARK AVENUE, 15H",2004-11-15,891987,2007-04-24,1125000,233013,890,261.8123595505618
"280 PARK AVENUE SOUTH, 18B",2006-02-15,1272812,2014-09-04,2090000,817188,3123,261.6676272814601
"123 WASHINGTON STREET, 43G",2013-06-13,1242265,2016-06-17,1530000,287735,1100,261.5772727272727
"1641 3 AVENUE, 27G",2003-02-20,280727,2007-06-04,690000,409273,1565,261.51629392971245
"1 MORTON SQUARE, 7A W",2004-11-05,1018250,2009-10-15,1490000,471750,1805,261.3573407202216
"300 EAST 55 STREET, 19D",2005-05-16,2245241,2007-04-04,2425000,179759,688,261.2776162790698
"1080 MADISON AVENUE, 14A",2003-05-15,850000,2012-10-19,1750000,900000,3445,261.2481857764877
"80 RIVERSIDE BOULEVARD, 3B",2010-12-21,1209171,2016-02-12,1700000,490829,1879,261.2182011708355
"200 WEST END AVENUE, 10A",2008-02-20,1669930,2012-09-12,2105000,435070,1666,261.1464585834334
"1641 3 AVENUE, 8C",2003-02-20,251979,2008-05-12,750000,498021,1908,261.0172955974843
"422 EAST 72ND STREET, 35C",2005-07-22,1700000,2008-12-19,2025000,325000,1246,260.8346709470305
"5 EAST 22ND   STREET, 14-D",2008-01-24,1440000,2017-08-14,2350000,910000,3490,260.74498567335246
"166 EAST 63RD   STREET, 1819C",2011-05-06,2000000,2017-11-08,2620000,620000,2378,260.7232968881413
"630 1 AVENUE, 24N",2003-01-10,581500,2007-04-26,990000,408500,1567,260.6892150606254
"43 EAST 25 STREET, 18A",2003-05-12,525000,2006-07-06,825000,300000,1151,260.6429192006951
"250 EAST 30 STREET, 10C",2003-10-15,343746,2004-05-14,399000,55254,212,260.6320754716981
"350 WEST 42ND STREET, 11K",2006-05-24,595676,2008-07-16,800000,204324,784,260.6173469387755
"1965 BROADWAY, 10F",2013-03-06,1375000,2016-11-08,1725000,350000,1343,260.61057334326136
"230 RIVERSIDE DRIVE, 12E",2008-06-30,475000,2009-08-07,580000,105000,403,260.545905707196
"220 WEST 148 STREET, 1H",2010-11-04,785000,2015-03-16,1200000,415000,1593,260.5147520401758
"92 LAIGHT STREET, 9A",2008-02-11,6500000,2017-01-17,7350000,850000,3263,260.4964756359179
"444 EAST 57TH STREET, 3C",2008-08-04,700000,2018-07-31,1650000,950000,3648,260.4166666666667
"212 EAST 70TH STREET, 2A",2007-11-01,430950,2016-12-01,1295000,864050,3318,260.41289933695
"252 7 AVENUE, 12H",2003-06-23,1265000,2011-03-16,2000000,735000,2823,260.3613177470776
"425 CENTRAL PARK WEST, 3F/G",2007-10-10,1082750,2018-06-22,2100000,1017250,3908,260.29938587512794
"555 WEST 59TH STREET, 28C",2008-06-18,1705568,2018-05-07,2645000,939432,3610,260.2304709141274
"655 SIXTH AVENUE, 4G",2007-09-20,1695386,2017-11-14,2660000,964614,3708,260.14401294498384
"101 WEST 24TH   STREET, 9E",2008-09-19,1430641,2012-08-09,1800000,369359,1420,260.1119718309859
"1641 3 AVENUE, 17G",2003-02-20,256595,2007-01-26,630000,373405,1436,260.03133704735376
"340 EAST 23RD STREET, 12M",2008-01-31,2072138,2013-08-26,2601000,528862,2034,260.0108161258604
"905 WEST END AVENUE, 112",2011-11-09,2640000,2017-06-28,3175000,535000,2058,259.96112730806607
"40 EAST 66TH   STREET, 8C",2011-03-18,5956762,2012-09-19,6100000,143238,551,259.9600725952813
"1965 BROADWAY, PH1C",2003-07-03,1590000,2018-05-09,2999999,1409999,5424,259.95556784660766
"205 EAST 22ND STREET, 2D",2009-06-11,800000,2017-11-14,1600000,800000,3078,259.9090318388564
"199 PRINCE STREET, 3",2007-08-01,256466,2013-08-16,830000,573534,2207,259.8704123244223
"117 EAST 57TH   STREET, 29B",2011-05-03,1420000,2017-06-12,2000000,580000,2232,259.85663082437276
"160 CENTRAL PARK SOUTH, 2911",2006-06-21,1320000,2013-08-21,2000000,680000,2618,259.7402597402597
"40 EAST 94TH STREET, 15E",2009-09-20,459500,2014-07-29,920000,460500,1773,259.72927241962776
"99 READE STREET, 3F",2007-02-07,1395000,2008-09-26,1550000,155000,597,259.6314907872697
"40 BROAD STREET, 11H",2012-04-25,1164878,2014-08-21,1385000,220122,848,259.57783018867923
"200 CHAMBERS STREET, PHA",2007-09-24,3441685,2013-08-14,4000000,558315,2151,259.56066945606693
"1601 3 AVENUE, 27D",2003-02-20,291018,2004-04-15,400000,108982,420,259.4809523809524
"15 BROAD STREET, 2328",2007-03-19,794235,2016-03-29,1650000,855765,3298,259.47998787143723
"333 EAST 34 STREET, 11N",2004-01-26,436020,2006-08-04,675000,238980,921,259.4788273615635
"420 WEST 25TH   STREET, 4A",2009-01-15,1069162,2014-04-11,1565000,495838,1912,259.3294979079498
"2257 ADAM C POWELL BLVD, 2A",2012-07-05,529790,2014-11-21,755000,225210,869,259.15995397008055
"77 PARK AVENUE, 8G",2003-07-22,645000,2007-12-19,1062500,417500,1611,259.15580384854127
"252 WEST 30TH STREET, 7B",2010-12-21,1725000,2018-02-07,2400000,675000,2605,259.11708253358927
"1 SHERIDAN SQUARE, 5D",2003-09-17,475000,2004-09-10,568000,93000,359,259.05292479108635
"38 DELANCEY STREET, 5C",2010-10-28,626223,2016-05-11,1150000,523777,2022,259.0390702274975
"1485 FIFTH AVENUE, 14E",2012-04-30,709000,2015-09-02,1025000,316000,1220,259.0163934426229
"115 4 AVENUE, 7I",2003-12-17,900000,2016-05-19,2075000,1175000,4537,258.98170597310997
"641 5 AVENUE, 30H",2008-08-29,2275000,2016-12-06,3057375,782375,3021,258.97881496193315
"145 EAST 48 STREET, 15A",2004-10-08,380000,2005-07-25,455000,75000,290,258.62068965517244
"200 WEST END AVENUE, 9E",2008-02-12,1949948,2014-04-04,2530000,580052,2243,258.6054391440036
"150 NASSAU STREET, 12C",2004-01-14,1374638,2017-05-25,2635000,1260362,4880,258.2709016393443
"127 7 AVENUE, 6B",2009-06-05,936790,2013-06-28,1320000,383210,1484,258.2277628032345
"105 NORFOLK STREET, 6B",2007-02-26,1043781,2008-10-23,1200000,156219,605,258.21322314049587
"100 RIVERSIDE BOULEVARD, 20C",2008-06-06,2372522,2014-07-22,2950000,577478,2237,258.14841305319624
"310 EAST 53RD STREET, 17B",2006-11-03,2769321,2014-08-04,3500000,730679,2831,258.09925821264574
"250 EAST 54TH   STREET, 25C",2011-10-13,925000,2016-05-25,1360000,435000,1686,258.0071174377224
"1623 3 AVENUE, 41D",2003-02-20,302376,2007-03-14,685000,382624,1483,258.0067430883345
"21 ASTOR PLACE, 9C",2004-05-19,3054750,2009-08-21,3550000,495250,1920,257.9427083333333
"350 WEST 42ND STREET, 35E",2010-07-16,880000,2013-07-25,1165000,285000,1105,257.9185520361991
"56 THOMAS STREET, 3",2005-07-14,1900000,2013-06-11,2645000,745000,2889,257.8746971270336
"635 WEST 42ND   STREET, 28K",2009-02-25,1414858,2015-11-24,2050000,635142,2463,257.8733252131547
"835 RIVERSIDE DRIVE, 3D",2012-09-27,524398,2014-12-23,735000,210602,817,257.77478580171356
"160 WADSWORTH AVENUE, 301",2013-09-27,280000,2017-05-30,625000,345000,1341,257.27069351230426
"571 ACADEMY STREET, 5F",2003-05-27,95750,2006-06-05,380000,284250,1105,257.23981900452486
"15 BROAD STREET, 1720",2006-07-07,1832850,2017-11-15,2900000,1067150,4149,257.2065557965775
"200 EAST 66TH   STREET, C1803",2011-06-16,3411137,2016-08-29,3900000,488863,1901,257.16096791162545
"15 BROAD STREET, 3420",2006-09-28,1985587,2008-10-23,2180000,194413,756,257.1600529100529
"28 LAIGHT STREET, 2E",2005-11-08,3575000,2012-03-30,4175000,600000,2334,257.0694087403599
"404 EAST 76TH   STREET, 4F",2013-09-10,430000,2015-05-14,587000,157000,611,256.95581014729953
"56 THOMAS STREET, 5",2003-11-21,1325000,2012-04-30,2117000,792000,3083,256.89263704184236
"48 LAIGHT STREET, 5N",2006-06-26,1451006,2017-06-14,2480000,1028994,4006,256.8632051922117
"5 WEST 127 STREET, 5B",2013-01-30,609000,2017-03-13,995000,386000,1503,256.81969394544245
"18 WEST 48TH STREET, 17C",2012-10-22,980000,2017-01-27,1380000,400000,1558,256.73940949935815
"252 7 AVENUE, 3G",2003-01-31,1140000,2018-08-28,2600000,1460000,5688,256.6807313642757
"2112 BROADWAY, 7/8ET",2008-05-14,4785775,2015-07-16,5458000,672225,2619,256.6723940435281
"146 CHAMBERS STREET, 5",2008-01-17,1843032,2017-12-27,2775000,931968,3632,256.59911894273125
"515 EAST 72ND   STREET, 19F",2009-08-12,1440823,2016-12-08,2127000,686177,2675,256.5147663551402
"93 WORTH STREET, 310",2014-04-02,789144,2017-01-13,1050000,260856,1017,256.49557522123894
"2300 FREDRICK DOUGLASS BL, 7F",2012-07-03,480000,2015-12-03,800000,320000,1248,256.4102564102564
"133 WEST 14TH STREET, 3",2007-06-28,1410000,2018-06-08,2435000,1025000,3998,256.3781890945473
"80 RIVERSIDE BOULEVARD, 3H",2009-12-29,846757,2015-06-23,1360000,513243,2002,256.36513486513485
"160 CENTRAL PARK SOUTH, 2307",2005-07-15,1600000,2014-01-30,2400000,800000,3121,256.32809996795896
"155 EAST 38 STREET, 20A",2005-07-15,240000,2008-02-26,485000,245000,956,256.27615062761504
"450 WEST 17TH STREET, 2306",2013-11-08,2700000,2016-05-13,2935000,235000,917,256.2704471101418
"415 GREENWICH STREET, 4E",2008-05-16,2456528,2012-09-07,2860000,403472,1575,256.1726984126984
"1 MORTON SQUARE, 3D W",2005-01-13,2214693,2013-12-18,3050000,835307,3261,256.1505673106409
"22 RENWICK STREET, 6B",2014-01-07,1575000,2017-06-29,1900000,325000,1269,256.107171000788
"2000 BROADWAY, 8G",2003-03-07,100000,2015-06-23,1250000,1150000,4491,256.0676909374304
"211 WEST 18TH STREET, 5",2005-05-25,1323725,2014-07-21,2180000,856275,3344,256.0630980861244
"250 MANHATTAN AVENUE, 1C",2013-05-21,687318,2017-10-19,1100000,412682,1612,256.0062034739454
"215 EAST 80TH   STREET, 5E",2014-01-16,1050000,2016-06-13,1275000,225000,879,255.9726962457338
"555 WEST 59TH   STREET, 10G",2009-04-24,1221900,2015-03-25,1775000,553100,2161,255.94632114761686
"32 EAST 76TH   STREET, 503",2011-07-08,1250000,2014-12-29,1575000,325000,1270,255.90551181102362
"101 WARREN STREET, 7J",2008-05-12,2443800,2017-07-11,3300000,856200,3347,255.81117418583807
"325 5 AVENUE, 36C",2008-09-03,1800000,2015-07-31,2445000,645000,2522,255.7494052339413
"101 WEST 24TH STREET, 9D",2008-08-21,1512101,2011-12-08,1820000,307899,1204,255.73006644518273
"393 WEST 49 STREET, 6II",2005-05-09,499000,2006-06-08,600000,101000,395,255.69620253164558
"40 BOND STREET, 6D",2009-10-16,2036500,2017-12-19,2800000,763500,2986,255.6932350971199
"210 LAFAYETTE STREET, PH1A",2006-03-07,2163525,2009-04-01,2450000,286475,1121,255.55307760927744
"555 WEST 59TH STREET, 19F",2008-04-18,1608835,2014-02-04,2150000,541165,2118,255.50755429650613
"450 WEST 17TH STREET, 2507",2011-02-04,4575000,2012-12-20,4750000,175000,685,255.47445255474452
"108 5 AVENUE, 16A",2008-07-17,1395000,2017-03-03,2200000,805000,3151,255.47445255474452
"641 5TH AVENUE, 27B",2012-05-08,2170000,2014-06-30,2370000,200000,783,255.4278416347382
"130 FULTON STREET, 12B",2006-07-19,1832850,2016-05-18,2750000,917150,3591,255.4023948760791
"80 RIVERSIDE BOULEVARD, 10A",2011-08-10,1251892,2015-07-02,1615000,363108,1422,255.35021097046413
"165 CHARLES STREET, RU10",2006-06-30,5193075,2012-11-15,5787865,594790,2330,255.27467811158797
"186 WEST 80 STREET, 7H",2004-01-30,290000,2005-05-18,411000,121000,474,255.27426160337552
"225 5 AVENUE, 10R",2007-03-28,1069162,2013-09-27,1675000,605838,2375,255.08968421052631
"345 EAST 80 STREET, 10L",2003-07-01,355000,2005-11-10,575000,220000,863,254.92468134414833
"20 WEST STREET, 36H",2006-12-19,451230,2007-10-24,530000,78770,309,254.9190938511327
"354 BROOME STREET, 3H",2010-01-25,1025000,2012-06-27,1250000,225000,884,254.52488687782807
"520 WEST 19TH STREET, 2A",2008-10-21,1756481,2017-06-13,2560000,803519,3157,254.51979727589483
"308 EAST 72 STREET, 6A",2004-08-05,1875000,2016-09-12,3000000,1125000,4421,254.46731508708436
"105 NORFOLK STREET, 9A",2013-02-14,892000,2016-12-22,1250000,358000,1407,254.44207533759771
"630 1 AVENUE, 17E",2003-02-20,555000,2005-04-20,756000,201000,790,254.43037974683546
"800 TENTH AVENUE, 4P",2011-07-20,1040000,2014-05-07,1300000,260000,1022,254.40313111545987
"447 WEST 18TH   STREET, 6A",2009-06-05,1901581,2014-04-03,2350000,448419,1763,254.34997163925127
"15 BROAD STREET, 830",2010-05-06,917500,2016-01-29,1450000,532500,2094,254.29799426934096
"311 GREENWICH STREET, 3I",2010-12-23,765000,2015-10-08,1210000,445000,1750,254.28571428571428
"62 EAST 1ST   STREET, 4N",2010-02-02,835000,2016-03-04,1400000,565000,2222,254.27542754275427
"275 WEST 96TH   STREET, 4B-1",2012-09-15,650000,2015-08-13,920000,270000,1062,254.23728813559322
"260 PARK AVENUE SOUTH, 3H",2008-05-30,2015000,2014-06-11,2575000,560000,2203,254.1988197911938
"52 PARK AVENUE, 12",2004-04-20,916425,2014-11-24,1900000,983575,3870,254.15374677002583
"2 COLUMBUS AVENUE, 18C",2004-03-25,1300000,2009-08-14,1800000,500000,1968,254.0650406504065
"311 EAST 38 STREET, 17C",2004-01-15,315000,2006-04-24,525700,210700,830,253.85542168674698
"200 WEST END AVENUE, PHD N",2008-07-25,4276650,2014-10-02,4850000,573350,2260,253.6946902654867
"30 ORCHARD STREET, PHA",2013-04-04,2214693,2017-12-15,2650000,435307,1716,253.67540792540794
"225 5 AVENUE, 9S",2007-06-15,1664838,2018-08-17,2700000,1035162,4081,253.6540063709875
"129 WEST 20TH   STREET, 5C",2009-08-27,765000,2015-09-14,1325000,560000,2209,253.50837483023992
"220 WEST 148 STREET, 4L",2010-10-04,715000,2017-05-26,1330000,615000,2426,253.50370981038748
"650 AVENUE OF THE AMER, 3N",2011-03-24,982611,2015-06-19,1375000,392389,1548,253.4812661498708
"222 WEST 14TH STREET, 11D",2005-08-24,415000,2007-08-24,600000,185000,730,253.42465753424656
"1965 BROADWAY, 8D",2007-04-30,2000000,2017-01-19,2900000,900000,3552,253.3783783783784
"120 GREENWICH STREET, 10C",2006-08-24,769034,2015-11-04,1620000,850966,3359,253.33908901458767
"148 EAST 24TH   STREET, 6C",2012-01-25,660000,2014-02-13,850000,190000,750,253.33333333333334
"80 CHAMBERS STREET, 13B",2011-12-28,840000,2016-06-23,1255000,415000,1639,253.20317266625992
"768 5 AVENUE, 606",2008-07-08,4558466,2016-07-15,5300000,741534,2929,253.16968248548991
"260 WEST BROADWAY, 9E",2005-08-03,1290000,2013-07-17,2025000,735000,2905,253.0120481927711
"101 WARREN STREET, 780",2008-07-02,1883762,2015-09-18,2550000,666238,2634,252.93773728170083
"55 EAST 86TH   STREET, 3-C",2011-07-19,1200000,2014-05-22,1462500,262500,1038,252.89017341040463
"240 RIVERSIDE BOULEVARD, 5 N-T",2011-05-17,765000,2014-06-17,1050000,285000,1127,252.88376220053237
"115 4 AVENUE, 4G",2006-07-31,1055000,2015-06-17,1875000,820000,3243,252.85229725562752
"530 EAST 76TH   STREET, 31K",2011-05-31,1230000,2017-03-23,1766750,536750,2123,252.82618935468676
"88 JANE STREET, BD",2011-02-15,2850000,2018-03-02,3500000,650000,2572,252.72161741835149
"40 WEST 116 STREET, B1009",2009-08-13,652600,2014-06-19,1100000,447400,1771,252.6256352343309
"350 WEST 42ND   STREET, PH B",2006-12-11,1344090,2015-02-20,2100000,755910,2993,252.55930504510525
"200 RIVERSIDE BOULEVARD, 30E",2006-06-15,1550000,2008-01-30,1700000,150000,594,252.5252525252525
"333 RECTOR PLACE, 204",2011-04-27,825000,2018-05-15,1475000,650000,2575,252.4271844660194
"2 COLUMBUS AVENUE, 34C",2004-05-28,1750000,2016-11-17,2900000,1150000,4556,252.414398595259
"1 IRVING PLACE, V16A",2013-08-05,995000,2017-11-17,1390000,395000,1565,252.3961661341853
"10 WEST END AVENUE, 28D",2007-10-11,1636753,2014-06-06,2250000,613247,2430,252.36502057613168
"211 WEST 71ST   STREET, 16C",2012-09-28,1760000,2015-01-28,1975000,215000,852,252.34741784037558
"136 BAXTER STREET, 2C",2009-05-28,1750000,2013-01-09,2083333,333333,1322,252.142965204236
"425 FIFTH AVENUE, 64B",2006-05-25,2153598,2007-12-07,2295000,141402,561,252.05347593582889
"225 EAST 34TH   STREET, 17H",2008-02-06,2163781,2015-03-05,2815000,651219,2584,252.01973684210526
"120 WEST 58TH STREET, 9A",2006-03-14,300000,2015-08-27,1170000,870000,3453,251.95482189400522
"367 WEST 49TH   STREET, 1D",2007-06-29,560000,2008-11-26,690000,130000,516,251.93798449612405
"230 RIVERSIDE DRIVE, 11H",2008-06-29,307000,2013-12-16,809508,502508,1996,251.75751503006012
"515 EAST 72ND   STREET, 21G",2010-04-13,1200000,2016-05-16,1760000,560000,2225,251.68539325842696
"240 RIVERSIDE BOULEVARD, 6 E-T",2005-11-18,2380000,2018-01-24,3500000,1120000,4450,251.68539325842696
"230 RIVERSIDE DRIVE, 8P",2008-06-30,475000,2010-08-02,666953,191953,763,251.57667103538662
"245 EAST 93RD   STREET, 21H",2009-10-09,995000,2016-05-11,1600000,605000,2406,251.4546965918537
"20 WEST 64TH   STREET, 28M",2014-08-19,1120000,2016-07-15,1295000,175000,696,251.4367816091954
"160 WOOSTER STREET, 4C",2005-03-03,1934675,2012-02-22,2575000,640325,2547,251.40361209265802
"25 MURRAY STREET, 6A",2008-08-07,1517192,2016-05-13,2230000,712808,2836,251.34273624823695
"120 RIVERSIDE BOULEVARD, 8S",2006-08-08,1324539,2017-03-24,2300000,975461,3881,251.34269518165422
"309 WEST 118 STREET, 1PTPL",2005-03-23,636406,2010-07-20,1125000,488594,1945,251.2051413881748
"450 WEST 17TH STREET, 1701",2009-09-25,585000,2015-11-24,1150000,565000,2251,250.99955575299867
"115 NORFOLK STREET, 201",2011-06-28,1088509,2015-09-15,1475000,386491,1540,250.96818181818182
"1601 3 AVENUE, 22J",2003-02-20,281438,2007-08-06,690000,408562,1628,250.95945945945945
"303 EAST 33RD   STREET, 5M",2010-08-05,793216,2015-01-12,1200000,406784,1621,250.94632942628007
"641 5 AVENUE, 22N",2006-07-25,750000,2014-08-22,1490000,740000,2950,250.84745762711864
"1601 3 AVENUE, 21G",2003-02-20,273984,2008-03-03,735000,461016,1838,250.8248095756257
"250 WEST STREET, 9G",2013-04-08,3950810,2017-01-30,4300000,349190,1393,250.67480258435032
"241 WEST 19TH   STREET, 8S",2008-11-25,1540103,2014-12-18,2095000,554897,2214,250.63098464317977
"401 EAST 60TH   STREET, 19A",2011-06-08,1800000,2015-07-14,2175000,375000,1497,250.50100200400803
"201 WEST 72 STREET, 8K",2006-02-08,1375000,2013-06-26,2050000,675000,2695,250.46382189239333
"1623 3 AVENUE, 26A",2003-02-20,540997,2014-09-19,1600000,1059003,4229,250.4145187987704
"24 WEST 45 STREET, 4",2003-01-22,780000,2004-10-22,940000,160000,639,250.39123630672927
"144 WEST 18TH   STREET, 400N",2008-12-03,1675000,2012-08-02,2010000,335000,1338,250.37369207772795
"280 PARK AVENUE SOUTH, 27C",2011-03-23,1069162,2017-11-06,1675000,605838,2420,250.34628099173554
"322 WEST 57TH   STREET, 53K1",2011-04-07,1400093,2017-05-22,1960000,559907,2237,250.29369691551184
"70 BATTERY PLACE, 27D",2009-03-16,3212578,2014-07-16,3700000,487422,1948,250.21663244353184
"99 JOHN STREET, 1803",2009-10-02,1040000,2018-08-15,1850000,810000,3239,250.07718431614697
"44 EAST 12TH STREET, 9A",2004-11-02,770000,2007-02-20,980000,210000,840,250.0
"260 PARK AVENUE SOUTH, 7A",2006-06-28,1858306,2012-12-21,2450000,591694,2368,249.87077702702703
"300 EAST 55 STREET, 12B",2005-03-17,1471371,2017-01-30,2555000,1083629,4337,249.85681346552917
"115 FOURTH AVENUE, 3G",2011-06-17,1280000,2013-11-14,1500000,220000,881,249.71623155505108
"1601 3 AVENUE, 27J",2003-02-20,293503,2007-01-18,650000,356497,1428,249.64775910364145
"90 FRANKLIN STREET, 10N",2004-09-27,1880000,2011-04-08,2475000,595000,2384,249.58053691275168
"11 EAST 29TH   STREET, 12A",2008-02-01,1690295,2016-12-20,2500000,809705,3245,249.52388289676426
"51 WALKER STREET, 8A",2007-02-15,1761345,2012-08-29,2265000,503655,2022,249.08753709198814
"305 EAST 51ST   STREET, RU15D",2015-07-29,1657124,2017-06-02,1825000,167876,674,249.07418397626114
"455 CENTRAL PARK WEST, 10",2005-10-17,4099474,2012-12-12,4750000,650526,2613,248.95752009184844
"260 PARK AVENUE SOUTH, 8F",2009-07-02,1037000,2010-09-29,1150000,113000,454,248.8986784140969
"301 EAST 79TH   STREET, PH J",2010-12-15,1975000,2015-01-30,2350000,375000,1507,248.8387524883875
"45 PARK AVENUE, 1101",2007-11-27,2067047,2017-01-26,2900000,832953,3348,248.79121863799284
"1420 YORK AVENUE, 5H",2004-08-12,233000,2006-08-30,419000,186000,748,248.66310160427807
"200 EAST 89 STREET, 23B",2003-10-28,462557,2006-06-29,705000,242443,975,248.65948717948717
"223 WEST 19TH   STREET, 6",2008-06-24,2700000,2016-07-08,3430000,730000,2936,248.6376021798365
"101 WARREN STREET, 880",2008-07-03,1871696,2017-08-18,2700000,828304,3333,248.51605160516053
"309 WEST 118 STREET, 1OTPL",2005-04-11,610950,2010-12-30,1130000,519050,2089,248.46816658688368
"15 WEST 63RD STREET, 19C",2008-03-25,2175000,2018-06-07,3100000,925000,3726,248.2555018786903
"226 EAST 52 STREET, 22",2003-04-11,346000,2005-12-19,590000,244000,983,248.21973550356054
"133 WEST 22ND   STREET, 7C",2008-12-24,981000,2014-09-15,1500000,519000,2091,248.20659971305597
"211 EAST 46TH   STREET, 15G",2008-10-10,772729,2013-06-28,1200000,427271,1722,248.12485481997678
"355 GREENWICH STREET, 2B",2005-09-06,1100000,2015-06-25,1988000,888000,3579,248.11399832355406
"450 WEST 17TH   STREET, 1122",2008-10-21,946972,2016-01-05,1600000,653028,2632,248.1109422492401
"135 WEST 4TH   STREET, PHW",2007-06-27,6068770,2010-01-14,6300000,231230,932,248.10085836909872
"150 NASSAU STREET, 3I",2003-05-28,300767,2005-07-19,495000,194233,783,248.0625798212005
"302 WEST 12TH STREET, 6D",2014-06-25,1850000,2018-01-26,2175000,325000,1311,247.90236460717009
"108 5 AVENUE, 14C",2003-01-28,575000,2015-04-29,1683750,1108750,4474,247.820742065266
"400 EAST 67TH   STREET, 5G",2011-03-25,2087412,2018-02-05,2708750,621338,2509,247.64368274212833
"382 CENTRAL PARK WEST, 2N",2007-04-19,200000,2015-02-03,905000,705000,2847,247.6290832455216
"7 ESSEX STREET, 9",2003-10-14,911334,2014-12-11,1920000,1008666,4076,247.4646712463199
"11 PRINCE STREET, 1B",2004-08-06,998500,2014-01-08,1850000,851500,3442,247.38524113887274
"350 EAST 30TH   STREET, 3E",2012-12-20,400000,2016-05-06,705000,305000,1233,247.36415247364152
"1 MORTON SQUARE, 11A W",2004-12-07,2072138,2018-07-11,3300000,1227862,4964,247.35334407735698
"1474 THIRD AVENUE, 2S",2008-03-04,1929583,2015-09-15,2610000,680417,2751,247.33442384587423
"845 UNITED NATIONS PLAZA, 40D",2005-11-21,1800000,2015-04-21,2650000,850000,3438,247.2367655613729
"524 EAST 72ND STREET, 24E",2006-09-05,25000,2015-12-01,859000,834000,3374,247.18435091879076
"25 CENTRAL PARK WEST, 4F",2004-03-30,827500,2010-12-22,1435000,607500,2458,247.15215622457282
"44 EAST 12TH STREET, 4C",2004-11-01,595000,2006-04-11,725000,130000,526,247.14828897338404
"200 CHAMBERS STREET, 5D",2007-05-11,1437198,2018-07-31,2450000,1012802,4099,247.08514271773603
"1600 BROADWAY, 6G",2011-07-20,1265000,2016-04-15,1692500,427500,1731,246.96707105719238
"15 BROAD STREET, 1920",2006-06-29,1540223,2013-05-31,2164500,624277,2528,246.9450158227848
"845 UNITED NATIONS PLAZA, 50A",2003-09-24,2168873,2011-11-03,2900000,731127,2962,246.83558406482106
"18 WEST 48TH   STREET, 26A",2007-06-06,1742430,2009-09-24,1950000,207570,841,246.81331747919143
"75 WALL STREET, 19A",2012-11-16,1349181,2017-04-28,1750000,400819,1624,246.8097290640394
"80 RIVERSIDE BOULEVARD, 14A",2010-09-29,1237173,2016-10-07,1780000,542827,2200,246.73954545454546
"133 WEST 22ND   STREET, 9J",2009-06-03,763687,2012-04-27,1024850,261163,1059,246.61284230406042
"161 EAST 110 STREET, 4F",2012-08-15,501930,2015-12-07,800000,298070,1209,246.54259718775847
"416 WASHINGTON STREET, 3K",2005-11-23,880786,2010-08-30,1310000,429214,1741,246.53302699597933
"2250 BROADWAY, ME",2007-11-07,1650000,2013-12-17,2200000,550000,2232,246.415770609319
"2 RIVER TERRACE, 6K",2012-03-20,841000,2017-11-15,1350000,509000,2066,246.3697967086157
"444 WEST 19TH STREET, 201",2006-07-10,1195000,2009-08-20,1475000,280000,1137,246.26209322779243
"219 WEST 81ST   STREET, 5G",2009-11-06,1029000,2014-07-15,1450000,421000,1712,245.91121495327104
"421 EAST 13TH   STREET, 2P",2008-09-18,1598652,2016-07-12,2300000,701348,2854,245.74211632796076
"211 EAST 2ND   STREET, 4",2008-01-30,1850000,2015-04-08,2495000,645000,2625,245.71428571428572
"162 WEST 56TH   STREET, 1102",2012-08-01,620000,2014-07-15,795000,175000,713,245.44179523141656
"254 PARK AVENUE SOUTH, 4B",2010-08-05,485439,2013-10-28,775000,289561,1180,245.3906779661017
"68 BRADHURST AVENUE, 5-W",2007-05-14,521799,2008-03-28,600000,78201,319,245.14420062695925
"75 WALL STREET, 25F",2010-09-29,997885,2016-03-29,1490000,492115,2008,245.07719123505976
"210 LAFAYETTE STREET, 2E",2006-02-24,1425550,2016-06-24,2350000,924450,3773,245.0172276702889
"381 LENOX AVENUE, 3-D",2009-03-05,733140,2017-01-27,1440000,706860,2885,245.01213171577123
"450 WEST 17TH STREET, 2401",2012-07-30,1400000,2017-08-10,1850000,450000,1837,244.96461622210126
"211 EAST 46TH   STREET, 25G",2008-03-27,878668,2011-09-19,1190000,311332,1271,244.95043273013374
"275 GREENWICH STREET, 11AS",2004-04-01,888000,2008-07-10,1270000,382000,1561,244.7149263292761
"923 5 AVENUE, 7-C",2007-04-16,3250000,2010-10-12,3562000,312000,1275,244.7058823529412
"243 WEST 98TH STREET, 2B",2006-01-23,870000,2010-04-07,1245585,375585,1535,244.68078175895766
"460 EAST 79 STREET, 5E",2003-03-20,789640,2007-07-17,1176000,386360,1580,244.53164556962025
"280 PARK AVENUE SOUTH, 27B",2005-08-09,1355000,2016-11-30,2365000,1010000,4131,244.49285887194384
"343 EAST 30TH   STREET, 10-H",2011-10-14,1525000,2017-02-07,2000000,475000,1943,244.46731857951622
"300 RECTOR PLACE, 8G",2004-02-26,335000,2004-10-08,390000,55000,225,244.44444444444446
"425 5 AVENUE, 18E",2004-05-27,539673,2008-02-28,875000,335327,1372,244.40743440233237
"324 WEST 23RD STREET, 5B",2010-07-15,1212500,2017-05-05,1820000,607500,2486,244.36846339501207
"1255 5 AVENUE, 5E",2011-08-15,395000,2017-01-20,880000,485000,1985,244.3324937027708
"450 WEST 17TH STREET, 1811",2012-07-26,1090900,2018-01-18,1580000,489100,2002,244.30569430569432
"462 WEST 58TH   STREET, 5D",2010-06-10,1210000,2015-12-07,1700000,490000,2006,244.26719840478563
"43 EAST 25TH   STREET, 24B",2008-09-29,1995000,2013-12-16,2460000,465000,1904,244.22268907563026
"1601 3 AVENUE, 25G",2003-02-20,282502,2008-05-19,750000,467498,1915,244.1242819843342
"1235 PARK AVENUE, 11D",2013-09-16,1300000,2017-06-20,1635000,335000,1373,243.99126001456665
"117 WEST 123 STREET, 4C",2011-05-26,735000,2018-04-20,1350000,615000,2521,243.95081316937723
"101 WARREN STREET, 3030",2009-03-10,2688180,2017-03-07,3400000,711820,2919,243.85748544021925
"715 PARK AVENUE, 11E",2003-09-09,700000,2014-12-01,1700000,1000000,4101,243.84296513045598
"106 CENTRAL PARK SOUTH, 19C",2013-12-02,650000,2016-10-13,905000,255000,1046,243.78585086042065
"93 WORTH STREET, 1105",2014-02-28,2596538,2017-07-27,2900000,303462,1245,243.74457831325302
"254 PARK AVENUE SOUTH, 4K",2013-06-14,906242,2015-08-18,1100000,193758,795,243.72075471698113
"66 LEONARD STREET, 11C",2003-12-16,2570000,2010-06-23,3150000,580000,2381,243.59512809743805
"2 COLUMBUS AVENUE, 21C",2004-09-21,1650000,2010-10-18,2190000,540000,2218,243.46257889990983
"25 CENTRAL PARK WEST, 2N",2007-09-10,4150000,2011-08-18,4500000,350000,1438,243.39360222531295
"415 MAIN STREET, 7-G",2009-12-04,1180000,2017-08-31,1868000,688000,2827,243.36752741422004
"715 PARK AVENUE, 5D",2006-01-05,1925000,2017-07-18,2950000,1025000,4212,243.35232668566002
"133 WEST 22ND   STREET, PHB",2009-04-01,4225000,2016-11-04,4900000,675000,2774,243.33093006488824
"22 WEST 15 STREET, 11H",2004-07-29,890000,2005-08-03,980000,90000,370,243.24324324324326
"161 GRAND STREET, 7A",2005-10-12,2600000,2014-03-24,3350000,750000,3085,243.11183144246354
"230 WEST 56 STREET, 48C",2003-08-25,1868489,2005-02-16,2000000,131511,541,243.08872458410352
"353 WEST 56 STREET, 2I",2003-09-26,620000,2006-11-17,899000,279000,1148,243.03135888501743
"455 MAIN STREET, 10H",2006-03-30,491790,2008-01-10,650000,158210,651,243.02611367127497
"5 EAST 22ND STREET, 12S",2015-10-20,1080000,2017-09-19,1250000,170000,700,242.85714285714286
"50 WEST 15TH STREET, 3E",2008-10-30,1563013,2016-07-29,2250000,686987,2829,242.83739837398375
"10 WEST END AVENUE, 16A",2007-09-24,1481287,2015-05-20,2160000,678713,2795,242.83112701252236
"310 WEST 52ND   STREET, 15B",2007-07-31,1109892,2015-01-29,1775000,665108,2739,242.82876962395034
"15 BROAD STREET, 1916",2006-06-15,992793,2018-05-17,2050000,1057207,4354,242.81281580156178
"455 MAIN STREET, 5J",2011-05-06,570000,2017-04-27,1100000,530000,2183,242.78515803939533
"200 CHAMBERS STREET, 8G",2007-07-27,2036500,2017-11-15,2950000,913500,3764,242.69394261424017
"160 CENTRAL PARK SOUTH, 555",2004-09-08,629000,2013-05-22,1400000,771000,3178,242.60541220893643
"260 PARK AVENUE SOUTH, 5I",2006-05-12,1550000,2016-10-20,2475000,925000,3814,242.5275301520713
"237 WEST 115 STREET, 6A",2009-05-27,605858,2015-06-08,1140000,534142,2203,242.46118928733546
"225 LAFAYETTE STREET, 4B",2005-02-22,911333,2013-10-08,1675000,763667,3150,242.43396825396826
"817 WEST END AVENUE, 11EE",2007-12-27,276490,2010-04-23,482000,205510,848,242.34669811320754
"2257 ADAM CLAYTON POWELL, PHA",2014-12-30,760000,2016-11-10,925000,165000,681,242.2907488986784
"40 WEST 116 STREET, B706",2008-10-31,411640,2014-06-19,910000,498360,2057,242.27515799708314
"354 BROOME STREET, 5E",2003-08-19,900000,2010-12-23,1550000,650000,2683,242.2661200149087
"150 EAST 85 STREET, 4C",2003-07-10,233220,2004-07-23,325000,91780,379,242.16358839050133
"135 EAST 54 STREET, 12H",2003-11-28,482500,2006-11-16,745000,262500,1084,242.15867158671585
"515 EAST 72ND   STREET, 27B",2009-09-30,1170987,2015-03-02,1650000,479013,1979,242.04800404244568
"400 FIFTH AVENUE, 33F",2012-04-12,1451006,2016-03-24,1800000,348994,1442,242.02080443828018
"101 WARREN STREET, 980",2008-07-28,1949948,2016-06-29,2650000,700052,2893,241.98133425509852
"1623 3 AVENUE, 32C",2003-02-20,283211,2008-04-03,735000,451789,1869,241.72766185125735
"5 EAST 22ND STREET, 10-D",2005-01-19,1219863,2016-09-20,2250000,1030137,4262,241.7027217268888
"2112 BROADWAY, 7/8BT",2007-05-03,7535050,2015-06-08,8250000,714950,2958,241.7004732927654
"170 EAST 77TH STREET, 10A",2007-09-06,3660608,2015-06-29,4350000,689392,2853,241.63757448300035
"1623 3 AVENUE, 33G",2003-02-20,307345,2006-11-28,640000,332655,1377,241.57952069716777
"150 NASSAU STREET, 18A",2004-03-02,3237871,2012-10-22,4000000,762129,3156,241.48574144486693
"516 WEST 47 STREET, S1H",2006-05-31,675099,2007-04-27,755000,79901,331,241.392749244713
"123 WASHINGTON STREET, 51H",2012-07-16,998862,2015-12-17,1300333,301471,1249,241.36989591673338
"225 RECTOR PLACE, 10S",2015-06-24,720000,2016-10-13,835000,115000,477,241.0901467505241
"310 WEST 52ND   STREET, 37J",2007-05-16,1352745,2013-08-02,1900000,547255,2270,241.08149779735683
"264 WATER STREET, 4A",2014-09-16,1262630,2018-01-11,1555000,292370,1213,241.03050288540808
"382 CENTRAL PARK WEST, 11W",2003-04-29,525000,2005-12-29,760000,235000,975,241.02564102564102
"395 BROADWAY, 8D",2004-09-02,975000,2016-01-12,1975000,1000000,4149,241.02193299590263
"225 FIFTH AVENUE, 2P",2008-08-07,1390000,2015-10-26,2025000,635000,2636,240.89529590288316
"11 EAST 29TH   STREET, 32A",2008-02-28,2423435,2016-07-15,3160000,736565,3060,240.70751633986927
"517 WEST 46TH STREET, 302",2013-01-18,1175000,2015-10-02,1412500,237500,987,240.62816616008107
"49 EAST 21ST STREET, 2D",2005-02-11,992793,2018-04-16,2150000,1157207,4812,240.48358270989195
"123 3 AVENUE, 4D",2011-06-03,600635,2014-08-12,881000,280365,1166,240.45025728987994
"400 EAST 70TH STREET, 2603",2011-11-07,1307600,2016-08-08,1725000,417400,1736,240.43778801843317
"269 BROADWAY, 11C",2004-12-21,728048,2008-01-22,999000,270952,1127,240.41881100266193
"170 EAST END AVENUE, 3M",2008-03-24,1731025,2009-12-04,1880000,148975,620,240.28225806451613
"81 WHITE STREET, 3E",2005-08-17,1337090,2018-01-09,2425000,1087910,4528,240.26280918727915
"250 SOUTH END AVENUE, 8D",2005-04-18,699000,2007-08-03,900000,201000,837,240.14336917562724
"255 HUDSON STREET, 10E",2007-12-21,2413252,2010-09-02,2650000,236748,986,240.10953346855985
"7 ESSEX STREET, 7",2003-12-05,845148,2017-02-06,2000000,1154852,4812,239.99418121363257
"79 LAIGHT STREET, 2C",2004-05-19,2500000,2011-10-19,3150000,650000,2709,239.94093761535623
"200 RIVERSIDE BOULEVARD, 5E",2004-08-11,632000,2018-06-15,1845000,1213000,5056,239.9129746835443
"846-48 2 AVENUE, 6B",2003-02-10,390000,2004-03-12,485000,95000,396,239.8989898989899
"40 BROAD STREET, 25H",2011-05-04,1226392,2015-02-23,1560000,333608,1391,239.8332135154565
"45 PARK AVENUE, 1603",2007-12-20,2036500,2016-02-12,2750000,713500,2976,239.7513440860215
"40 WEST 116 STREET, B310",2008-12-02,386540,2015-03-25,938800,552260,2304,239.69618055555554
"14 LEONARD STREET, PH-B",2006-10-17,2825000,2015-12-07,3625000,800000,3338,239.6644697423607
"250 EAST 49TH   STREET, 15A",2010-06-02,715000,2013-09-04,999999,284999,1190,239.49495798319327
"39 EAST 29TH   STREET, 16B",2012-07-30,1238000,2018-01-12,1715000,477000,1992,239.4578313253012
"215 WEST 90TH   STREET, 8-A",2011-09-13,2250000,2017-12-27,2800000,550000,2297,239.442751414889
"845 UNITED NATIONS PLAZA, 20E",2004-06-23,1750000,2015-05-07,2700000,950000,3970,239.29471032745593
"250 MANHATTAN AVENUE, 4C",2013-05-17,728048,2018-08-30,1190000,461952,1931,239.22941481097877
"146 WEST 57TH STREET, 43F",2012-08-31,895000,2017-01-27,1280000,385000,1610,239.1304347826087
"100 CENTRAL PARK SOUTH, 3A",2014-02-28,2851100,2015-11-13,3000000,148900,623,239.0048154093098
"220 3 AVENUE, 3A",2012-01-11,840056,2015-09-11,1160000,319944,1339,238.94249439880508
"300 RECTOR PLACE, 1E",2003-08-27,133000,2006-10-30,410000,277000,1160,238.79310344827587
"2 COLUMBUS AVENUE, 14D",2003-08-26,660000,2007-02-13,962500,302500,1267,238.7529597474349
"200 CHAMBERS STREET, 15A",2007-07-13,2881647,2012-04-30,3300000,418353,1753,238.6497432972048
"530 EAST 76TH   STREET, 10D",2012-03-30,765000,2016-08-30,1150000,385000,1614,238.53779429987608
"15 BROAD STREET, 3320",2006-09-20,1832850,2010-06-23,2160000,327150,1372,238.4475218658892
"220 RIVERSIDE BOULEVARD, 20A",2010-09-08,920000,2015-11-30,1375000,455000,1909,238.34468308014667
"401 EAST 60TH STREET, 12A",2004-07-30,900000,2007-05-03,1140000,240000,1007,238.33167825223435
"2000 BROADWAY, 25D",2011-06-30,1600000,2017-10-24,2150000,550000,2308,238.30155979202772
"250 SOUTH END AVENUE, 15B",2009-07-03,875000,2015-10-29,1425000,550000,2309,238.19835426591598
"62 WEST 62ND STREET, 17A",2004-10-27,1400000,2018-04-30,2575000,1175000,4933,238.19176971416988
"200 RIVERSIDE BOULEVARD, 27D",2007-02-23,1470000,2014-12-18,2150000,680000,2855,238.1786339754816
"326-36 EAST 49 STREET, 1A",2003-03-17,280000,2003-07-21,310000,30000,126,238.0952380952381
"107 GREENE STREET, 3A",2006-04-03,3600000,2010-04-12,3950000,350000,1470,238.0952380952381
"230 RIVERSIDE DRIVE, 15C",2008-06-30,179000,2011-07-06,441090,262090,1101,238.047229791099
"77 PARK AVENUE, 2E",2003-09-15,1145000,2017-04-12,2325000,1180000,4958,237.99919322307383
"25 WEST HOUSTON STREET, 2C",2005-05-04,1695000,2016-04-29,2650000,955000,4013,237.97657612758536
"101 WARREN STREET, 3160",2009-02-17,3645335,2018-05-23,4450000,804665,3382,237.92578356002366
"120 EAST 87TH   STREET, R6-C",2013-05-09,750000,2016-08-19,1035000,285000,1198,237.8964941569282
"333 WEST 56 STREET, 9A",2003-05-01,690000,2006-04-28,950000,260000,1093,237.87740164684354
"108 WEST 138 STREET, 2B",2013-07-11,380000,2016-03-25,615000,235000,988,237.85425101214574
"525 EAST 80TH STREET, 4F",2006-09-22,2708000,2013-07-17,3300000,592000,2490,237.75100401606426
"2101 BROADWAY, 41154",2003-09-30,425000,2007-04-26,735000,310000,1304,237.73006134969324
"300 EAST 62ND   STREET, PH-1",2007-12-17,2765000,2013-04-04,3225000,460000,1935,237.72609819121448
"280 PARK AVENUE SOUTH, 16M",2004-10-26,825000,2008-04-10,1125000,300000,1262,237.71790808240888
"18 WEST 48TH STREET, 11C",2010-05-28,950000,2015-07-13,1395000,445000,1872,237.7136752136752
"502 PARK AVENUE, 9J",2004-10-14,1346126,2017-10-16,2475000,1128874,4750,237.65768421052633
"30 EAST 37TH   STREET, 10B",2007-02-01,541709,2013-04-16,1080000,538291,2266,237.5511915269197
"475 GREENWICH STREET, 3B",2008-06-27,2235058,2011-07-18,2500000,264942,1116,237.40322580645162
"505 GREENWICH STREET, 14C",2005-01-31,1201535,2010-11-01,1700000,498465,2100,237.36428571428573
"393 WEST 49TH   STREET, 3F",2003-11-05,405600,2007-06-22,720000,314400,1325,237.28301886792454
"123 WEST 131 STREET, 6",2011-12-29,509532,2013-08-12,650000,140468,592,237.27702702702703
"392 CENTRAL PARK WEST, 17W",2005-03-21,636406,2007-05-25,825000,188594,795,237.2251572327044
"845 UNITED NATIONS PLAZA, 19D",2007-07-02,2400000,2014-09-18,3025000,625000,2635,237.19165085388994
"420 WEST 25TH   STREET, 2C",2008-12-22,1050000,2013-12-30,1485000,435000,1834,237.18647764449292
"300 ALBANY STREET, 5I",2007-03-06,608625,2010-05-27,888000,279375,1178,237.160441426146
"173 GRAND STREET, 4A",2004-02-04,435000,2008-03-11,790000,355000,1497,237.14094856379427
"166 EAST 63RD   STREET, 6J",2008-06-23,1200000,2013-06-11,1630000,430000,1814,237.045203969129
"100 WEST 18TH STREET, 6F",2008-07-08,1578287,2014-07-18,2100000,521713,2201,237.03452975920035
"15 BROAD STREET, 1930",2006-09-18,585493,2013-08-23,1185000,599507,2531,236.86566574476493
"230 RIVERSIDE DRIVE, 14B",2008-06-30,272000,2014-11-21,825000,553000,2335,236.830835117773
"230 RIVERSIDE DRIVE, 1E",2008-06-30,252000,2010-09-02,440000,188000,794,236.7758186397985
"18 PINE STREET, 1813",2011-01-26,1523302,2013-11-13,1765000,241698,1022,236.49510763209392
"21 ASTOR PLACE, 10A",2004-04-06,1318634,2012-09-25,2050000,731366,3094,236.3820297349709
"31 MONROE STREET, 12C",2013-03-28,550000,2016-04-01,810000,260000,1100,236.36363636363637
"225 EAST 34TH STREET, 10J",2007-11-02,906242,2008-04-14,945000,38758,164,236.32926829268294
"583 BROADWAY, 6M",2005-06-15,7500000,2012-12-27,8150000,650000,2752,236.1918604651163
"40 WEST 55TH STREET, 7A",2008-01-09,1500000,2014-06-27,2057500,557500,2361,236.12875900042354
"43 EAST 25 STREET, 8B",2003-03-03,465000,2006-10-06,775000,310000,1313,236.1005331302361
"630 1 AVENUE, 33L",2003-02-06,850000,2013-07-15,1750000,900000,3812,236.09653725078698
"126 WEST 22ND STREET, 11N",2005-01-12,2200000,2018-06-27,3360000,1160000,4914,236.06023606023606
"11 EAST 29TH   STREET, 46C",2009-02-27,1323725,2015-02-24,1840000,516275,2188,235.95749542961607
"150 WEST 51 STREET, 12328",2004-01-16,342000,2005-05-09,455000,113000,479,235.90814196242172
"112 WEST 56TH STREET, 32N",2005-01-11,1150000,2011-10-27,1735000,585000,2480,235.88709677419354
"166 EAST 63RD STREET, 8C",2013-11-27,2200000,2016-07-08,2425000,225000,954,235.8490566037736
"134 WEST 93RD STREET, 6E",2010-05-24,900000,2015-08-14,1350000,450000,1908,235.8490566037736
"20 CLINTON STREET, 6D",2010-02-25,930000,2017-05-08,1550000,620000,2629,235.83111449220235
"280 PARK AVENUE SOUTH, 14A",2003-03-06,1070000,2016-08-02,2225000,1155000,4898,235.81053491220908
"551 WEST 21ST   STREET, 16A",2016-09-01,16905700,2017-10-06,17000000,94300,400,235.75
"28 LAIGHT STREET, 1D",2012-04-17,3250000,2018-05-23,3775000,525000,2227,235.74315222272114
"99 JANE STREET, 6K",2005-05-31,1825000,2010-12-07,2300000,475000,2016,235.61507936507937
"240 WEST END AVENUE, 12C",2010-05-11,765000,2015-09-16,1225000,460000,1954,235.4145342886387
"42 EAST 20TH STREET, 7D",2005-01-14,1780000,2014-03-24,2570000,790000,3356,235.39928486293206
"70 BATTERY PLACE, 22A",2010-08-02,850967,2014-11-17,1220000,369033,1568,235.35267857142858
"220 RIVERSIDE BOULEVARD, 14J",2005-06-10,2837500,2017-07-11,3875000,1037500,4414,235.04757589487994
"25 CENTRAL PARK WEST, 2K",2004-03-26,1601000,2010-01-18,2100000,499000,2124,234.93408662900188
"48 ORCHARD STREET, 6-C",2011-03-21,1420458,2017-02-06,1925000,504542,2149,234.77989762680318
"2077 FIFTH AVENUE, 4A",2011-05-27,722957,2016-05-19,1150000,427043,1819,234.76800439802088
"519 WEST 135 STREET, 6B",2003-07-21,365040,2005-01-14,492500,127460,543,234.7329650092081
"350 WEST 50 STREET, 20D",2004-07-12,575000,2006-10-25,771000,196000,835,234.7305389221557
"260 PARK AVENUE SOUTH, 4I",2006-07-07,1577000,2015-10-28,2375000,798000,3400,234.7058823529412
"30 EAST 37TH STREET, 8J",2007-02-01,535599,2015-06-03,1250000,714401,3044,234.69152431011827
"505 GREENWICH STREET, 10C",2004-12-30,855330,2011-05-09,1400000,544670,2321,234.67040068935805
"258 ST NICHOLAS AVENUE, 2B",2008-09-12,933881,2016-11-17,1635000,701119,2988,234.64491298527443
"40 WEST 55TH   STREET, 5B",2008-02-21,1443048,2014-08-01,1995000,551952,2353,234.5737356566086
"247 WEST 46TH   STREET, 603",2009-11-09,1425550,2017-06-09,2075000,649450,2769,234.54315637414228
"80 RIVERSIDE BOULEVARD, 11A",2010-04-21,1234899,2015-06-11,1675000,440101,1877,234.470431539691
"230 RIVERSIDE DRIVE, 11AB",2007-05-07,2438708,2013-11-04,2995000,556292,2373,234.42562157606406
"260 PARK AVENUE SOUTH, 11A",2006-05-04,1705568,2010-06-24,2060000,354432,1512,234.4126984126984
"63 DOWNING STREET, 3B",2004-10-15,1100000,2016-06-20,2100000,1000000,4266,234.4116268166901
"120 RIVERSIDE BOULEVARD, 3D",2009-05-20,999000,2013-08-29,1365000,366000,1562,234.31498079385403
"250 EAST 49TH   STREET, 19A",2011-05-03,794235,2014-03-17,1040000,245765,1049,234.28503336510963
"240 WEST 98TH   STREET, 10G",2010-04-22,1059581,2014-09-11,1435000,375419,1603,234.19775421085464
"50 WEST 15TH STREET, 9B",2008-10-30,1710660,2017-08-04,2460000,749340,3200,234.16875
"753 ST NICHOLAS AVENUE, PHB",2013-11-22,575311,2015-12-30,755000,179689,768,233.97005208333334
"142 HENRY STREET, 2E",2010-06-01,845000,2015-02-26,1250000,405000,1731,233.9688041594454
"247 WEST 46TH   STREET, 1104",2009-09-11,962246,2016-07-08,1545000,582754,2492,233.84991974317816
"200 CHAMBERS STREET, 11E",2008-09-05,1240000,2016-09-13,1925000,685000,2930,233.78839590443687
"127 7 AVENUE, 4C",2009-01-23,1094618,2018-04-06,1880000,785382,3360,233.74464285714285
"846-48 2 AVENUE, 15C",2003-06-19,325000,2004-05-21,403750,78750,337,233.67952522255192
"2 COLUMBUS AVENUE, 37A",2006-04-07,3050000,2012-02-15,3550000,500000,2140,233.6448598130841
"415 MAIN STREET, 8-A",2010-04-14,720000,2014-08-15,1090000,370000,1584,233.58585858585857
"40 BROAD STREET, 10B",2012-05-15,909297,2014-05-27,1082500,173203,742,233.42722371967656
"60 RIVERSIDE BOULEVARD, 1108",2011-06-23,888877,2017-05-09,1390000,501123,2147,233.40614811364694
"50 FRANKLIN STREET, 5A",2010-02-26,743322,2014-10-02,1135000,391678,1679,233.2805241215009
"255 HUDSON STREET, 5G",2006-09-26,1018250,2008-07-29,1175000,156750,672,233.25892857142858
"222 WEST 14TH   STREET, 6L",2014-04-21,580000,2015-06-24,680000,100000,429,233.1002331002331
"450 WEST 17TH   STREET, 1906",2008-12-16,750959,2015-08-13,1317500,566541,2431,233.04853969559852
"225 5 AVENUE, 7T",2007-01-17,748413,2014-04-16,1365000,616587,2646,233.02607709750566
"200 CHAMBERS STREET, 14D",2007-03-30,2464165,2017-01-23,3300000,835835,3587,233.01784220797325
"220 RIVERSIDE BOULEVARD, 25A",2007-09-17,3100000,2011-07-13,3425000,325000,1395,232.97491039426524
"85 WEST BROADWAY, 11W",2010-08-10,1654656,2017-01-06,2200000,545344,2341,232.95343870140965
"225 EAST 34TH   STREET, 21C",2008-07-22,1379728,2013-09-24,1820000,440272,1890,232.94814814814814
"10 BEDFORD STREET, 4",2003-10-27,1500000,2006-06-19,1725000,225000,966,232.91925465838509
"301 EAST 79 STREET, 32 N",2003-04-10,465000,2006-01-13,700000,235000,1009,232.90386521308227
"50 WEST 127TH STREET, 1A",2007-09-21,1456097,2015-11-18,2150000,693903,2980,232.85335570469798
"111 FULTON STREET, PH208",2009-12-21,835000,2015-02-23,1275000,440000,1890,232.8042328042328
"224 WEST 18 STREET, 6B",2003-06-25,789144,2014-06-23,1724000,934856,4016,232.78286852589642
"40 BROAD STREET, 12B",2011-08-02,738231,2013-08-09,910000,171769,738,232.74932249322492
"150 EAST 85 STREET, 5E",2003-07-14,375180,2004-09-15,475000,99820,429,232.68065268065268
"130 BEEKMAN STREET, 3B",2007-02-10,139500,2018-05-31,1100000,960500,4128,232.67926356589146
"2628 BROADWAY, 31A",2007-12-21,3772616,2017-05-31,4575000,802384,3449,232.64250507393447
"555 WEST 23RD STREET, N9F",2009-10-16,1125000,2016-04-07,1675000,550000,2365,232.5581395348837
"130 WATER STREET, 9K",2013-09-25,595000,2017-11-08,945000,350000,1505,232.5581395348837
"505 GREENWICH STREET, 3A",2007-07-19,2230000,2017-03-15,3050000,820000,3527,232.492203005387
"171 EAST 84 STREET, 5G",2003-11-25,665000,2006-06-07,880000,215000,925,232.43243243243242
"200 WEST END AVENUE, 8C",2008-03-27,1607816,2018-06-15,2475000,867184,3732,232.36441586280816
"555 WEST 59TH STREET, 29C",2008-07-03,1914310,2013-08-22,2350000,435690,1876,232.24413646055436
"45 PARK AVENUE, PH04",2008-02-01,1527375,2016-08-10,2250000,722625,3113,232.13138451654353
"225 LAFAYETTE STREET, 7D",2015-03-12,3625000,2017-05-17,3810000,185000,797,232.12045169385195
"36 GRAMERCY PARK EAST, 10T",2011-02-15,319333,2015-08-13,700000,380667,1640,232.1140243902439
"380 RECTOR PLACE, 24G",2003-12-30,880000,2006-03-28,1070000,190000,819,231.990231990232
"40 WEST 116 STREET, A814",2009-04-15,301200,2017-01-23,960000,658800,2840,231.9718309859155
"220 RIVERSIDE BOULEVARD, 11R",2010-10-18,700000,2014-04-30,999000,299000,1290,231.7829457364341
"123 WASHINGTON STREET, 46B",2011-09-20,2053097,2013-08-19,2215000,161903,699,231.620886981402
"123 WASHINGTON STREET, 36D",2013-09-19,1264896,2015-09-02,1430000,165104,713,231.562412342216
"200 CHAMBERS STREET, 22E",2007-06-01,1705568,2012-03-13,2110000,404432,1747,231.50085861476816
"158 WEST 23RD STREET, 5",2007-08-13,1680112,2012-11-16,2125000,444888,1922,231.47138397502601
"170 EAST END AVENUE, 8D",2008-12-22,3767525,2017-08-23,4500000,732475,3166,231.35660138976627
"99 JOHN STREET, 2102",2011-05-10,1075000,2017-04-10,1575000,500000,2162,231.26734505087882
"382 CENTRAL PARK WEST, 16M",2015-08-21,970000,2018-08-28,1225000,255000,1103,231.1876699909338
"269 BROADWAY, 10E",2004-06-29,763687,2007-04-13,999000,235313,1018,231.15225933202356
"58 WEST 58TH STREET, 14C",2005-03-21,1475000,2014-12-30,2300000,825000,3571,231.02772332679922
"1635 LEXINGTON AVENUE, 2D",2013-08-26,741286,2017-04-24,1050000,308714,1337,230.90052356020942
"135 WEST 4TH   STREET, 2E",2007-07-11,2469924,2015-08-04,3150000,680076,2946,230.84725050916498
"1 IRVING PLACE, U22A",2006-04-25,846000,2015-07-22,1625000,779000,3375,230.8148148148148
"40 BROAD STREET, 12E",2011-12-13,960000,2016-07-29,1350000,390000,1690,230.76923076923077
"7 ESSEX STREET, 11",2003-10-20,881000,2012-05-01,1600000,719000,3116,230.74454428754814
"200 CHAMBERS STREET, 5F",2012-11-26,970000,2018-08-08,1450000,480000,2081,230.65833733781835
"120 RIVERSIDE BOULEVARD, 4T",2006-03-27,869992,2010-07-27,1235033,365041,1583,230.60075805432723
"55 EAST 86TH   STREET, 12B",2007-07-09,4300000,2011-08-24,4647500,347500,1507,230.59057730590578
"25 NORTH MOORE STREET, 2C",2003-09-24,1125000,2017-09-06,2300000,1175000,5096,230.5729984301413
"260 PARK AVENUE SOUTH, 8D",2006-05-01,2036500,2011-11-02,2500000,463500,2011,230.4823470909995
"415 EAST 54TH   STREET, 9F",2012-07-16,1062500,2017-04-06,1460000,397500,1725,230.43478260869566
"170 EAST 77TH   STREET, 10F",2012-05-02,1100000,2014-02-12,1250000,150000,651,230.4147465437788
"211 EAST 46TH   STREET, 19C",2009-11-24,489048,2015-06-30,960000,470952,2044,230.40704500978472
"15 ST. MARKS PLACE, 6B",2005-01-25,544763,2006-11-30,700000,155237,674,230.3219584569733
"1991 BROADWAY, 8B",2003-02-14,795000,2017-05-22,1995000,1200000,5211,230.28209556706966
"253 WEST 73 STREET, 10E",2005-12-05,1180000,2006-10-05,1250000,70000,304,230.26315789473685
"15 BROAD STREET, 1524",2007-02-09,712775,2014-09-09,1350000,637225,2769,230.12820512820514
"343 EAST 30 STREET, 4-B",2003-03-20,410000,2005-03-28,580000,170000,739,230.04059539918808
"115 ALLEN STREET, 2",2005-08-31,1349181,2013-09-16,2025000,675819,2938,230.02688904016338
"345 WEST 14TH   STREET, 3E",2013-05-21,1705568,2016-11-21,2000000,294432,1280,230.025
"102 FULTON STREET, 4E",2008-06-06,1385000,2016-05-06,2050000,665000,2891,230.02421307506054
"2131 FREDRICK DOUGLASS BL, 3H",2013-07-26,685000,2015-06-08,841875,156875,682,230.02199413489737
"249 EAST 118 STREET, 6A",2010-10-26,338839,2015-08-27,745000,406161,1766,229.98924122310305
"170 EAST 87 STREET, E6D",2003-03-07,540000,2006-11-14,850000,310000,1348,229.97032640949556
"450 WEST 17TH   STREET, 1205",2008-12-02,921516,2012-03-27,1200000,278484,1211,229.96201486374898
"111 FULTON STREET, 419",2010-01-21,924061,2015-12-18,1420000,495939,2157,229.92072322670376
"549 EAST 11 STREET, C1",2004-05-04,116717,2016-03-24,1115000,998283,4342,229.9131736526946
"225 WEST 60TH   STREET, 17A",2007-03-13,1375000,2015-07-15,2075000,700000,3046,229.80958634274458
"260 PARK AVENUE SOUTH, 12F",2006-04-27,987702,2012-03-30,1485000,497298,2164,229.80499075785582
"505 GREENWICH STREET, 4B",2005-04-12,1395002,2014-04-11,2150000,754998,3286,229.76202069385272
"56 PINE STREET, 6G",2005-10-27,461370,2008-05-14,675000,213630,930,229.70967741935485
"75 WALL STREET, 21P",2012-09-19,1170987,2016-08-22,1500000,329013,1433,229.5973482205164
"88 GREENWICH STREET, 3202",2012-07-25,825000,2013-09-12,920000,95000,414,229.46859903381642
"18 WEST 48TH   STREET, 25B",2007-06-01,1696404,2018-03-13,2600000,903596,3938,229.45556119857795
"77 PARK AVENUE, 5D",2006-03-28,1370000,2008-07-25,1565000,195000,850,229.41176470588235
"49 EAST 21ST STREET, 9D",2005-01-31,1048797,2012-12-07,1706500,657703,2867,229.40460411580048
"49 HESTER STREET, 5B",2005-05-11,257000,2007-06-26,435000,178000,776,229.38144329896906
"1760 2 AVENUE, 14D",2004-10-04,620000,2006-07-31,772500,152500,665,229.3233082706767
"15 BROAD STREET, 1130",2006-12-27,600767,2011-04-12,960000,359233,1567,229.24888321633696
"49 EAST 21ST STREET, 11C",2005-03-28,1338998,2011-05-06,1850000,511002,2230,229.14887892376683
"40 BROAD STREET, 27D",2011-08-12,931698,2014-07-09,1175000,243302,1062,229.09792843691147
"133 WEST 22ND   STREET, 3K",2009-08-28,712775,2016-03-15,1260000,547225,2391,228.86867419489752
"555 WEST 59TH STREET, 24D",2008-05-28,4433460,2016-12-23,5150000,716540,3131,228.85340146917918
"505 GREENWICH STREET, 14A",2005-01-06,2240150,2013-03-18,2925000,684850,2993,228.8172402271968
"150 NASSAU STREET, 10D",2003-03-24,880786,2007-12-11,1275000,394214,1723,228.79512478235637
"425 5 AVENUE, 43B/C",2005-10-28,992793,2014-11-20,1750000,757207,3310,228.76344410876132
"250 EAST 54 STREET, 25E",2003-07-17,296000,2005-01-31,425000,129000,564,228.72340425531914
"119 FULTON STREET, 8",2007-01-26,1603743,2016-08-08,2400000,796257,3482,228.67805858701897
"35 VESTRY STREET, 5",2004-08-19,1680000,2013-04-15,2402525,722525,3161,228.5748180955394
"222 RIVERSIDE DRIVE, 10D",2003-05-28,499000,2006-06-21,755000,256000,1120,228.57142857142858
"301 WEST 57TH   STREET, 10D",2007-12-17,1595000,2016-02-09,2275000,680000,2976,228.49462365591398
"77 PARK AVENUE, 2F",2004-04-13,1075000,2017-03-01,2150000,1075000,4705,228.48034006376196
"100 WEST 18TH STREET, 3C",2008-05-21,2392887,2018-05-11,3225000,832113,3642,228.47693574958814
"15 EAST 26TH STREET, 11D",2008-08-05,1094618,2017-12-13,1875000,780382,3417,228.38220661398887
"404 EAST 76 STREET, 25C",2004-03-11,1035000,2006-04-04,1207000,172000,754,228.11671087533156
"205 WEST 76TH   STREET, 9L",2010-04-27,1413185,2012-09-06,1610000,196815,863,228.05909617612977
"78 RIDGE STREET, 5E",2013-04-17,539672,2018-01-26,937500,397828,1745,227.98166189111748
"130 WEST 19TH   STREET, THF",2007-01-19,1705568,2016-08-05,2500000,794432,3486,227.89213998852554
"125 WEST 22ND STREET, 3C",2008-05-28,1108874,2014-06-27,1615000,506126,2221,227.88203511931562
"22 RENWICK STREET, 3A",2013-12-12,1599454,2017-06-20,1892500,293046,1286,227.87402799377915
"200 EAST 66TH   STREET, E0403",2008-10-27,1081371,2015-01-20,1600000,518629,2276,227.86862917398946
"211 WEST 71 STREET, 7B",2003-04-15,475000,2004-02-25,547000,72000,316,227.84810126582278
"520 WEST 19TH STREET, 4A",2008-09-26,2138325,2016-11-14,2815000,676675,2971,227.7600134634803
"272 WEST 107 STREET, 19B",2008-02-19,2967500,2014-06-25,3495000,527500,2318,227.56686798964625
"220 EAST 65TH STREET, 3C",2008-10-16,1790000,2016-06-20,2428000,638000,2804,227.5320970042796
"230 RIVERSIDE DRIVE, 1N",2008-06-30,241000,2015-07-22,827482,586482,2578,227.49495733126454
"5 EAST 22ND   STREET, 11T",2010-09-01,720000,2013-09-26,975000,255000,1121,227.47546833184657
"1601 3 AVENUE, 31A",2003-02-20,617621,2015-06-01,1637500,1019879,4484,227.4484834968778
"350 WEST 50 STREET, 4II",2003-12-19,265339,2006-06-28,475000,209661,922,227.39804772234274
"330 SPRING STREET, 7B",2008-06-27,3054750,2015-01-20,3600000,545250,2398,227.3769808173478
"7 ESSEX STREET, 4",2003-11-19,860421,2011-08-02,1500000,639579,2813,227.36544614290793
"1400 5 AVENUE, 7B-DU",2005-02-01,790000,2016-08-25,1750000,960000,4223,227.32654511011128
"120 EAST 87TH   STREET, P24-C",2011-10-05,2280000,2012-08-08,2350000,70000,308,227.27272727272728
"80 RIVERSIDE BOULEVARD, 14B",2009-08-07,3614787,2015-06-12,4100000,485213,2135,227.26604215456675
"382 CENTRAL PARK WEST, 11B",2003-09-09,486720,2008-01-25,850000,363280,1599,227.19199499687304
"1601 3 AVENUE, 25C",2003-02-20,284276,2007-11-06,675000,390724,1720,227.16511627906976
"200 EAST 66TH   STREET, C2004",2012-09-14,4515938,2017-05-02,4900000,384062,1691,227.12123004139562
"49 EAST 21ST STREET, 4A",2008-01-24,1740000,2018-06-07,2600000,860000,3787,227.0926855030367
"55 WALL STREET, 724",2011-03-28,490000,2012-07-20,599000,109000,480,227.08333333333334
"340 EAST 64TH   STREET, 5F",2011-07-29,960750,2015-08-31,1300000,339250,1494,227.07496653279784
"300 ALBANY STREET, 3F",2006-05-17,312500,2008-07-07,490000,177500,782,226.98209718670077
"105 WEST 78TH   STREET, 1ST",2012-05-10,1217500,2017-11-16,1675000,457500,2016,226.9345238095238
"170 EAST END AVENUE, 3B",2008-05-14,2026317,2014-01-31,2500000,473683,2088,226.85967432950193
"80 RIVERSIDE BOULEVARD, 5N",2010-08-03,1944857,2015-06-24,2350000,405143,1786,226.8437849944009
"350 WEST 57TH STREET, 12A",2009-09-10,1450000,2011-01-19,1562500,112500,496,226.81451612903226
"66-72 ST NICHOLAS AVENUE, 2C",2014-04-03,510000,2016-07-19,700000,190000,838,226.73031026252983
"325 FIFTH AVENUE, 31F",2007-01-18,1680112,2014-07-15,2300000,619888,2735,226.65009140767825
"50 WEST 15TH STREET, 8B",2008-10-28,1715751,2017-09-11,2450000,734249,3240,226.62006172839506
"48 WEST 138 STREET, 4A",2014-07-07,212940,2015-12-10,331000,118060,521,226.60268714011517
"130 FULTON STREET, 11B",2007-07-16,1680112,2011-07-11,2010000,329888,1456,226.57142857142858
"200 EAST 61ST   STREET, 31A",2009-07-14,999000,2016-10-18,1600000,601000,2653,226.5359969845458
"304 BOWERY, 3",2005-08-11,1180000,2017-01-12,2125000,945000,4172,226.51006711409397
"250 EAST 54 STREET, 24D",2004-11-16,760000,2005-08-30,825000,65000,287,226.4808362369338
"300 RECTOR PLACE, 4Q",2008-05-13,357500,2017-12-12,1150000,792500,3500,226.42857142857142
"300 ALBANY STREET, 6I",2005-03-16,319410,2013-09-27,1025000,705590,3117,226.3683028553096
"25 CENTRAL PARK WEST, 24O",2005-09-01,2138325,2018-05-11,3187500,1049175,4635,226.35922330097088
"456 WEST 167TH STREET, 5D",2014-09-02,504972,2015-10-27,600000,95028,420,226.25714285714287
"215 WEST 90TH   STREET, 12-D",2007-05-22,1812485,2016-12-01,2600000,787515,3481,226.23240448147084
"40 BROAD STREET, 15B",2010-01-12,992793,2013-10-01,1300000,307207,1358,226.220176730486
"200 CHAMBERS STREET, 11B",2007-04-18,1736116,2017-02-22,2550000,813884,3598,226.20455808782657
"190 RIVERSIDE DRIVE, 7D",2006-06-22,3767525,2012-04-24,4250000,482475,2133,226.19549929676512
"18 WEST 48TH STREET, 28A",2007-07-12,1770533,2012-10-05,2203000,432467,1912,226.18566945606693
"39 EAST 29TH STREET, 22B",2011-08-26,1230000,2017-12-11,1750000,520000,2299,226.18529795563288
"2360 AMSTERDAM AVENUE, PH4",2011-03-15,468468,2017-01-11,950000,481532,2129,226.17754814466886
"100 RIVERSIDE BOULEVARD, 18B",2008-06-06,1593561,2014-06-10,2090000,496439,2195,226.16810933940775
"106 CENTRAL PARK SOUTH, 17N",2003-08-21,330000,2006-10-12,589500,259500,1148,226.0452961672474
"18 WEST 48TH STREET, 27B",2007-05-18,2087412,2014-03-11,2650000,562588,2489,226.02973081558858
"30 LITTLE WEST STREET, 10D",2013-10-17,797500,2015-12-07,974000,176500,781,225.99231754161332
"120 RIVERSIDE BOULEVARD, PH3M",2006-04-26,1588470,2016-02-24,2400000,811530,3591,225.98997493734336
"845 UNITED NATIONS PLAZA, 18G",2007-09-27,1280000,2014-08-19,1849000,569000,2518,225.97299444003178
"210 LAFAYETTE STREET, 5G",2006-02-13,1985587,2008-02-11,2150000,164413,728,225.84203296703296
"420 CENTRAL PARK WEST, 3J",2010-10-15,270000,2013-07-25,499000,229000,1014,225.83826429980277
"130 WEST 19TH   STREET, 12A",2007-04-30,2138325,2013-06-21,2645000,506675,2244,225.7909982174688
"39 EAST 29TH   STREET, 6D",2012-04-25,920000,2016-11-29,1299000,379000,1679,225.72960095294818
"330 EAST 38 STREET, 17I",2003-11-24,537500,2006-09-19,770000,232500,1030,225.72815533980582
"101 WEST 79TH STREET, 3C",2010-07-28,1225000,2018-07-19,1882500,657500,2913,225.71232406453828
"80 RIVERSIDE BOULEVARD, 34B",2009-10-22,2902012,2016-06-15,3450000,547988,2428,225.69522240527183
"75 WALL STREET, 24F",2011-03-03,999870,2016-04-29,1425000,425130,1884,225.65286624203821
"18 PINE STREET, 409",2008-12-10,1013158,2015-04-22,1537500,524342,2324,225.62048192771084
"255 EAST 74TH   STREET, 18C",2009-02-26,3904988,2017-08-04,4600000,695012,3081,225.5800064913989
"426 WEST BROADWAY, 5F",2005-07-13,1650000,2015-03-30,2450000,800000,3547,225.54271215111362
"77 HORATIO STREET, 1B",2007-07-18,1750000,2015-10-07,2427000,677000,3003,225.44122544122544
"13 EAST 30TH   STREET, 4",2006-10-16,1221900,2014-09-22,1875000,653100,2898,225.36231884057972
"392 CENTRAL PARK WEST, 18S",2003-09-03,305000,2005-08-31,469000,164000,728,225.27472527472528
"155 WEST 71ST   STREET, 3E",2007-01-17,659000,2008-02-25,750000,91000,404,225.24752475247524
"126 UNIVERSITY PLACE, 2",2005-03-25,2240150,2018-04-18,3315000,1074850,4772,225.2409891031014
"121 WEST 19TH ST, 7F",2006-05-03,1104801,2016-05-16,1930000,825199,3666,225.09519912711403
"311 WEST BROADWAY, 3E",2010-06-17,3750000,2013-07-02,4000000,250000,1111,225.02250225022502
"134 EAST 93RD STREET, 7A",2009-09-22,1300000,2018-03-30,2000000,700000,3111,225.00803600128577
"200 RIVERSIDE BOULEVARD, 10H",2006-08-18,370000,2017-05-03,1250000,880000,3911,225.00639222705192
"502 PARK AVENUE, 15E",2004-10-14,1232082,2013-07-10,1950000,717918,3191,224.9821372610467
"200 RIVERSIDE BOULEVARD, 9D",2004-09-07,1537500,2017-08-14,2600000,1062500,4724,224.91532599491956
"124 WEST 93 STREET, 4E",2003-08-14,440000,2007-10-26,785000,345000,1534,224.90221642764016
"630 FIRST AVENUE, 8E",2014-12-12,970000,2018-03-27,1240000,270000,1201,224.81265611990008
"66 LEONARD STREET, 4E",2005-02-07,2695000,2018-07-26,3800000,1105000,4917,224.73052674394955
"845 UNITED NATIONS PLAZA, 57E",2010-11-08,2200000,2013-10-11,2440000,240000,1068,224.7191011235955
"380 LENOX AVENUE, 12A",2009-08-31,1300000,2014-07-16,1700000,400000,1780,224.7191011235955
"1623 3 AVENUE, 22A",2003-02-20,510705,2009-12-14,1070000,559295,2489,224.70670952189636
"88 LAIGHT STREET, 5",2007-10-22,2698362,2012-09-13,3100000,401638,1788,224.6297539149888
"76 MADISON AVENUE, 3B",2008-10-24,1501918,2017-04-28,2200000,698082,3108,224.6081081081081
"420 WEST 25TH   STREET, 1C",2008-05-13,916425,2016-06-15,1580000,663575,2955,224.5600676818951
"99 JOHN STREET, 416",2010-08-26,829873,2016-05-20,1300000,470127,2094,224.51146131805157
"45 WEST 67TH STREET, 20F",2010-12-14,999000,2016-07-07,1455000,456000,2032,224.40944881889763
"15 WEST 20TH STREET, 5B",2007-07-17,2520168,2018-08-01,3425000,904832,4033,224.35705430200844
"768 5 AVENUE, 602",2008-04-14,2504723,2015-03-31,3075000,570277,2542,224.34185680566483
"211 EAST 51ST STREET, 6F",2011-07-13,997885,2013-12-30,1200000,202115,901,224.322974472808
"2 COLUMBUS AVENUE, 26C",2004-08-31,1625000,2010-10-08,2125000,500000,2229,224.31583669807088
"322 WEST 57TH   STREET, 31P",2012-05-14,750959,2015-03-02,980000,229041,1022,224.11056751467711
"175 EAST BROADWAY, 2C",2006-12-04,1099710,2014-11-14,1750000,650290,2902,224.08339076498967
"133 WEST 22ND STREET, 5F",2010-03-15,1323725,2012-05-10,1500000,176275,787,223.98348157560355
"322 WEST 57TH   STREET, 16V",2011-04-29,625000,2016-04-11,1030000,405000,1809,223.88059701492537
"80 RIVERSIDE BOULEVARD, 3D",2010-03-03,1301648,2012-05-30,1485000,183352,819,223.87301587301587
"393 WEST 49TH STREET, 4C",2012-05-11,617500,2015-05-22,865000,247500,1106,223.77938517179024
"99 JOHN STREET, 404",2011-04-14,662000,2013-06-18,840000,178000,796,223.6180904522613
"210 LAFAYETTE STREET, 2A",2006-02-02,1629200,2018-08-03,2650000,1020800,4565,223.6144578313253
"140 EAST 56TH STREET, 3F",2004-11-12,890000,2013-07-24,1600000,710000,3176,223.55163727959697
"11 EAST 36TH   STREET, 702",2008-04-04,443468,2014-02-04,920000,476532,2132,223.5140712945591
"1965 BROADWAY, 18G",2004-09-13,980000,2008-11-14,1320000,340000,1523,223.24359816152332
"186 WEST 80 STREET, 8D",2004-01-30,300000,2005-04-13,398000,98000,439,223.2346241457859
"255 HUDSON STREET, TH3",2007-08-09,2764548,2012-12-12,3200000,435452,1952,223.07991803278688
"422 WEST 20TH STREET, 5C",2012-12-07,799326,2017-08-10,1180000,380674,1707,223.00761570005858
"148 WAVERLY PLACE, F",2004-12-22,962000,2012-10-22,1600000,638000,2861,222.99895141558895
"254 PARK AVENUE SOUTH, 10HJ",2010-12-06,1210950,2017-12-01,1780000,569050,2552,222.9819749216301
"25 MURRAY STREET, 8E",2008-09-10,1318633,2015-10-09,1895000,576367,2585,222.96595744680852
"50 FRANKLIN STREET, 7E",2011-03-23,855000,2015-02-03,1170000,315000,1413,222.9299363057325
"255 EAST 49TH STREET, 31F",2004-07-23,410000,2008-01-23,695000,285000,1279,222.83033620015638
"555 WEST 23RD STREET, N3P",2011-06-16,835000,2017-08-30,1340000,505000,2267,222.7613586237318
"2250 BROADWAY, 9D",2005-06-16,1100000,2015-12-23,1955750,855750,3842,222.73555439875065
"350 WEST 50 STREET, 15G",2003-12-16,451230,2006-11-22,690000,238770,1072,222.7332089552239
"502 PARK AVENUE, 6F",2004-01-30,814600,2014-05-08,1650000,835400,3751,222.71394294854704
"300 EAST 55TH STREET, 2B",2008-01-07,990000,2014-06-05,1511250,521250,2341,222.6612558735583
"45 EAST 25TH   STREET, 30C",2011-07-14,1400000,2017-12-29,1925000,525000,2360,222.45762711864407
"400 CENTRAL PARK WEST, 8D",2003-10-16,764706,2015-08-13,1725000,960294,4319,222.34174577448482
"106 CENTRAL PARK SOUTH, 7O",2012-05-31,580000,2017-01-12,955000,375000,1687,222.28808535862478
"211 WEST 71ST   STREET, 10C",2011-11-08,775000,2013-01-31,875000,100000,450,222.22222222222223
"200 EAST 89 STREET, 20B",2003-10-10,460000,2004-08-20,530000,70000,315,222.22222222222223
"211 EAST 46TH   STREET, 17C",2008-05-15,494902,2010-01-13,630000,135098,608,222.20065789473685
"52 THOMAS STREET, 5C",2008-04-10,1832850,2017-02-10,2550000,717150,3228,222.1654275092937
"347 WEST 57TH STREET, 3F",2012-07-10,700000,2016-03-17,999000,299000,1346,222.13967310549776
"3 WOOSTER STREET, 3A",2005-10-14,2438708,2011-06-22,2900000,461292,2077,222.0953298025999
"25 5 AVENUE, 9E",2007-12-19,1201535,2014-02-06,1699000,497465,2241,221.98348951360998
"350 WEST 50 STREET, 4S",2003-09-29,234916,2006-06-12,454000,219084,987,221.9696048632219
"1031 6 AVENUE, 42J",2006-09-14,636406,2007-06-05,695000,58594,264,221.9469696969697
"571 ACADEMY STREET, 5H",2003-11-24,118500,2005-03-18,225000,106500,480,221.875
"39 EAST 29TH STREET, 15C",2011-10-05,1075000,2018-05-08,1608888,533888,2407,221.80639800581636
"425 5 AVENUE, 19E",2004-06-03,575311,2008-06-06,900000,324689,1464,221.7821038251366
"325 FIFTH AVENUE, 44D",2008-03-11,2450000,2014-05-14,2950000,500000,2255,221.72949002217294
"260 WEST BROADWAY, 5-6E",2007-06-21,1550000,2016-02-12,2250000,700000,3158,221.65927802406586
"327 CENTRAL PARK WEST, 3B",2003-02-26,675000,2005-03-25,843000,168000,758,221.6358839050132
"250 EAST 54 STREET, 7E",2004-03-01,295000,2005-09-16,420000,125000,564,221.63120567375887
"106 CENTRAL PARK SOUTH, 23F",2004-09-30,875000,2014-07-29,1670000,795000,3589,221.51016996377822
"450 WEST 17TH   STREET, 1710",2008-11-04,977520,2009-06-29,1030000,52480,237,221.43459915611814
"70 BATTERY PLACE, 6B",2009-01-12,1338998,2013-11-13,1730000,391002,1766,221.40543601359005
"250 EAST 53RD STREET, 702",2008-07-08,1513605,2012-05-15,1825000,311395,1407,221.318407960199
"406 WEST 45TH STREET, 2C",2012-05-02,1295000,2017-12-18,1750000,455000,2056,221.30350194552528
"100 RIVERSIDE BOULEVARD, 17D",2008-05-27,1832850,2015-11-12,2435888,603038,2725,221.2983486238532
"300 EAST 77 STREET, 4C",2003-09-29,2250333,2009-12-04,2750000,499667,2258,221.28742249778566
"45 PARK AVENUE, 1702",2008-01-10,3818437,2016-06-16,4500000,681563,3080,221.28668831168832
"101 WARREN STREET, 740",2008-07-03,1247356,2014-05-09,1720000,472644,2136,221.27528089887642
"250 EAST 65TH   STREET, 10C",2009-12-01,997885,2011-01-10,1087500,89615,405,221.2716049382716
"1619 THIRD AVENUE, 18A",2004-12-21,700046,2009-12-03,1100000,399954,1808,221.21349557522123
"322 WEST 57TH STREET, 28B",2008-04-22,1130257,2015-11-04,1739000,608743,2752,221.20021802325581
"80 RIVERSIDE BOULEVARD, 7A",2009-09-11,1120075,2013-02-28,1400000,279925,1266,221.10979462875198
"721 5 AVENUE, 42C",2005-01-27,1070000,2016-08-04,2000000,930000,4207,221.06013786546234
"333 RECTOR PLACE, 912",2012-01-23,680000,2016-02-24,1010000,330000,1493,221.03148024112525
"2250 BROADWAY, 3E",2004-11-02,620000,2007-07-03,835000,215000,973,220.9660842754368
"205 EAST 59TH STREET, 10A",2011-06-29,1392500,2015-12-03,1750000,357500,1618,220.95179233621755
"450 WEST 17TH   STREET, 1109",2008-09-26,733140,2014-07-10,1200000,466860,2113,220.9465215333649
"101 WEST 79TH   STREET, 14B",2007-03-26,1900000,2012-10-22,2350000,450000,2037,220.91310751104567
"425 5 AVENUE, 45D",2006-02-02,1099710,2008-04-15,1277000,177290,803,220.78455790784557
"333 RECTOR PLACE, 1005",2013-02-11,2573268,2018-05-29,3000000,426732,1933,220.76151060527678
"150 EAST 85 STREET, 8F",2004-04-26,438555,2006-07-27,620000,181445,822,220.7360097323601
"140 WEST 22ND   STREET, 6A",2010-06-16,1221900,2017-02-17,1760000,538100,2438,220.71369975389663
"446 WEST 47TH STREET, 2A",2006-08-03,235000,2008-07-31,395655,160655,728,220.67994505494505
"251 WEST 19TH   STREET, 3D",2007-08-31,2263000,2017-02-13,3025000,762000,3454,220.61378112333526
"60 EAST 55TH   STREET, 27A",2011-06-02,1900000,2017-12-07,2425000,525000,2380,220.58823529411765
"130 BARROW STREET, PH14",2007-05-15,1460000,2011-08-04,1800000,340000,1542,220.4928664072633
"555 WEST 59TH   STREET, 10D",2013-01-04,963000,2016-12-12,1280000,317000,1438,220.4450625869263
"1437 3 AVENUE, 10B",2004-03-23,275000,2013-07-17,1025000,750000,3403,220.39377020276225
"7 ESSEX STREET, 14",2003-12-17,1096655,2013-10-02,1885000,788345,3577,220.39278725188706
"111 FULTON STREET, 811",2010-02-09,1225000,2013-07-11,1500000,275000,1248,220.35256410256412
"101 WARREN STREET, 5D",2008-08-04,2896921,2010-09-15,3067000,170079,772,220.30958549222797
"400 CENTRAL PARK WEST, 4V",2003-12-22,402558,2006-11-02,633000,230442,1046,220.3078393881453
"100 RIVERSIDE BOULEVARD, 19B",2008-07-15,1593561,2014-03-18,2050000,456439,2072,220.28909266409266
"111 FULTON STREET, 324",2009-09-30,1084436,2017-06-30,1707500,623064,2830,220.16395759717315
"101 WEST 24TH   STREET, 37C",2008-10-15,3258400,2012-02-08,3525000,266600,1211,220.14863748967795
"1619 3 AVENUE, 13A",2003-02-20,513198,2018-08-01,1755000,1241802,5641,220.1386279028541
"260 WEST BROADWAY, 4A",2006-05-11,1600000,2017-06-28,2495000,895000,4066,220.11805213969504
"401 EAST 60TH STREET, 29B",2004-10-15,1750000,2007-04-12,1950000,200000,909,220.02200220022002
"29 KING STREET, 4D",2006-02-01,1180000,2014-06-06,1850000,670000,3047,219.88841483426322
"330 EAST 38TH STREET, 54E",2004-08-10,1395000,2009-08-26,1800000,405000,1842,219.86970684039088
"15 WEST 53RD STREET, 30D",2008-07-09,3175000,2015-01-22,3700000,525000,2388,219.84924623115577
"350 WEST 42ND   STREET, 5G",2007-06-19,840056,2014-06-09,1400000,559944,2547,219.84452296819788
"1760 SECOND AVENUE, 9A",2013-04-19,675000,2015-08-04,859000,184000,837,219.8327359617682
"455 EAST 86TH STREET, 15E",2006-08-25,680000,2007-07-05,749000,69000,314,219.74522292993632
"350 WEST 50TH STREET, 25B",2008-03-06,1099000,2016-06-28,1766000,667000,3036,219.6969696969697
"140 EAST 63RD   STREET, 16A",2010-08-26,5400000,2016-11-18,5900000,500000,2276,219.6836555360281
"205 EAST 85TH   STREET, 15G",2009-08-11,2152335,2014-11-17,2575000,422665,1924,219.68035343035342
"310 EAST HOUSTON STREET, 3C",2008-02-29,567000,2014-05-29,1068000,501000,2281,219.64050854888208
"99 JOHN STREET, 2208",2009-08-07,965000,2014-09-17,1375000,410000,1867,219.6036422067488
"20 PINE STREET, 1915",2013-01-29,630000,2016-03-21,881800,251800,1147,219.52920662598083
"320 ALBANY STREET, 5G",2003-02-10,300000,2005-12-01,525000,225000,1025,219.5121951219512
"303 EAST 33RD STREET, 2D",2012-05-16,1450000,2017-12-26,1900000,450000,2050,219.5121951219512
"60 EAST 55TH STREET, 31B",2005-12-09,2132617,2014-04-07,2800000,667383,3041,219.46169023347582
"425 FIFTH AVENUE, 46B",2008-02-29,825000,2009-05-07,920000,95000,433,219.39953810623555
"240 EAST HOUSTON STREET, 4E",2009-08-13,790000,2013-06-26,1100000,310000,1413,219.39136588818118
"40 WEST 116 STREET, B209",2008-10-30,722880,2017-09-19,1435000,712120,3246,219.3838570548367
"425 FIFTH AVENUE, 31E",2005-11-09,940300,2007-08-08,1080000,139700,637,219.30926216640503
"502 PARK AVENUE, 12C",2005-04-14,1221900,2016-03-31,2100000,878100,4004,219.30569430569432
"510 EAST 80TH   STREET, 10D",2010-08-11,1150000,2017-03-01,1675000,525000,2394,219.2982456140351
"301 WEST 118TH STREET, 8M",2016-08-29,1110000,2018-03-22,1235000,125000,570,219.2982456140351
"381 LENOX AVENUE, 5-B",2009-11-03,700000,2017-01-30,1280000,580000,2645,219.28166351606805
"460 EAST 79TH   STREET, 17E",2012-05-11,1614600,2017-06-26,2025000,410400,1872,219.23076923076923
"101 WARREN STREET, 7H",2008-05-12,2443800,2012-07-24,2780000,336200,1534,219.16558018252934
"263 9 AVENUE, PHE",2006-04-07,1883762,2009-08-04,2150000,266238,1215,219.1259259259259
"116 HUDSON STREET, 5",2005-10-19,2825000,2016-09-27,3700000,875000,3996,218.96896896896897
"1623 3 AVENUE, 6D",2003-02-20,237783,2007-06-25,585000,347217,1586,218.9262295081967
"70 BATTERY PLACE, 3C",2011-03-10,815000,2014-10-02,1100000,285000,1302,218.89400921658986
"31 EAST 28TH   STREET, 10W",2007-08-09,2049228,2016-09-06,2775000,725772,3316,218.86972255729796
"350 WEST 50 STREET, 32A",2003-03-04,261000,2005-10-14,470000,209000,955,218.84816753926702
"27 WEST 72ND   STREET, 505",2007-03-23,2642358,2013-07-29,3150000,507642,2320,218.81120689655174
"100 WEST 58TH STREET, 8G",2010-03-22,972428,2016-07-05,1475000,502572,2297,218.79494993469743
"225 EAST 34TH   STREET, 5E",2008-04-01,1410276,2016-04-26,2055000,644724,2947,218.77298948082796
"100 UNITED NATIONS PLAZA, 6G",2003-09-16,448526,2013-08-12,1240000,791474,3618,218.7600884466556
"146 WEST 57TH   STREET, 43A",2010-07-07,2100000,2015-10-09,2520000,420000,1920,218.75
"1 YORK STREET, 6D",2008-08-14,1964204,2018-06-19,2750000,785796,3596,218.51946607341492
"701 MADISON AVENUE, 7C",2004-07-15,735000,2014-02-14,1500000,765000,3501,218.5089974293059
"233 EAST 17TH STREET, PH2",2007-06-18,2112868,2018-07-30,3000000,887132,4060,218.50541871921183
"455 MAIN STREET, 12E",2006-06-27,814854,2011-04-25,1200000,385146,1763,218.46057855927396
"15 UNION SQUARE WEST, 25",2010-08-09,488000,2016-05-24,950000,462000,2115,218.43971631205673
"258 ST NICHOLAS AVENUE, 3B",2008-06-06,949919,2016-10-07,1615000,665081,3045,218.4174055829228
"166 EAST 63RD   STREET, 10G",2009-07-22,1580000,2017-12-15,2250000,670000,3068,218.38331160365058
"111 CENTRAL PARK NORTH, 4C",2007-10-15,1579305,2016-07-08,2275000,695695,3189,218.15459391658828
"382 CENTRAL PARK WEST, 12R",2003-10-22,720000,2015-09-25,1670000,950000,4356,218.08999081726355
"325 WEST 13TH STREET, 2",2010-02-24,1400093,2016-09-28,1925000,524907,2408,217.98463455149502
"32 WEST 128TH STREET, 4",2014-02-10,889000,2017-10-30,1185000,296000,1358,217.96759941089837
"101 WEST 24TH STREET, 7A",2008-09-04,972428,2013-09-25,1375000,402572,1847,217.95993502977802
"80 JOHN STREET, 6C",2008-07-09,1312015,2016-07-15,1950000,637985,2928,217.89105191256832
"145 EAST 48 STREET, 8F",2003-09-09,415000,2004-03-29,459000,44000,202,217.82178217821783
"130 FULTON STREET, 5A",2006-07-13,1420000,2017-08-04,2300000,880000,4040,217.82178217821783
"146 WEST 57TH   STREET, 55A",2007-05-15,2400000,2013-07-03,2888000,488000,2241,217.7599286033021
"252 7 AVENUE, 4H",2007-07-11,1995000,2017-06-30,2788000,793000,3642,217.73750686436023
"160 WOOSTER STREET, 5B",2005-02-22,1578287,2011-09-16,2100000,521713,2397,217.65248226950354
"510 EAST 80 STREET, 4F",2003-12-29,925000,2013-09-30,1700000,775000,3563,217.5133314622509
"115 ALLEN STREET, 4",2005-08-26,1410276,2015-05-28,2185000,774724,3562,217.4969118472768
"140 EAST 63RD STREET, 12D",2007-07-18,2764548,2013-12-20,3275000,510452,2347,217.49126544524924
"41 WEST 72ND STREET, 11E",2005-09-19,505986,2010-05-14,875000,369014,1698,217.32273262661954
"100 RIVERSIDE BOULEVARD, 10F",2008-05-05,2196874,2015-02-03,2732500,535626,2465,217.2924949290061
"18 PINE STREET, 912",2009-10-29,347500,2016-08-08,885000,537500,2475,217.17171717171718
"1601 3 AVENUE, 30B",2003-02-20,172483,2006-08-21,450000,277517,1278,217.14945226917058
"100 RIVERSIDE BOULEVARD, 9N",2008-03-31,1925001,2015-07-01,2500000,574999,2648,217.14463746223564
"2257 ADAM C POWELL BLVD, 4B",2012-09-13,595676,2014-05-02,725000,129324,596,216.98657718120805
"780 WEST END AVENUE, 5D",2010-09-15,825000,2017-05-01,1350000,525000,2420,216.94214876033058
"11 EAST 29TH   STREET, 34B",2008-06-09,1476462,2013-08-29,1890000,413538,1907,216.85264813843733
"11 EAST 29TH   STREET, 9A",2008-01-29,1659747,2013-09-13,2105000,445253,2054,216.77361246348588
"305 EAST 51ST   STREET, RU7D",2015-07-22,2596537,2017-06-29,2750000,153463,708,216.75564971751413
"250 WEST 90TH STREET, PH1G",2005-01-26,1237500,2014-08-22,1995000,757500,3495,216.73819742489272
"515 EAST 72ND   STREET, 37A",2012-07-02,2030000,2017-03-17,2402500,372500,1719,216.695753344968
"220 EAST 65TH   STREET, 11K",2011-01-05,1050000,2014-03-27,1305000,255000,1177,216.65250637213254
"166 EAST 63 STREET, 5D",2003-04-01,495000,2005-08-25,685000,190000,877,216.64766248574688
"524 EAST 72 STREET, 37C",2003-02-14,855000,2004-11-22,995000,140000,647,216.38330757341578
"660 RIVERSIDE DRIVE, 6D",2013-07-17,255000,2015-04-02,390000,135000,624,216.34615384615384
"15 BROAD STREET, 1912",2006-06-29,1374637,2018-03-16,2300000,925363,4278,216.307386629266
"130 WEST 19TH STREET, 4D",2006-08-22,1424531,2015-10-30,2150000,725469,3356,216.1707389749702
"1 IRVING PLACE, G19D",2007-04-03,932500,2014-05-19,1495000,562500,2603,216.09681137149443
"350 WEST 50TH   STREET, 21D",2011-10-25,621156,2013-07-24,759000,137844,638,216.0564263322884
"111 FULTON STREET, PH209",2010-04-08,721000,2016-12-21,1250000,529000,2449,216.00653327888935
"200 EAST 89 STREET, 6D",2003-07-17,357500,2006-04-19,575000,217500,1007,215.9880834160874
"199 BOWERY, 3A",2012-12-27,1005521,2018-03-30,1420000,414479,1919,215.98697238144868
"101 WARREN STREET, 950",2008-07-31,1654656,2018-01-11,2400000,745344,3451,215.9791364821791
"1 IRVING PLACE, G28C",2009-04-06,850000,2014-01-30,1230000,380000,1760,215.9090909090909
"372 CENTRAL PARK WEST, 5W",2013-01-10,867000,2018-03-15,1275000,408000,1890,215.87301587301587
"120 RIVERSIDE BOULEVARD, 3H",2010-08-18,839000,2015-11-04,1250000,411000,1904,215.8613445378151
"10 WEST END AVENUE, 17D",2007-08-10,1461188,2016-05-05,2150000,688812,3191,215.8608586649953
"90 WILLIAM STREET, 6G",2009-11-02,815000,2014-08-29,1195000,380000,1761,215.78648495173198
"472 WEST 144 STREET, U",2004-04-26,462500,2008-07-15,795000,332500,1541,215.76898118105126
"1630 MADISON AVENUE, 2B",2003-07-09,175422,2004-08-04,260000,84578,392,215.76020408163265
"250 EAST 53RD STREET, 1502",2008-01-30,1712489,2013-08-19,2150000,437511,2028,215.7352071005917
"150 WEST 12TH   STREET, 9 EAS",2016-03-10,6718423,2017-11-10,6850000,131577,610,215.7
"280 PARK AVENUE SOUTH, 12A",2004-04-02,1062500,2011-01-05,1595000,532500,2469,215.67436208991495
"1890 ADAM C POWELL BLVD, 6C",2014-05-09,819691,2017-12-22,1105000,285309,1323,215.6530612244898
"344 BOWERY, 5",2007-12-10,2392887,2013-06-28,2830000,437113,2027,215.64528860384806
"455 EAST 86TH STREET, 21A",2012-08-16,1525000,2015-03-02,1725000,200000,928,215.51724137931035
"22 GRAMERCY PARK SOUTH, 3",2011-02-01,9164250,2012-03-05,9250000,85750,398,215.45226130653268
"44 EAST 12TH STREET, 6D",2009-09-19,765000,2014-04-17,1125000,360000,1671,215.43985637342908
"301 EAST 79TH   STREET, 18 J",2013-07-09,1227000,2017-08-17,1550000,323000,1500,215.33333333333334
"215 AVENUE B, 1005",2010-08-13,690000,2014-07-18,999000,309000,1435,215.33101045296166
"2 COLUMBUS AVENUE, 11C",2004-05-21,1275000,2016-09-20,2245000,970000,4505,215.3163152053274
"430 WEST 154 STREET, 4",2009-06-02,442000,2014-03-24,820000,378000,1756,215.2619589977221
"133 WEST 22ND   STREET, 6L",2008-12-18,824782,2015-04-30,1325000,500218,2324,215.24010327022376
"2628 BROADWAY, 8B",2007-10-18,2031408,2016-12-08,2750000,718592,3339,215.21174004192872
"505 GREENWICH STREET, 12F",2005-04-01,982611,2008-09-18,1255000,272389,1266,215.15718799368088
"330 EAST 38 STREET, 19O",2003-06-09,325000,2005-01-10,450000,125000,581,215.14629948364887
"164 BANK STREET, 7B",2004-12-09,750000,2014-06-26,1500000,750000,3486,215.14629948364887
"45 PARK AVENUE, 1104",2008-02-01,1165641,2014-11-20,1700000,534359,2484,215.12037037037038
"72 EAST 3RD   STREET, 1A",2005-01-12,845000,2015-12-01,1700000,855000,3975,215.0943396226415
"450 WEST 17TH   STREET, 1223",2008-12-04,789143,2012-07-25,1075000,285857,1329,215.09179834462
"15 BROAD STREET, 2502",2006-06-26,789143,2008-09-30,967000,177857,827,215.0628778718259
"62 BEACH STREET, 2F",2007-02-22,2450000,2017-05-02,3250000,800000,3722,214.93820526598603
"300 WEST 53RD   STREET, 2D",2007-03-07,465000,2010-07-22,730000,265000,1233,214.92295214922953
"121 EAST 23RD   STREET, 20B",2009-12-03,1200000,2016-12-06,1750000,550000,2560,214.84375
"127 7 AVENUE, 4B",2009-08-26,799326,2018-04-06,1475000,675674,3145,214.84069952305245
"2 COLUMBUS AVENUE, 12A",2006-02-28,1975000,2016-07-20,2790000,815000,3795,214.7562582345191
"100 RIVERSIDE BOULEVARD, 31E",2008-11-12,1556192,2013-11-20,1950000,393808,1834,214.72628135223556
"203 WEST 81ST   STREET, 8A",2012-05-22,1929000,2017-02-13,2300000,371000,1728,214.69907407407408
"534 WEST 42ND   STREET, 3",2012-11-07,738231,2016-12-15,1060000,321769,1499,214.65577051367578
"1400 5 AVENUE, TH-B2",2006-08-23,1408320,2017-07-05,2260000,851680,3969,214.58301839254221
"421 WEST 54TH   STREET, 5D",2008-03-27,2425000,2013-05-06,2825000,400000,1866,214.36227224008576
"1965 BROADWAY, 12D",2006-12-12,1600000,2018-06-07,2499000,899000,4195,214.30274135876044
"215 AVENUE B, 1012",2010-08-04,1200000,2017-08-14,1750000,550000,2567,214.25788858589794
"1601 3 AVENUE, 22K",2003-02-20,437947,2017-12-27,1600000,1162053,5424,214.2428097345133
"39 EAST 29TH STREET, 16C",2012-03-30,1090000,2018-06-11,1575000,485000,2264,214.2226148409894
"505 GREENWICH STREET, 12H",2005-04-05,2265606,2009-07-14,2600000,334394,1561,214.21780909673285
"88 JANE STREET, 4R",2004-07-13,1250000,2013-02-27,1925000,675000,3151,214.21770866391623
"150 WEST 51ST   STREET, 17-3",2012-10-05,449000,2014-09-10,600000,151000,705,214.18439716312056
"220 RIVERSIDE BOULEVARD, 22H",2005-03-15,2050000,2017-01-10,2975000,925000,4319,214.16994674693217
"2 COLUMBUS AVENUE, 8C",2003-07-09,1075000,2018-05-08,2235000,1160000,5417,214.1406682665682
"14 PRINCE STREET, 1D",2003-10-16,249000,2015-04-24,1150000,901000,4208,214.11596958174906
"263 9 AVENUE, 5D",2006-04-24,1425550,2016-06-21,2220000,794450,3711,214.07976286715171
"160 WADSWORTH AVENUE, 608",2003-02-05,130000,2006-09-05,410000,280000,1308,214.06727828746176
"111 CENTRAL PARK NORTH, 8B",2007-09-28,2158518,2014-05-07,2675000,516482,2413,214.04144218814753
"464 WEST 44TH STREET, 2A",2013-08-28,815000,2015-10-08,980000,165000,771,214.00778210116732
"101 WARREN STREET, 1540",2008-09-18,2729215,2014-09-23,3199000,469785,2196,213.9275956284153
"150 WEST 56TH STREET, 3903",2005-03-02,1300000,2013-08-14,1960000,660000,3087,213.79980563654033
"406 WEST 45TH   STREET, 1A",2009-04-29,992793,2017-02-02,1599000,606207,2836,213.75423131170663
"18 WEST 48TH STREET, 32B",2007-06-28,1695591,2013-04-23,2150000,454409,2126,213.73894637817497
"450 EAST 83RD STREET, 17D",2006-08-31,2683292,2010-05-27,2975000,291708,1365,213.7054945054945
"88 GREENWICH STREET, 1112",2009-12-30,760000,2014-12-29,1150000,390000,1825,213.6986301369863
"300 EAST 79TH   STREET, 8C",2009-08-21,1400000,2013-02-28,1675000,275000,1287,213.67521367521368
"25 CENTRAL PARK WEST, 4H",2003-10-07,540000,2006-10-11,775000,235000,1100,213.63636363636363
"57 READE STREET, 14A",2012-08-16,1875000,2017-09-08,2270000,395000,1849,213.62898864250946
"460 EAST 79 STREET, 11G",2003-07-11,460000,2006-06-22,690000,230000,1077,213.55617455896007
"500 WEST 43RD STREET, 12J",2013-06-07,749000,2016-05-06,976000,227000,1064,213.34586466165413
"21 SOUTH END AVENUE, 321",2004-01-09,1599000,2015-08-03,2500000,901000,4224,213.30492424242425
"1 IRVING PLACE, G18B",2008-01-15,950000,2014-03-05,1428000,478000,2241,213.29763498438197
"382 CENTRAL PARK WEST, 5U",2009-02-04,460000,2010-04-02,550000,90000,422,213.27014218009478
"380 RECTOR PLACE, 5R",2004-06-30,290000,2013-07-19,995000,705000,3306,213.2486388384755
"30 EAST 37TH STREET, 3F",2007-02-21,172462,2010-10-08,455000,282538,1325,213.23622641509434
"372 CENTRAL PARK WEST, 15D",2015-07-23,900000,2018-02-15,1100000,200000,938,213.21961620469082
"322 WEST 57TH   STREET, 27H",2010-09-17,999921,2017-08-24,1540000,540079,2533,213.21713383339912
"40 WEST 116 STREET, A313",2009-02-26,642560,2017-07-14,1295000,652440,3060,213.2156862745098
"305 SECOND AVENUE, 728",2014-03-20,1300000,2017-04-19,1540000,240000,1126,213.14387211367674
"188 EAST 76TH STREET, 24B",2005-10-31,2600000,2013-07-17,3200000,600000,2816,213.0681818181818
"330 EAST 38TH STREET, 7P",2011-10-06,835000,2016-02-18,1175000,340000,1596,213.0325814536341
"99 JOHN STREET, 714",2011-10-06,675000,2014-12-23,925000,250000,1174,212.94718909710392
"1601 THIRD AVENUE, 8A",2013-12-12,1500000,2017-09-28,1795000,295000,1386,212.84271284271284
"163 ST. NICHOLAS AVENUE, 1A",2005-07-18,600000,2008-02-08,799000,199000,935,212.8342245989305
"49 EAST 21ST STREET, 2B",2005-03-15,992793,2009-02-26,1300000,307207,1444,212.7472299168975
"45 CHRISTOPHER STREET, 15C",2010-04-12,1287500,2014-12-11,1650000,362500,1704,212.73474178403757
"845 UNITED NATIONS PLAZA, 38E",2005-08-01,1650000,2010-02-03,2000000,350000,1647,212.5075895567699
"380 LENOX AVENUE, 4E",2013-05-23,754370,2018-06-28,1150000,395630,1862,212.47583243823846
"412 GREENWICH STREET, 3F",2015-07-13,5200000,2018-06-06,5425000,225000,1059,212.46458923512748
"322 WEST 57TH STREET, 19C",2007-09-24,901151,2013-07-08,1350000,448849,2114,212.3221381267739
"421 HUDSON STREET, 315",2012-11-20,999000,2018-06-12,1430000,431000,2030,212.3152709359606
"104 WEST 70TH   STREET, 4B",2007-07-30,1470000,2014-07-17,2010000,540000,2544,212.26415094339623
"845 UNITED NATIONS PLAZA, 59E",2004-12-15,1800000,2015-08-07,2625000,825000,3887,212.2459480319012
"42 EAST 20 STREET, 8DPHD",2005-03-22,2850000,2011-07-18,3340000,490000,2309,212.2130792550888
"155 WEST 70TH STREET, 6D",2007-05-01,1435000,2018-06-29,2300000,865000,4077,212.16580819229827
"130 WEST 19TH STREET, 10C",2006-12-07,2211369,2018-08-29,3120000,908631,4283,212.14826056502451
"280 PARK AVENUE SOUTH, 18D",2013-08-02,1079500,2017-05-26,1375000,295500,1393,212.13208901651112
"115 MERCER STREET, 4B",2008-04-01,2851100,2013-01-28,3225000,373900,1763,212.08167895632445
"200 CHAMBERS STREET, 4D",2007-03-21,1501918,2014-06-04,2060000,558082,2632,212.0372340425532
"225 EAST 34TH STREET, 15F",2007-11-19,999921,2015-12-16,1625000,625079,2949,211.96303831807393
"200 WEST END AVENUE, 6E",2007-12-19,1808093,2017-04-18,2530000,721907,3408,211.82717136150234
"255 EAST 49TH STREET, 18F",2011-10-14,510000,2015-01-30,765000,255000,1204,211.7940199335548
"50 FRANKLIN STREET, 8E",2010-03-11,804417,2014-08-06,1145000,340583,1609,211.67371037911747
"1601 3 AVENUE, 3G",2003-02-20,195551,2009-03-06,662500,466949,2206,211.6722574796011
"2 EAST 55 STREET, 835",2006-08-17,467251,2006-11-17,486720,19469,92,211.6195652173913
"250 SOUTH END AVENUE, 6D",2010-05-13,387500,2017-09-15,955000,567500,2682,211.5958240119314
"435 EAST 76 STREET, 3A",2003-06-09,437642,2005-12-09,631000,193358,914,211.55142231947482
"165 HENRY STREET, 201",2015-06-03,590000,2016-04-29,660000,70000,331,211.48036253776436
"530 EAST 76TH STREET, 24K",2009-09-02,940000,2011-09-29,1100000,160000,757,211.36063408190225
"77 PARK AVENUE, 4A",2004-05-28,840000,2007-06-14,1075000,235000,1112,211.33093525179856
"200 EAST 89TH   STREET, 39D",2007-07-30,1575000,2009-04-29,1710000,135000,639,211.26760563380282
"1 IRVING PLACE, P21A",2007-08-16,790000,2015-04-09,1380000,590000,2793,211.24239169351952
"322 WEST 57TH   STREET, 16R",2010-08-02,621132,2016-02-23,1050000,428868,2031,211.16100443131464
"2 COLUMBUS AVENUE, 5D",2004-06-16,1250000,2015-02-27,2075000,825000,3908,211.10542476970318
"250 EAST 30 STREET, 10G",2003-09-19,542727,2005-01-06,643000,100273,475,211.10105263157894
"421 HUDSON STREET, 524",2006-02-10,800000,2016-03-24,1580000,780000,3695,211.09607577807847
"75 WALL STREET, 20K",2010-09-29,814600,2015-09-24,1199000,384400,1821,211.09280615046677
"280 PARK AVENUE SOUTH, 19J",2003-04-29,995000,2012-11-09,1730000,735000,3482,211.08558299827686
"2322 ADAM C POWELL BLVD, 1A",2004-08-27,222371,2008-07-07,520000,297629,1410,211.08439716312057
"260 PARK AVENUE SOUTH, 8H",2006-02-23,1517192,2013-04-26,2070000,552808,2619,211.07598319969455
"117 WEST 123 STREET, 1A",2011-04-28,600000,2018-05-24,1145200,545200,2583,211.0723964382501
"120 GREENWICH STREET, 6A",2013-09-09,610000,2015-04-01,730000,120000,569,210.896309314587
"170 EAST 77TH   STREET, 10D",2007-10-30,1431914,2015-03-17,2000000,568086,2695,210.7925788497217
"715 PARK AVENUE, 9-C",2003-12-26,625000,2010-08-11,1135000,510000,2420,210.74380165289256
"155 EAST 38TH STREET, 21G",2012-10-19,1080000,2017-08-10,1450000,370000,1756,210.70615034168566
"353 WEST 56TH STREET, 8A",2009-06-30,825000,2013-09-20,1150000,325000,1543,210.62864549578742
"135 WEST 70TH STREET, 6H",2005-11-03,895000,2008-10-30,1125000,230000,1092,210.62271062271063
"325 5 AVENUE, 15B",2012-01-27,870000,2016-05-12,1200000,330000,1567,210.59349074664965
"1623 3 AVENUE, 34K",2003-02-20,489409,2015-10-06,1460000,970591,4611,210.49468661895466
"240 WEST END AVENUE, 3B",2010-03-19,635000,2014-03-07,940000,305000,1449,210.48999309868876
"310 EAST 53RD   STREET, 24A",2009-04-22,2562000,2016-12-15,3150000,588000,2794,210.45096635647818
"30 EAST 37TH   STREET, 3H",2007-03-08,87500,2011-07-29,425000,337500,1604,210.41147132169576
"140 EAST 63RD   STREET, 4M",2007-11-20,501930,2018-01-05,1280000,778070,3699,210.34603947012707
"491 GREENWICH STREET, 4B",2004-12-01,1120075,2018-08-24,2174000,1053925,5014,210.19644994016753
"303 EAST 33RD   STREET, 3D",2011-06-23,1191352,2017-06-14,1650000,458648,2183,210.09986257443884
"2250 BROADWAY, 10D",2004-06-15,960000,2015-02-27,1781000,821000,3909,210.02814018930673
"7 ESSEX STREET, 10",2003-12-30,865513,2011-08-15,1450000,584487,2785,209.8696588868941
"88 GREENWICH STREET, 2203",2010-02-17,1170000,2014-08-19,1515000,345000,1644,209.85401459854015
"450 WEST 17TH   STREET, 2303",2009-01-13,1501918,2010-11-02,1640000,138082,658,209.85106382978722
"254 PARK AVENUE SOUTH, 2B",2011-12-22,560037,2017-02-17,955000,394963,1884,209.64065817409767
"100 WEST 18TH STREET, 3E",2008-06-05,1323725,2013-12-06,1745000,421275,2010,209.58955223880596
"650 SIXTH AVENUE, 6K",2008-05-22,1563013,2015-01-30,2075000,511987,2444,209.48731587561375
"545 WEST 48TH   STREET, 607S",2015-10-09,1043706,2016-05-17,1090000,46294,221,209.47511312217193
"39 VESTRY STREET, 5A",2008-03-24,3322826,2015-06-12,3875000,552174,2636,209.4742033383915
"524 EAST 72ND   STREET, 25B",2009-12-11,840000,2015-04-17,1249000,409000,1953,209.42140296979008
"393 WEST 49 STREET, 3FF",2004-04-30,350000,2006-01-06,479000,129000,616,209.41558441558442
"101 WARREN STREET, 11L",2008-08-05,3258400,2013-09-18,3650000,391600,1870,209.41176470588235
"347 WEST 57TH   STREET, 8 BB",2012-08-28,400000,2014-04-17,525000,125000,597,209.38023450586266
"209 EAST 51ST   STREET, 10E",2010-05-11,1476462,2015-11-24,1900000,423538,2023,209.3613445378151
"225 FIFTH AVENUE, 11P",2007-08-09,1069162,2017-08-29,1838000,768838,3673,209.3215355295399
"30 EAST 37TH STREET, 9D",2007-02-21,179550,2010-03-22,415000,235450,1125,209.2888888888889
"88 GREENWICH STREET, 804",2009-10-08,970000,2013-05-14,1245000,275000,1314,209.28462709284628
"200 CHAMBERS STREET, 17G",2007-05-17,1675021,2011-08-17,2000000,324979,1553,209.25885383129426
"240 RIVERSIDE BOULEVARD, 26 C",2006-02-07,2301250,2006-09-28,2350000,48750,233,209.2274678111588
"949 PARK AVENUE, DUP1",2012-01-24,3908043,2015-11-20,4200000,291957,1396,209.13825214899714
"225 5 AVENUE, 6F",2007-02-15,1728479,2014-01-07,2255000,526521,2518,209.10285941223194
"200 CHAMBERS STREET, 17B",2007-04-30,1812485,2015-01-08,2400000,587515,2810,209.08007117437722
"56 PINE STREET, 15F",2013-08-22,620000,2015-03-19,740000,120000,574,209.05923344947735
"425 5 AVENUE, 30D",2004-04-27,931699,2016-09-28,1880000,948301,4537,209.01498787745206
"1255 5 AVENUE, 5F",2012-09-07,495000,2015-06-09,705000,210000,1005,208.955223880597
"249 EAST 118 STREET, 10B",2010-05-26,308129,2014-11-18,650000,341871,1637,208.83995113011608
"260 PARK AVENUE SOUTH, 9I",2006-10-27,1535000,2018-08-16,2435000,900000,4311,208.76826722338205
"108 5 AVENUE, 14A",2007-08-17,1450000,2018-04-02,2260000,810000,3881,208.7090955939191
"82 BEAVER STREET, 505",2010-06-14,999878,2013-11-21,1262000,262122,1256,208.69585987261146
"295 THIRD AVENUE, 4A",2004-09-22,742000,2008-10-07,1050000,308000,1476,208.6720867208672
"250 EAST 53RD STREET, 502",2008-08-18,1493219,2015-09-04,2030000,536781,2573,208.6206762534007
"300 EAST 55TH STREET, 9D",2005-05-11,1787028,2014-09-19,2500000,712972,3418,208.59332943241662
"1623 3 AVENUE, 14B",2003-02-20,153674,2007-02-28,460000,306326,1469,208.52688904016338
"768 5 AVENUE, 1302",2007-08-20,1375889,2014-03-26,1878000,502111,2410,208.3448132780083
"280 PARK AVENUE SOUTH, 21A",2004-08-09,1630000,2016-01-15,2500000,870000,4176,208.33333333333334
"171 EAST 84TH STREET, 29D",2006-06-21,995000,2008-03-06,1125000,130000,624,208.33333333333334
"340 EAST 23RD   STREET, PH1B",2009-06-16,1221900,2011-05-04,1365000,143100,687,208.29694323144105
"1 YORK STREET, 4F",2008-06-26,2596537,2016-07-20,3210000,613463,2946,208.2359131025119
"235 WEST END AVENUE, 14F",2003-12-23,790000,2008-07-30,1140000,350000,1681,208.20939916716242
"230 RIVERSIDE DRIVE, 12O",2008-06-30,261000,2018-03-13,998000,737000,3543,208.0158058142817
"40 BROAD STREET, 18A",2011-05-05,801678,2016-08-01,1200000,398322,1915,208.001044386423
"49 EAST 21ST STREET, 5C",2005-03-02,1495000,2006-10-24,1620000,125000,601,207.98668885191347
"416 WASHINGTON STREET, 5J",2006-01-09,1109892,2011-02-28,1500000,390108,1876,207.94669509594883
"170 JOHN STREET, 3/4A",2005-10-17,840000,2008-03-25,1025000,185000,890,207.86516853932585
"322 WEST 57TH   STREET, 34Q1",2010-07-16,950000,2012-08-24,1110000,160000,770,207.7922077922078
"309 EAST 49TH STREET, 12E",2010-06-01,999000,2017-09-28,1555000,556000,2676,207.7727952167414
"50 EAST 72ND STREET, 3D",2004-09-17,995000,2010-09-16,1450000,455000,2190,207.76255707762556
"301 EAST 79 STREET, 36 M",2003-11-26,465000,2006-09-14,677500,212500,1023,207.72238514173998
"340 EAST 64TH   STREET, 5K",2006-12-15,1275000,2014-01-27,1815000,540000,2600,207.69230769230768
"130 WEST 79TH STREET, 10F",2004-12-20,1100000,2013-11-13,1775000,675000,3250,207.69230769230768
"400 FIFTH AVENUE, 40G",2011-11-09,1143577,2016-03-23,1475000,331423,1596,207.65852130325814
"236 EAST 47TH STREET, 15F",2005-01-10,551000,2006-07-13,665000,114000,549,207.65027322404373
"133 WEST 22ND   STREET, 3E",2009-02-18,1140440,2010-11-04,1270000,129560,624,207.62820512820514
"325 FIFTH AVENUE, 18B",2009-12-17,840000,2014-05-19,1175000,335000,1614,207.55885997521685
"50 FRANKLIN STREET, 12C",2010-07-09,1034353,2016-08-30,1500000,465647,2244,207.50757575757575
"344 EAST 50TH   STREET, 14/2B",2007-03-20,430950,2008-04-04,510000,79050,381,207.48031496062993
"250 EAST 65TH STREET, 11A",2004-09-21,1299000,2007-04-24,1495000,196000,945,207.40740740740742
"5 EAST 22ND   STREET, 12-D",2009-08-11,1437500,2012-06-01,1650000,212500,1025,207.3170731707317
"139 WOOSTER STREET, 3A",2007-08-07,2280880,2010-06-29,2500000,219120,1057,207.30368968779564
"354 BROOME STREET, 6G",2004-12-23,1265000,2014-01-10,1950000,685000,3305,207.26172465960667
"39 EAST 29TH   STREET, 7D",2011-03-29,840000,2017-07-07,1315000,475000,2292,207.24258289703315
"79 WORTH STREET, 5E",2010-02-02,967337,2017-06-16,1525000,557663,2691,207.23262727610555
"225 WEST 83RD   STREET, 8Z",2010-04-07,820000,2017-08-21,1378000,558000,2693,207.2038618640921
"310 WEST 52ND   STREET, 30H",2007-04-30,1573196,2010-12-02,1845000,271804,1312,207.16768292682926
"1623 3 AVENUE, 31C",2003-02-20,281082,2008-12-09,720000,438918,2119,207.13449740443605
"4260 BROADWAY, 105",2014-04-11,384000,2017-08-29,640000,256000,1236,207.11974110032364
"146 WEST 57 STREET, 37D",2004-07-28,1485000,2013-05-14,2150000,665000,3212,207.03611457036115
"635 WEST 42ND STREET, 36B",2007-06-12,1140440,2014-07-07,1675000,534560,2582,207.03330751355537
"400 EAST 51 STREET, 7F",2003-03-06,895000,2009-11-10,1400000,505000,2441,206.8824252355592
"450 EAST 83RD STREET, 25D",2006-08-29,2881647,2014-11-04,3500000,618353,2989,206.87621278019404
"401 EAST 60TH STREET, 12B",2004-07-30,1100000,2007-04-17,1305000,205000,991,206.86175580222
"225 EAST 86 STREET, 301",2004-07-26,485000,2006-06-27,630000,145000,701,206.84736091298146
"142 EDGECOMBE AVENUE, 4A",2014-09-23,539881,2017-11-27,780000,240119,1161,206.82084409991387
"272 WEST 107 STREET, 9D",2010-08-11,1575000,2016-08-19,2030000,455000,2200,206.8181818181818
"505 GREENWICH STREET, 6E",2005-04-04,1585000,2014-09-22,2300000,715000,3458,206.7669172932331
"420 WEST 25TH   STREET, 5D",2008-02-01,1400093,2016-01-12,2000000,599907,2902,206.72191592005512
"82 UNIVERSITY PLACE, 6A",2010-05-13,1400000,2013-09-04,1650000,250000,1210,206.61157024793388
"301 CATHEDRAL PARKWAY, 15D",2006-04-25,196000,2009-02-24,410000,214000,1036,206.56370656370657
"354 BOWERY, 4",2005-01-24,194995,2012-10-02,775000,580005,2808,206.55448717948718
"321 WEST 13TH STREET, 6A",2009-05-27,1325000,2017-09-08,1950000,625000,3026,206.54329147389294
"340 EAST 64TH   STREET, 8A",2011-02-08,827000,2012-03-16,910000,83000,402,206.46766169154228
"555 WEST 59TH STREET, 26B",2008-07-21,1624108,2015-12-29,2185000,560892,2717,206.43798306956202
"210 WEST 19TH STREET, 1J",2011-07-13,720000,2015-02-10,990000,270000,1308,206.42201834862385
"30 EAST 37TH STREET, 3H",2012-05-31,470000,2013-11-15,580000,110000,533,206.37898686679173
"45 PARK AVENUE, 2002",2008-01-29,1985587,2008-08-07,2025000,39413,191,206.35078534031413
"161 WEST 61ST   STREET, 6C",2012-11-16,830000,2017-06-15,1175000,345000,1672,206.3397129186603
"40 WEST 116 STREET, B1201",2009-05-29,833320,2013-10-23,1165000,331680,1608,206.26865671641792
"520 EAST 81 STREET, 7E",2003-06-03,235000,2005-11-16,420000,185000,897,206.24303232998886
"240 PARK AVENUE SOUTH, 5D",2008-04-03,1099710,2015-08-21,1655000,555290,2696,205.96810089020772
"15 WEST 20TH STREET, 8B",2007-06-25,2800187,2017-12-01,3585000,784813,3812,205.8795907660021
"71 NASSAU STREET, PHA",2007-02-21,2112868,2015-08-13,2750000,637132,3095,205.8584814216478
"15 BROAD STREET, 2220",2006-07-31,1883762,2018-08-14,2788750,904988,4397,205.81942233340914
"254 PARK AVENUE SOUTH, 8KL",2010-08-31,2067047,2017-05-10,2570000,502953,2444,205.79091653027822
"415 EAST 37TH STREET, 31L",2007-04-26,1320000,2016-05-13,1999999,679999,3305,205.74856278366113
"315 7TH AVENUE, 11C",2004-07-30,343000,2007-05-07,551000,208000,1011,205.73689416419387
"202 BOWERY, 4",2007-01-10,1323725,2018-01-10,2150000,826275,4018,205.64335490293678
"70 BATTERY PLACE, 9N",2009-07-27,1221900,2013-10-21,1540000,318100,1547,205.62378797672915
"333 RECTOR PLACE, 1210",2011-11-21,750000,2016-09-06,1110000,360000,1751,205.59680182752712
"200 RIVERSIDE BOULEVARD, 40C",2007-07-23,1650000,2016-06-24,2320000,670000,3259,205.58453513347652
"68 BRADHURST AVENUE, 7-K",2007-07-19,455034,2008-10-23,550000,94966,462,205.55411255411255
"1 IRVING PLACE, G20EF",2007-12-06,2300000,2013-04-04,2700000,400000,1946,205.54984583761563
"450 WEST 17TH   STREET, 1215",2008-12-01,840056,2015-09-17,1350000,509944,2481,205.5397017331721
"25 MURRAY STREET, 4F",2008-07-01,1527375,2016-08-29,2140000,612625,2981,205.509896008051
"170 EAST 87TH STREET, E14G",2004-08-09,525000,2006-10-09,687500,162500,791,205.4361567635904
"555 WEST 59TH STREET, 25B",2008-07-03,1501918,2013-12-30,1914000,412082,2006,205.4247258225324
"1031 6 AVENUE, 41A",2006-09-13,575311,2008-05-12,700000,124689,607,205.4184514003295
"1623 3 AVENUE, 27H",2003-02-20,436883,2013-06-11,1210000,773117,3764,205.39771519659936
"313 WEST 119 STREET, 5F",2007-07-17,1639382,2014-05-09,2150000,510618,2488,205.2323151125402
"200 CHAMBERS STREET, 2D",2007-05-03,1483590,2017-06-06,2240000,756410,3687,205.15595334960673
"222 RIVERSIDE DRIVE, 3F",2004-01-29,342000,2006-06-15,520000,178000,868,205.06912442396313
"200 RIVERSIDE BOULEVARD, 14B",2012-11-02,839000,2015-08-28,1050000,211000,1029,205.05344995140914
"310 EAST 53RD STREET, 23A",2006-11-13,2723818,2015-11-24,3400000,676182,3298,205.0278956943602
"800 10TH   AVENUE, 4H",2012-03-19,1060000,2018-01-09,1495000,435000,2122,204.99528746465597
"41 WEST 72ND STREET, 7A",2008-09-19,890968,2016-10-26,1497500,606532,2959,204.9787090233187
"1 MORTON SQUARE, 7C E",2004-11-19,1552831,2018-03-16,2550000,997169,4865,204.96793422404934
"415 MAIN STREET, 2-A",2009-10-22,662084,2015-03-11,1065000,402916,1966,204.94201424211596
"111 FULTON STREET, 510",2010-07-16,600767,2014-05-28,890000,289233,1412,204.83923512747876
"1619 3 AVENUE, 18B",2003-02-20,152607,2006-11-20,433000,280393,1369,204.81592403214026
"2000 BROADWAY, 25A",2009-06-18,1025000,2017-12-14,1660000,635000,3101,204.77265398258626
"450 WEST 17TH   STREET, 1910",2008-12-10,1013158,2018-01-22,1695000,681842,3330,204.75735735735736
"333 RECTOR PLACE, 411",2011-11-22,570220,2018-01-17,1030000,459780,2248,204.52846975088968
"356 BROADWAY, 4B",2003-05-08,499900,2017-05-18,1547500,1047600,5124,204.44964871194378
"147 WEST 13TH   STREET, 3",2007-03-23,1050000,2018-01-26,1860000,810000,3962,204.442200908632
"220 MANHATTAN AVENUE, 6F",2011-08-01,325000,2016-06-01,686000,361000,1766,204.41676104190262
"100 RIVERSIDE BOULEVARD, 21E T",2014-05-28,1535000,2017-04-14,1750000,215000,1052,204.37262357414448
"50 FRANKLIN STREET, 11A",2011-02-07,794235,2016-11-10,1224000,429765,2103,204.358059914408
"124 HUDSON STREET, 4B",2007-04-25,2496875,2012-09-19,2900000,403125,1974,204.21732522796353
"630 FIRST AVENUE, 29L",2008-12-08,1240000,2016-02-10,1775000,535000,2620,204.19847328244273
"11 EAST 29TH   STREET, 35C",2008-06-23,1099710,2010-06-29,1250000,150290,736,204.1983695652174
"225 FIFTH AVENUE, 2H",2007-06-26,1018250,2016-08-16,1700000,681750,3339,204.177897574124
"305 EAST 85TH   STREET, 7D",2010-12-15,1989671,2015-02-12,2300000,310329,1520,204.1638157894737
"220 WEST 93RD   STREET, 7A",2008-01-07,1900000,2017-06-22,2605000,705000,3454,204.11117544875506
"20 PINE STREET, 1401",2009-08-27,771980,2014-11-12,1160000,388020,1903,203.89910667367315
"30 WEST 61ST STREET, 14G",2006-08-18,675000,2007-10-04,759000,84000,412,203.88349514563106
"1437 3 AVENUE, 6B",2003-09-19,570000,2007-12-12,885000,315000,1545,203.88349514563106
"350 WEST 50TH STREET, 27F",2004-05-21,1010000,2008-10-02,1335000,325000,1595,203.76175548589342
"520 WEST 19TH STREET, 3C",2008-09-26,2739092,2012-03-30,3000000,260908,1281,203.6752537080406
"15 BROAD STREET, 2000",2006-05-31,1649565,2013-10-24,2200000,550435,2703,203.63854975952646
"1641 3 AVENUE, 12A",2003-02-20,430114,2012-04-24,1112500,682386,3351,203.63652641002685
"247 WEST 46TH   STREET, 906",2008-08-19,1018248,2014-01-14,1420000,401752,1974,203.52178318135765
"500 WEST 43 STREET, 29A",2004-01-21,275000,2005-12-09,415000,140000,688,203.48837209302326
"350 ALBANY STREET, 2C",2012-11-07,545000,2015-11-03,767000,222000,1091,203.48304307974337
"280 PARK AVENUE SOUTH, 19F",2004-08-31,838000,2016-12-08,1750000,912000,4482,203.4805890227577
"150 WEST 56TH   STREET, 3202",2011-01-19,1205000,2015-08-17,1545000,340000,1671,203.47097546379413
"20 PINE STREET, 1610",2010-05-24,845147,2014-09-12,1165000,319853,1572,203.46882951653944
"120 RIVERSIDE BOULEVARD, PH4M",2006-03-21,1646892,2010-02-04,1935000,288108,1416,203.46610169491527
"100 RIVERSIDE BOULEVARD, 10K",2008-05-05,1041236,2016-11-14,1675000,633764,3115,203.45553772070625
"195 BOWERY, 5E",2006-04-13,610950,2014-11-20,1250000,639050,3143,203.3248488705059
"555 WEST 23RD   STREET, N11C",2007-03-02,1215000,2014-05-16,1750000,535000,2632,203.26747720364742
"1623 3 AVENUE, 39A",2003-03-11,655041,2018-02-21,1765000,1109959,5461,203.251968503937
"11 EAST 29TH   STREET, 50C",2008-08-07,1415367,2014-04-03,1835000,419633,2065,203.21210653753027
"250 EAST 54TH STREET, 34C",2011-03-02,850000,2015-06-24,1170000,320000,1575,203.17460317460316
"263 9 AVENUE, 9B",2006-03-02,1680112,2007-02-09,1750000,69888,344,203.1627906976744
"162 WEST 56TH   STREET, 1606",2009-10-01,233333,2013-05-06,500000,266667,1313,203.0974866717441
"1 MORTON SQUARE, 14E W",2004-12-15,1537557,2017-04-04,2450000,912443,4493,203.08101491208546
"220 EAST 65TH   STREET, 9B",2009-02-24,1225000,2014-03-17,1600000,375000,1847,203.03194369247427
"210 LAFAYETTE STREET, 2C",2006-01-27,941881,2016-12-21,1750000,808119,3981,202.9939713639789
"200 EAST 69TH   STREET, 22B",2007-09-12,2775000,2014-02-07,3250000,475000,2340,202.991452991453
"210 LAFAYETTE STREET, PH2A",2006-02-27,4797874,2011-11-08,5220000,422126,2080,202.9451923076923
"50 WEST 127 STREET, 1C",2011-03-04,507000,2017-05-10,965150,458150,2259,202.81097830898628
"240 RIVERSIDE BOULEVARD, 6 D-T",2005-11-30,1600000,2018-01-24,2500000,900000,4438,202.79405137449302
"25 MURRAY STREET, 3B",2012-03-26,1807393,2016-11-10,2150000,342607,1690,202.72603550295858
"635 WEST 42ND STREET, 33F",2007-06-25,1282995,2014-09-25,1820000,537005,2649,202.71989429973576
"99 JOHN STREET, PH03",2011-04-20,690000,2014-08-11,935000,245000,1209,202.64681555004137
"146 WEST 57TH STREET, 65E",2008-08-21,925000,2010-04-30,1050000,125000,617,202.5931928687196
"160 WEST 66TH   STREET, 36B",2007-09-24,1632500,2016-02-02,2251000,618500,3053,202.58761873566982
"301 EAST 79TH   STREET, 20 F",2012-05-24,640000,2015-05-15,860000,220000,1086,202.57826887661142
"630 FIRST AVENUE, 6M",2005-06-06,820000,2007-10-18,995000,175000,864,202.5462962962963
"415 MAIN STREET, 9-H",2009-10-29,672045,2016-02-26,1140000,467955,2311,202.49026395499783
"76 BEDFORD STREET, 275A",2003-11-18,585000,2008-04-11,910000,325000,1606,202.36612702366128
"280 RECTOR PLACE, 4C",2003-01-07,455000,2007-09-08,800000,345000,1705,202.34604105571847
"272 WEST 107 STREET, 7A",2010-07-15,1900000,2018-08-28,2500000,600000,2966,202.29265003371543
"295 GREENWICH STREET, 5HN",2003-03-06,670000,2017-05-24,1720000,1050000,5193,202.1952628538417
"15 BROAD STREET, 1406",2006-05-24,616041,2014-11-04,1240000,623959,3086,202.1902138690862
"100 UNITED NATIONS PLAZA, 33E",2012-09-19,1100000,2014-10-01,1250000,150000,742,202.15633423180594
"101 WARREN STREET, 9I",2008-06-30,2392887,2017-05-25,3050000,657113,3251,202.12642263918795
"253 WEST 73RD   STREET, 2F",2010-04-14,1075000,2015-10-09,1480000,405000,2004,202.09580838323353
"123 WASHINGTON STREET, 46A",2011-09-20,1464447,2013-06-27,1595000,130553,646,202.09442724458205
"1601 3 AVENUE, 5A",2003-02-20,449305,2011-12-15,1100000,650695,3220,202.07919254658384
"120 RIVERSIDE BOULEVARD, 14D",2006-02-24,1040142,2015-07-07,1731100,690958,3420,202.03450292397662
"125 WEST 22ND STREET, 2C",2008-04-24,1170987,2015-12-16,1735000,564013,2792,202.01038681948424
"135 WEST 70TH STREET, 7F",2005-08-15,1850000,2007-08-03,1995000,145000,718,201.949860724234
"335 EAST 51ST STREET, 8G",2005-05-19,250000,2008-04-03,462000,212000,1050,201.9047619047619
"250 EAST 40 STREET, 24F",2004-06-24,625000,2006-07-07,775000,150000,743,201.8842530282638
"261 WEST 112 STREET, 3D",2010-08-26,636406,2014-06-06,915000,278594,1380,201.87971014492754
"106 CENTRAL PARK SOUTH, 23H",2004-07-28,890000,2005-06-15,955000,65000,322,201.86335403726707
"425 WEST 53RD   STREET, 410",2011-05-12,700000,2015-05-13,995000,295000,1462,201.77838577291382
"150 WEST 51ST   STREET, 19-30",2011-05-19,430000,2014-10-09,680000,250000,1239,201.77562550443906
"100 WEST 39TH   STREET, 36B",2011-06-27,600000,2014-09-04,835000,235000,1165,201.7167381974249
"1601 3 AVENUE, 18G",2003-02-20,271810,2008-04-09,650000,378190,1875,201.70133333333334
"260 PARK AVENUE SOUTH, 11C",2006-07-10,1985587,2017-03-28,2775000,789413,3914,201.6895758814512
"500 WEST 43RD   STREET, 3J",2012-08-02,749000,2015-07-29,969000,220000,1091,201.64986251145737
"30 LITTLE WEST STREET, 18C",2013-11-07,1312000,2017-02-07,1551375,239375,1188,201.49410774410774
"350 WEST 42ND STREET, 39F",2006-11-07,707683,2014-10-31,1295000,587317,2915,201.48096054888507
"21 WEST 75TH STREET, 2",2010-11-30,2438708,2018-07-17,3000000,561292,2786,201.46877243359654
"65 THOMPSON STREET, 5",2005-02-04,1200000,2012-07-27,1750000,550000,2730,201.46520146520146
"130 WEST 19TH STREET, 3E",2006-09-28,1476462,2017-12-08,2300000,823538,4089,201.40327708486183
"400 CENTRAL PARK WEST, 4L",2004-07-16,400000,2007-05-01,605000,205000,1019,201.1776251226693
"225 EAST 86TH   STREET, 1102",2011-07-21,535000,2014-06-19,749000,214000,1064,201.12781954887217
"80 PARK AVENUE, 19G",2004-01-06,775000,2015-03-31,1600000,825000,4102,201.12140419307656
"205 WEST 76TH   STREET, 803",2009-11-03,1019975,2017-06-19,1580000,560025,2785,201.08617594254937
"15 BROAD STREET, 2002",2006-06-05,626223,2015-07-16,1295000,668777,3328,200.95462740384616
"677 WASHINGTON STREET, 7E",2003-09-09,585000,2017-03-06,1575000,990000,4927,200.9336310127867
"157 LUDLOW STREET, PHF",2005-10-21,992793,2016-07-13,1780000,787207,3918,200.9206227667177
"468 WEST 23RD STREET, 2B",2005-07-18,916425,2015-02-18,1620000,703575,3502,200.90662478583667
"301 EAST 79 STREET, 8 R",2004-04-21,87000,2011-08-22,625000,538000,2679,200.82120194102276
"101 WARREN STREET, 3120",2009-02-26,5600375,2013-12-03,5950000,349625,1741,200.81849511774843
"845 UNITED NATIONS PLAZA, 12C",2004-08-25,766233,2014-08-27,1500001,733768,3654,200.81226053639847
"235 EAST 40TH   STREET, 28A",2009-12-29,1060000,2017-11-13,1637500,577500,2876,200.79972183588316
"139 WOOSTER STREET, 4B",2007-08-14,2240150,2014-05-14,2735000,494850,2465,200.75050709939148
"21 MERCER STREET, 4",2006-11-06,3843893,2011-09-15,4200000,356107,1774,200.7367531003382
"2019 1 AVENUE, 6B",2012-09-20,640000,2015-11-10,870000,230000,1146,200.6980802792321
"30 WEST 61 STREET, 9F",2003-02-05,280000,2005-11-23,485000,205000,1022,200.587084148728
"1623 3 AVENUE, 42A",2003-02-20,696789,2016-06-28,1675000,978211,4877,200.57637892146812
"200 EAST 69TH   STREET, 9E",2009-03-31,988125,2015-07-21,1450000,461875,2303,200.55362570560138
"11 EAST 70 STREET, 5A",2004-04-15,1275000,2006-05-03,1425000,150000,748,200.53475935828877
"416 EAST 11 STREET, 3B",2004-08-12,529000,2006-09-29,685000,156000,778,200.51413881748073
"184 THOMPSON STREET, 6D",2007-06-29,911333,2015-07-13,1500000,588667,2936,200.49965940054497
"309 EAST 105 STREET, 4S",2003-12-18,190816,2007-04-19,435000,244184,1218,200.47947454844007
"1601 3 AVENUE, 27A",2003-02-20,571291,2014-06-16,1400000,828709,4134,200.46178035800676
"250 EAST 53RD STREET, 2502",2008-03-11,1829612,2014-04-11,2275000,445388,2222,200.44464446444644
"377 RECTOR PLACE, 8J",2004-09-28,560000,2007-05-29,755000,195000,973,200.41109969167522
"260 PARK AVENUE SOUTH, 8E",2006-04-21,936790,2015-05-15,1600000,663210,3311,200.30504379341588
"48 WEST 138 STREET, 3N",2014-04-23,197730,2016-10-19,380000,182270,910,200.2967032967033
"99 JOHN STREET, 1106",2011-01-31,746000,2017-01-06,1180000,434000,2167,200.27688047992618
"255 HUDSON STREET, PHB",2006-11-20,2087412,2017-06-13,2860000,772588,3858,200.25609123898394
"1623 3 AVENUE, 35F",2003-02-20,457468,2014-05-23,1280000,822532,4110,200.12944038929442
"555 WEST 59TH STREET, 26E",2008-05-02,1761572,2017-03-17,2410000,648428,3241,200.07034865782165
"125 WEST 21ST   STREET, 6B",2012-05-11,1295000,2017-08-30,1682500,387500,1937,200.05162622612286
"525 PARK AVENUE, 10D",2006-02-07,1400000,2017-09-26,2250000,850000,4249,200.04706989879972
"505 WEST 47TH   STREET, 3F-S",2010-05-06,865512,2015-04-09,1225000,359488,1799,199.8265703168427
"260 PARK AVENUE SOUTH, 2E",2006-03-17,1425550,2012-05-14,1875000,449450,2250,199.75555555555556
"304 SPRING STREET, 7",2007-06-11,2750000,2013-03-14,3170000,420000,2103,199.71469329529245
"247 WEST 46TH   STREET, 3101",2010-08-24,1299287,2015-07-23,1657500,358213,1794,199.67279821627648
"555 WEST 59TH STREET, 25E",2008-05-07,1725933,2017-02-10,2365000,639067,3201,199.64604810996565
"38 LAIGHT STREET, P14",2005-01-12,50700,2006-12-06,189000,138300,693,199.56709956709958
"333 EAST 34 STREET, 3N",2004-02-03,400530,2007-04-23,635000,234470,1175,199.54893617021276
"40 BROAD STREET, 23A",2010-04-27,840056,2015-03-11,1195000,354944,1779,199.51883080382237
"252 SEVENTH AVENUE, 11A",2006-06-28,1965000,2010-09-29,2275000,310000,1554,199.48519948519947
"2360 AMSTERDAM AVENUE, 2E",2011-03-15,268811,2017-01-19,695000,426189,2137,199.43331773514274
"400 FIFTH AVENUE, 42H",2012-08-22,1425550,2016-11-22,1735000,309450,1553,199.25949774629748
"835 RIVERSIDE DRIVE, 5I",2011-12-08,375000,2015-04-21,620000,245000,1230,199.1869918699187
"30 EAST 37TH   STREET, 6J",2010-03-15,600000,2014-01-13,878850,278850,1400,199.17857142857142
"655 SIXTH AVENUE, 2G",2007-07-16,1425550,2010-08-16,1650000,224450,1127,199.15705412599823
"7 BOND STREET, 2C",2009-10-29,1386000,2018-04-10,2000000,614000,3085,199.02755267423015
"100 WEST 39TH STREET, 38G",2011-08-16,610000,2013-10-03,765000,155000,779,198.97304236200256
"77 PARK AVENUE, 11E",2003-04-23,1290000,2013-04-15,2015000,725000,3645,198.9026063100137
"106 CENTRAL PARK SOUTH, 16G",2007-11-30,1500000,2012-01-17,1800000,300000,1509,198.80715705765408
"155 PERRY STREET, 2D",2008-09-29,2200000,2013-03-22,2525000,325000,1635,198.77675840978594
"170 EAST 87 STREET, E15C",2003-02-12,580000,2004-06-04,675000,95000,478,198.744769874477
"404 EAST 76 STREET, 20C",2003-11-07,992285,2006-07-14,1187000,194715,980,198.6887755102041
"342 WEST 85TH   STREET, 1B",2010-03-19,1260000,2014-11-25,1600000,340000,1712,198.5981308411215
"188 EAST 70TH STREET, 23A",2011-03-01,1887500,2018-03-26,2400000,512500,2582,198.4895429899303
"555 WEST 59TH STREET, 19G",2008-04-11,1453042,2016-07-06,2050000,596958,3008,198.4567819148936
"160 WADSWORTH AVENUE, 504",2014-08-06,382500,2016-11-02,545000,162500,819,198.4126984126984
"350 EAST 62 STREET, 1N",2003-05-23,245000,2006-10-04,489000,244000,1230,198.3739837398374
"357 WEST 12TH STREET, 2E",2004-10-19,712000,2008-02-01,950000,238000,1200,198.33333333333334
"15 BROAD STREET, 1928",2007-01-26,488760,2014-11-20,1055000,566240,2855,198.33274956217164
"220 3 AVENUE, 3B",2012-02-02,534581,2013-09-06,650000,115419,582,198.31443298969072
"63 DOWNING STREET, 2B",2004-02-13,1250000,2017-03-27,2200000,950000,4791,198.28845752452514
"347 WEST 57TH STREET, 6A",2010-05-07,940000,2018-01-04,1495000,555000,2799,198.28510182207933
"374 BROADWAY, 17A",2005-02-25,400000,2007-12-31,606000,206000,1039,198.26756496631376
"250 EAST 53RD STREET, 2801",2008-03-25,2062418,2012-05-04,2360000,297582,1501,198.2558294470353
"505 GREENWICH STREET, 14E",2005-04-15,1690295,2017-11-09,2600000,909705,4591,198.1496406011762
"1641 3 AVENUE, 15F",2003-02-20,384359,2015-05-18,1270000,885641,4470,198.12997762863534
"333 RECTOR PLACE, 1010",2011-09-27,690000,2015-12-15,995000,305000,1540,198.05194805194805
"425 FIFTH AVENUE, 42B",2004-07-15,909297,2012-12-24,1520000,610703,3084,198.02302204928665
"101 WARREN STREET, 7A",2008-05-14,3054750,2012-06-13,3350000,295250,1491,198.02146210596914
"10 WEST END AVENUE, 24A",2007-09-21,1628420,2015-10-06,2210000,581580,2937,198.01838610827375
"150-56 WEST 56 STREET, 3106",2003-01-17,341000,2004-05-26,439000,98000,495,197.97979797979798
"176 WEST 86 STREET, 5C",2004-09-10,420000,2007-11-16,650000,230000,1162,197.93459552495696
"301 CATHEDRAL PARKWAY, 6P",2013-05-01,425000,2016-06-16,651000,226000,1142,197.8984238178634
"15 WEST 53RD   STREET, 20D",2007-06-01,2600000,2014-05-02,3100000,500000,2527,197.86307874950535
"325 FIFTH AVENUE, 33A",2007-01-10,1715751,2017-11-17,2500000,784249,3964,197.8428355196771
"44 LAIGHT STREET, 6C",2008-07-31,1900000,2012-05-21,2175000,275000,1390,197.84172661870502
"205 EAST 85TH   STREET, 11G",2009-05-12,2091188,2014-04-30,2450000,358812,1814,197.80154355016538
"800 TENTH AVENUE, 5G",2012-07-23,1140000,2017-07-12,1499000,359000,1815,197.79614325068871
"122 GREENWICH AVENUE, 19",2010-03-25,2341975,2014-06-30,2650000,308025,1558,197.7053915275995
"407 EAST 12 STREET, 4FNW",2003-05-19,745000,2004-07-22,830000,85000,430,197.67441860465115
"170 EAST END AVENUE, 7E",2008-10-02,3156575,2017-08-31,3800000,643425,3255,197.67281105990784
"1437 3 AVENUE, 14A",2005-05-05,1500000,2014-09-11,2175000,675000,3416,197.59953161592506
"205 EAST 85TH   STREET, 15H",2009-08-11,1569833,2014-11-17,1950000,380167,1924,197.59199584199584
"350 WEST 50 STREET, 6JJ",2003-10-17,314340,2006-08-23,520000,205660,1041,197.56003842459174
"99 JOHN STREET, 1220",2011-08-15,1059000,2018-07-25,1560000,501000,2536,197.55520504731862
"879-87 8 AVENUE, 2H",2003-01-06,525000,2004-05-06,621000,96000,486,197.53086419753086
"150 EAST 85 STREET, 2B",2003-08-11,248430,2004-09-27,330000,81570,413,197.50605326876513
"305 WEST 22ND   STREET, 1A",2007-08-29,1257000,2015-02-13,1795000,538000,2725,197.43119266055047
"211 EAST 46TH   STREET, 29F",2009-07-10,1196443,2012-12-20,1445000,248557,1259,197.4241461477363
"57 READE STREET, 3D",2012-09-07,1020000,2018-05-31,1433000,413000,2092,197.4187380497132
"45 EAST 80TH STREET, 17A",2005-07-28,2650000,2010-04-16,2990000,340000,1723,197.33023795705165
"10 WEST END AVENUE, 32C",2008-03-21,3105662,2015-01-30,3600000,494338,2506,197.26177174780526
"1641 3 AVENUE, 25E",2003-02-20,142671,2007-03-13,435000,292329,1482,197.25303643724698
"114 EAST 13TH STREET, 7C",2004-10-04,920000,2009-10-29,1285000,365000,1851,197.19070772555375
"322 WEST 57TH   STREET, 38K",2013-05-10,845147,2016-07-19,1075000,229853,1166,197.1295025728988
"199 BOWERY, 6A",2006-05-15,875695,2014-05-07,1450000,574305,2914,197.08476321207962
"150 WEST 51ST   STREET, 18-7",2012-07-25,770000,2015-05-06,970000,200000,1015,197.04433497536945
"124 WEST 93 STREET, 5F",2003-05-09,490000,2006-11-08,742000,252000,1279,197.02892885066458
"10 LITTLE WEST STREET, 18A",2012-07-13,2890000,2017-06-19,3245000,355000,1802,197.0033296337403
"300 ALBANY STREET, 9M",2004-07-21,347500,2006-01-19,455000,107500,547,196.52650822669105
"145 EAST 48 STREET, 15B",2004-10-08,435000,2005-07-15,490000,55000,280,196.42857142857142
"200, 10C",2003-01-22,710000,2003-12-19,775000,65000,331,196.37462235649548
"350 WEST 50 STREET, 5S",2003-01-03,265000,2005-05-18,435000,170000,866,196.30484988452656
"15 CHARLES STREET, 11E",2005-07-27,767760,2014-10-29,1431250,663490,3381,196.2407571724342
"188 EAST 78TH STREET, 17C",2014-10-16,2900000,2018-04-12,3150000,250000,1274,196.23233908948194
"130 SUFFOLK STREET, 130-B",2004-08-18,595500,2007-06-04,795599,200099,1020,196.17549019607844
"310 WEST 52ND   STREET, 14H",2007-03-29,1064071,2014-05-16,1575000,510929,2605,196.13397312859885
"200 CHAMBERS STREET, 28E",2007-06-12,1787028,2010-06-02,2000000,212972,1086,196.10681399631676
"77 WEST 55TH   STREET, 21G",2011-04-12,750000,2013-05-16,900000,150000,765,196.07843137254903
"415 MAIN STREET, 5-A",2009-12-17,773870,2015-03-20,1150000,376130,1919,196.00312662845232
"311 EAST 11TH   STREET, 3C",2010-05-11,773193,2011-07-28,860000,86807,443,195.95259593679458
"146 WEST 57TH   STREET, 34E",2009-11-02,870000,2013-10-01,1150000,280000,1429,195.94121763470957
"220 WEST 148 STREET, 3D",2011-03-30,548000,2013-05-14,700000,152000,776,195.8762886597938
"32 NORTH MOORE STREET, 5",2008-01-22,1830000,2016-09-22,2450000,620000,3166,195.8307012002527
"230 WEST 56TH   STREET, 68C",2009-12-23,3400000,2016-12-20,3900000,500000,2554,195.77133907595928
"220 RIVERSIDE BOULEVARD, 17E",2005-08-15,1800000,2015-06-01,2500000,700000,3577,195.69471624266146
"595 WEST END AVENUE, 7C",2007-09-28,1547740,2013-12-05,1990000,442260,2260,195.69026548672565
"137 DUANE STREET, 2D",2007-12-12,1501918,2014-04-15,1955000,453082,2316,195.63126079447323
"275 GREENWICH STREET, 8GS",2005-06-10,1650000,2013-04-19,2211000,561000,2870,195.47038327526133
"30 EAST 37TH STREET, 4K",2007-02-15,248063,2012-12-28,666953,418890,2143,195.46896873541763
"230 RIVERSIDE DRIVE, 9N",2008-06-30,255000,2012-09-12,555000,300000,1535,195.43973941368077
"677 WASHINGTON STREET, 14A",2007-05-23,965000,2016-12-27,1650000,685000,3506,195.37934968625214
"415 EAST 37TH   STREET, 9A",2010-12-15,698000,2017-12-15,1197500,499500,2557,195.3461087211576
"143 LEXINGTON AVENUE, 6",2009-10-13,1323725,2016-11-18,1830000,506275,2593,195.2468183571153
"90 WILLIAM STREET, 15C",2009-02-27,865000,2014-06-02,1240000,375000,1921,195.2108276939094
"845 UNITED NATIONS PLAZA, 60B",2005-02-15,3691156,2012-04-06,4200000,508844,2607,195.1837360951285
"99 JOHN STREET, 507",2011-04-20,597000,2014-11-17,852000,255000,1307,195.10328997704667
"313 WEST 119 STREET, 4B",2013-08-16,825000,2017-06-26,1100000,275000,1410,195.03546099290782
"247 WEST 46TH   STREET, 802",2008-08-18,1002976,2014-10-07,1440000,437024,2241,195.01294065149486
"39 EAST 29TH STREET, 11C",2008-09-17,1074253,2015-09-29,1575000,500747,2568,194.99493769470405
"350 EAST 54TH STREET, 5A",2005-11-22,390000,2007-06-04,499000,109000,559,194.99105545617172
"100 WEST 93RD   STREET, 7G",2011-08-16,650000,2013-08-29,795000,145000,744,194.89247311827958
"443 WEST 151 STREET, 2A",2012-10-12,145000,2014-04-04,250000,105000,539,194.80519480519482
"555 WEST 59TH   STREET, 23C",2008-11-13,2138325,2014-07-07,2540000,401675,2062,194.79873908826383
"121 EAST 23RD STREET, 12B",2012-06-01,1360000,2018-08-08,1800000,440000,2259,194.77644975652944
"70 BATTERY PLACE, 15E",2009-05-22,2357248,2013-02-25,2625000,267752,1375,194.72872727272727
"1641 3 AVENUE, 15B",2003-02-20,156512,2007-02-15,440000,283488,1456,194.7032967032967
"635 WEST 42ND STREET, 27K",2007-08-13,1257538,2014-10-02,1765000,507462,2607,194.6536248561565
"324 PEARL STREET, 3H",2003-10-09,390000,2007-08-27,665900,275900,1418,194.56981664315938
"201 WEST 74 STREET, 12H",2005-06-17,479500,2006-04-24,540000,60500,311,194.53376205787782
"76 MADISON AVENUE, 11B",2007-04-19,1985587,2018-04-11,2765000,779413,4010,194.36733167082295
"50 FRANKLIN STREET, 4B",2012-06-14,615000,2015-07-21,835000,220000,1132,194.34628975265016
"1619 3 AVENUE, 11K",2003-02-20,415589,2009-08-12,875000,459411,2365,194.25412262156448
"220 RIVERSIDE BOULEVARD, 11L",2010-07-09,1845500,2012-11-16,2012750,167250,861,194.25087108013938
"380 RECTOR PLACE, 6D",2003-11-17,479000,2005-01-07,560000,81000,417,194.24460431654677
"1400 5 AVENUE, 3O",2004-10-18,285940,2009-03-18,599000,313060,1612,194.2059553349876
"2109 BROADWAY, 12160",2010-02-01,985000,2013-06-21,1225000,240000,1236,194.1747572815534
"372 CENTRAL PARK WEST, 7X",2004-03-22,520000,2015-07-29,1325000,805000,4146,194.16304872165944
"1601 3 AVENUE, 3K",2003-02-20,341416,2011-02-02,905000,563584,2904,194.0716253443526
"15 BROAD STREET, 1126",2006-12-21,471510,2014-01-28,975000,503490,2595,194.02312138728323
"425 WEST 53RD   STREET, PH8",2012-07-26,2400000,2017-08-25,2760000,360000,1856,193.9655172413793
"1623 3 AVENUE, 6E",2003-02-20,116408,2007-10-12,445000,328592,1695,193.85958702064897
"25 MURRAY STREET, 4G",2008-08-12,1420458,2016-10-19,2000000,579542,2990,193.8267558528428
"275 WEST 96TH STREET, 7R",2004-10-05,701000,2006-10-18,845000,144000,743,193.80888290713324
"305 EAST 85TH   STREET, 7A",2010-02-05,1858306,2017-05-25,2375000,516694,2666,193.80870217554389
"404 EAST 76 STREET, 7I",2004-06-08,487000,2007-06-07,699000,212000,1094,193.78427787934186
"393 WEST 49 STREET, 6Q",2003-12-15,255000,2006-10-25,457500,202500,1045,193.7799043062201
"99 JOHN STREET, 2507",2011-02-16,678900,2015-02-06,960000,281100,1451,193.72846312887663
"313 WEST 119TH STREET, 3D",2007-07-24,936790,2015-07-10,1500000,563210,2908,193.67606602475928
"161 WEST 61ST   STREET, 9A",2009-04-16,1062500,2015-06-23,1500000,437500,2259,193.6697653829128
"350 ALBANY STREET, 11A",2012-07-23,685000,2015-06-17,890000,205000,1059,193.57884796978283
"1601 3 AVENUE, 8K",2003-02-20,393394,2016-09-01,1350000,956606,4942,193.56657223796034
"145 WEST 27TH STREET, 4E",2006-04-10,1018250,2013-10-18,1550000,531750,2748,193.50436681222706
"175 WEST 12TH STREET, 8B",2006-08-30,977825,2016-07-14,1675000,697175,3606,193.33749306711036
"252 7 AVENUE, 9O",2004-09-27,1700000,2017-06-28,2600000,900000,4657,193.2574618853339
"53 NORTH MOORE STREET, PHB",2007-05-29,1950000,2010-03-29,2150000,200000,1035,193.23671497584542
"340 EAST 23RD STREET, 8M",2008-01-22,1899036,2015-04-28,2411500,512464,2653,193.16396532227668
"40 BOND STREET, 7B",2007-09-06,3614787,2012-06-07,3950000,335213,1736,193.0950460829493
"88 GREENWICH STREET, 1610",2010-01-14,850000,2017-02-16,1350000,500000,2590,193.05019305019306
"310 EAST 53RD   STREET, 24C",2011-02-14,4200000,2015-05-18,4500000,300000,1554,193.05019305019306
"80 RIVERSIDE BOULEVARD, 5F",2010-02-23,604840,2012-11-30,800000,195160,1011,193.03659742828881
"99 JOHN STREET, 1911",2012-08-13,755000,2015-08-06,965000,210000,1088,193.01470588235293
"425 WEST 53RD   STREET, 306",2012-11-15,638951,2017-02-22,940000,301049,1560,192.9801282051282
"393 WEST 49 STREET, 3L",2003-11-11,200000,2006-04-10,370000,170000,881,192.96254256526674
"275 GREENWICH STREET, 10AS",2004-09-23,885000,2017-12-20,1818000,933000,4836,192.92803970223326
"240 RIVERSIDE BOULEVARD, 15 P",2006-05-11,103750,2013-08-02,613000,509250,2640,192.89772727272728
"40 BROAD STREET, 17F",2012-03-01,891019,2013-09-12,999000,107981,560,192.82321428571427
"1 YORK STREET, 6E",2011-01-28,3360225,2017-04-27,3800000,439775,2281,192.79921087242437
"80 JOHN STREET, 4I",2007-03-12,699741,2016-07-01,1355000,655259,3399,192.7799352750809
"250 EAST 53RD STREET, 2401",2008-02-21,2031831,2012-08-29,2350000,318169,1651,192.71290127195638
"10 WEST END AVENUE, 15C",2007-08-23,1649813,2016-05-20,2265000,615187,3193,192.66739743188225
"146 WEST 57TH   STREET, 37A",2007-06-29,1800000,2010-06-23,2010000,210000,1090,192.6605504587156
"715 PARK AVENUE, 10E",2006-12-06,1200000,2011-07-20,1525000,325000,1687,192.6496739774748
"340 EAST 64TH STREET, 5S",2008-10-10,1300000,2017-04-21,1900000,600000,3115,192.6163723916533
"200 RIVERSIDE BOULEVARD, 17G",2004-10-13,925000,2013-11-18,1565000,640000,3323,192.59705085765873
"202 BOWERY, 6",2007-02-15,1425550,2014-12-08,1975000,549450,2853,192.58675078864354
"1 MORTON SQUARE, 12A W",2004-12-10,2148507,2012-01-27,2650000,501493,2604,192.58563748079877
"382 CENTRAL PARK WEST, 14E",2004-05-11,369000,2004-12-10,410000,41000,213,192.4882629107981
"1 CENTRAL PARK WEST, 33F",2003-05-01,1350000,2016-11-07,2300000,950000,4939,192.34662887224135
"106 CENTRAL PARK SOUTH, 8K",2012-08-30,449000,2016-03-01,695000,246000,1279,192.3377638780297
"270 BROADWAY, 16D",2013-11-12,6260000,2017-07-26,6520000,260000,1352,192.30769230769232
"200 CHAMBERS STREET, 9D",2007-06-29,2189237,2012-08-17,2550000,360763,1876,192.3043710021322
"158 HESTER STREET, 5D",2006-12-14,977520,2016-04-01,1630000,652480,3396,192.1319199057715
"177 EAST 77TH STREET, 8A",2005-05-18,1490000,2011-08-01,1925000,435000,2266,191.96822594880848
"58 WEST 58TH STREET, 19-F",2011-06-02,600000,2015-05-05,875000,275000,1433,191.90509420795533
"1 MORTON SQUARE, 8A W",2004-11-18,2403070,2010-07-19,2800000,396930,2069,191.846302561624
"50 BOND STREET, R7",2007-03-29,6669538,2011-12-16,7000000,330462,1723,191.79454439930353
"120 RIVERSIDE BOULEVARD, PH1K",2006-03-09,1466280,2015-05-19,2110000,643720,3358,191.697438951757
"309 WEST 118 STREET, 1ATPL",2005-03-23,809508,2012-07-27,1323725,514217,2683,191.65747297800968
"1601 3 AVENUE, 11H",2003-02-20,385777,2010-02-16,875000,489223,2553,191.62671367019192
"467 CENTRAL PARK WEST, 10B",2007-02-28,1089527,2017-04-25,1800000,710473,3709,191.55378808304124
"20 PINE STREET, 2009",2009-11-30,1231148,2013-11-25,1510000,278852,1456,191.51923076923077
"2250 BROADWAY, 5F",2011-05-05,710000,2013-11-25,889000,179000,935,191.44385026737967
"28 PERRY STREET, BW",2010-03-10,344760,2015-05-05,705000,360240,1882,191.41339001062698
"333 RECTOR PLACE, 1107",2012-07-30,830000,2014-11-13,990000,160000,836,191.38755980861245
"145 EAST 48 STREET, 9D",2004-09-30,595000,2005-11-22,675000,80000,418,191.38755980861245
"249 EAST 118 STREET, 8C",2010-07-06,316368,2015-01-26,635000,318632,1665,191.37057057057058
"205 WEST 76TH   STREET, 8D",2009-11-05,1049548,2017-01-05,1550000,500452,2618,191.1581359816654
"240 EAST HOUSTON STREET, 5D",2007-09-21,1270000,2013-08-05,1680000,410000,2145,191.14219114219114
"38 WARREN STREET, 8A",2008-01-17,1600000,2013-10-10,2000000,400000,2093,191.11323459149546
"515 EAST 72ND STREET, 30E",2012-08-31,1382478,2014-05-08,1500000,117522,615,191.09268292682927
"136 BAXTER STREET, 5C",2008-09-09,2800187,2017-04-14,3400000,599813,3139,191.0841032175852
"1965 BROADWAY, 22G",2004-01-08,860000,2012-06-22,1450000,590000,3088,191.0621761658031
"1601 3 AVENUE, 28H",2003-02-20,443272,2016-02-19,1350000,906728,4747,191.01074362755423
"10 WEST END AVENUE, 19C",2007-08-21,1691981,2015-01-23,2210000,518019,2712,191.0099557522124
"408 EAST 79TH STREET, 8A",2005-12-15,1372906,2015-07-09,2040000,667094,3493,190.98024620669912
"80 PARK AVENUE, 15K",2004-08-03,735000,2006-12-15,900000,165000,864,190.97222222222223
"150 NASSAU STREET, 5A",2003-03-26,318550,2007-10-29,639000,320450,1678,190.97139451728248
"16 WEST 19TH   STREET, 6-E",2008-01-10,1028432,2014-07-28,1485000,456568,2391,190.95273943956502
"10 WEST END AVENUE, 24D",2007-09-20,1632967,2016-05-09,2235000,602033,3154,190.87920101458465
"340 EAST 64TH STREET, 18N",2005-02-08,1125000,2016-02-25,1895000,770000,4034,190.8775409023302
"150 WEST 51ST STREET, 11628",2005-12-05,465000,2008-11-13,670000,205000,1074,190.87523277467412
"302 WEST 12TH   STREET, 1C",2008-08-14,700000,2017-12-11,1350000,650000,3406,190.83969465648855
"166 DUANE STREET, PH.A",2003-07-01,2900000,2018-07-26,3950000,1050000,5504,190.7703488372093
"99 JOHN STREET, 2103",2009-03-12,1100000,2012-08-08,1337500,237500,1245,190.76305220883535
"555 LENOX AVENUE, 1D",2013-01-03,456300,2016-08-25,710000,253700,1330,190.75187969924812
"205 WEST 76TH   STREET, PH1E",2009-12-02,2607923,2015-07-20,3000000,392077,2056,190.6989299610895
"111 FULTON STREET, 314",2008-12-02,1440823,2015-07-07,1900000,459177,2408,190.68812292358805
"520 EAST 81 STREET, 9M",2003-05-23,230000,2006-08-15,455000,225000,1180,190.67796610169492
"380 LENOX AVENUE, 12E",2014-09-26,1604200,2018-03-12,1845000,240800,1263,190.6571654790182
"303 EAST 33RD   STREET, 9B",2011-06-01,636406,2014-04-08,835000,198594,1042,190.58925143953934
"11 EAST 29TH   STREET, 42B",2008-07-08,1598652,2015-03-09,2062500,463848,2435,190.49199178644764
"1619 3 AVENUE, 21H",2003-02-20,448950,2013-07-29,1175000,726050,3812,190.46432318992655
"1641 3 AVENUE, 22F",2003-02-20,414524,2010-12-09,957000,542476,2849,190.40926640926642
"40 BOND STREET, 5B",2007-07-19,3232943,2018-08-02,4000000,767057,4032,190.2423115079365
"80 PARK AVENUE, 9J",2008-02-11,1250000,2010-08-19,1425000,175000,920,190.2173913043478
"345 EAST 80 STREET, 22H",2003-09-04,400000,2006-05-30,590000,190000,999,190.19019019019018
"75 WALL STREET, 34F",2009-10-29,2351344,2015-03-17,2725000,373656,1965,190.1557251908397
"350 WEST 42ND   STREET, 54D",2007-08-10,1652500,2016-12-06,2300000,647500,3406,190.10569583088667
"101 WARREN STREET, 1010",2008-10-17,2749275,2012-05-02,2995000,245725,1293,190.04253673627224
"200 EAST 58 STREET, 6C",2003-09-10,300000,2005-12-30,460000,160000,842,190.02375296912115
"15 BROAD STREET, 3108",2006-08-31,1781937,2017-07-21,2537625,755688,3977,190.0145838571788
"1431 6 AVENUE, 9E",2003-06-06,365000,2004-10-18,460000,95000,500,190.0
"101 WARREN STREET, 540",2008-06-19,1527375,2016-09-19,2100000,572625,3014,189.98838752488388
"16 WEST 48TH   STREET, 6F",2013-05-29,1150000,2016-07-25,1369000,219000,1153,189.9392888117953
"100 UNITED NATIONS PLAZA, 24G",2006-06-06,1200000,2016-11-18,1925000,725000,3818,189.88999476165532
"162 WEST 56 STREET, 1102",2003-02-26,436500,2006-05-18,660000,223500,1177,189.88954970263381
"48 WEST 138 STREET, 1F",2014-06-02,165438,2016-08-24,320000,154562,814,189.87960687960688
"30 LITTLE WEST STREET, 7C",2010-03-15,926000,2018-08-16,1510000,584000,3076,189.85695708712615
"15 BROAD STREET, 1906",2006-06-14,712775,2015-02-19,1315000,602225,3172,189.85655737704917
"77 READE STREET, 6C",2012-08-16,992794,2015-01-14,1160000,167206,881,189.7911464245176
"838 5 AVENUE, 1C",2005-04-21,500000,2014-07-10,1138500,638500,3367,189.63468963468964
"211 WEST 88TH   STREET, 1B",2010-01-08,304258,2012-12-28,510000,205742,1085,189.62396313364056
"300 EAST 23RD   STREET, 15B",2013-04-04,2200000,2018-04-24,2550000,350000,1846,189.5991332611051
"2628 BROADWAY, 10B",2008-03-12,2341975,2018-06-05,3050000,708025,3737,189.46347337436447
"207 EAST 120 STREET, 5F",2012-05-09,263640,2015-08-17,490000,226360,1195,189.4225941422594
"40 BROAD STREET, 25A",2011-10-21,875695,2014-04-29,1050000,174305,921,189.25624321389793
"181 EAST 90TH STREET, 7E",2005-07-15,1120075,2015-02-03,1780000,659925,3490,189.09025787965615
"27 ESSEX STREET, 2A",2012-08-03,402500,2017-04-05,725000,322500,1706,189.03868698710434
"15 WEST 63RD STREET, 23B",2008-06-17,10000000,2011-05-11,10200000,200000,1058,189.0359168241966
"204-10 EAST 47 STREET, 7F",2003-07-22,235000,2003-11-26,259000,24000,127,188.9763779527559
"144 COLUMBUS AVENUE, 27B",2003-12-26,925000,2010-07-30,1380000,455000,2408,188.95348837209303
"40 BROAD STREET, 24E",2011-06-21,783034,2013-08-07,930000,146966,778,188.90231362467867
"1 IRVING PLACE, G11A",2011-09-09,880000,2018-05-11,1340000,460000,2436,188.83415435139574
"220, 8G",2003-01-27,763688,2004-06-07,857500,93812,497,188.75653923541248
"502 PARK AVENUE, 14C",2005-09-01,1654656,2008-07-02,1850000,195344,1035,188.73816425120773
"40 WEST 116 STREET, B308",2008-12-12,747980,2018-05-29,1400000,652020,3455,188.7178002894356
"80 PARK AVENUE, 16K",2004-06-28,720000,2006-10-24,880000,160000,848,188.67924528301887
"400 CENTRAL PARK WEST, 7W",2004-08-13,640000,2007-07-09,840000,200000,1060,188.67924528301887
"230 RIVERSIDE DRIVE, 10C",2008-06-30,176000,2012-12-06,481650,305650,1620,188.67283950617283
"200 EAST 58TH STREET, 12B",2005-08-26,730000,2007-11-26,885000,155000,822,188.56447688564478
"162 WEST 56TH   STREET, 1703",2007-04-09,610000,2014-05-21,1100000,490000,2599,188.53405155829165
"462 WEST 58TH STREET, 7E",2010-04-13,870000,2013-08-15,1100000,230000,1220,188.52459016393442
"118 WEST 112 STREET, 1A",2012-11-15,312000,2014-11-17,450000,138000,732,188.52459016393442
"27 COMMERCE STREET, 272B",2013-06-13,700000,2018-07-09,1049000,349000,1852,188.4449244060475
"115 NORFOLK STREET, 202",2012-01-09,784052,2016-02-08,1065000,280948,1491,188.42924211938296
"22 PERRY STREET, 4D",2003-10-22,550000,2009-08-14,950000,400000,2123,188.41262364578427
"350 ALBANY STREET, P3",2009-12-23,462500,2016-11-04,935000,472500,2508,188.39712918660288
"133 WEST 14TH   STREET, 5",2007-06-29,1440823,2012-06-29,1785000,344177,1827,188.38368910782705
"200 EAST 66TH STREET, B1106",2009-12-10,2100000,2012-11-06,2300000,200000,1062,188.32391713747646
"30 WEST 61ST   STREET, 11G",2009-09-25,625000,2014-06-18,950000,325000,1727,188.18760856977417
"630 1 AVENUE, 17R",2013-05-17,700000,2015-01-29,817050,117050,622,188.18327974276528
"273 WATER STREET, 2",2004-09-23,840056,2017-03-29,1700000,859944,4570,188.17155361050328
"51 ST NICHOLAS AVENUE, 4A",2006-10-05,1120075,2016-02-23,1765000,644925,3428,188.13448074679113
"425 CENTRAL PARK WEST, 6K",2007-12-05,496126,2010-01-08,640000,143874,765,188.0705882352941
"111 WEST 67TH   STREET, 29-B",2010-07-26,1060000,2015-02-25,1375000,315000,1675,188.0597014925373
"71 LUDLOW STREET, 3A",2008-10-02,1323725,2013-07-03,1650000,326275,1735,188.05475504322766
"900 PARK AVENUE, 8E",2003-05-12,1175000,2017-09-28,2162500,987500,5253,187.98781648581763
"1641 3 AVENUE, 14K",2003-02-20,376550,2009-09-02,825000,448450,2386,187.95054484492874
"835 RIVERSIDE DRIVE, 3C",2010-04-26,240000,2015-09-21,611000,371000,1974,187.94326241134752
"500 WEST 43RD   STREET, 15F",2010-10-01,611100,2013-08-19,809000,197900,1053,187.93922127255462
"25 CENTRAL PARK WEST, 6G",2003-06-04,700000,2016-02-23,1573196,873196,4647,187.90531525715517
"240 RIVERSIDE BOULEVARD, 15 OT",2006-03-21,1113000,2012-12-13,1575000,462000,2459,187.8812525416836
"333 RECTOR PLACE, 1011",2012-03-15,700000,2017-08-16,1072000,372000,1980,187.87878787878788
"1 MORTON SQUARE, 9D W",2004-11-30,3003837,2011-06-02,3450000,446163,2375,187.85810526315788
"167 EAST 82ND   STREET, 4D",2011-02-10,890000,2018-03-07,1375000,485000,2582,187.83888458559255
"415 MAIN STREET, 9-A",2009-10-15,794235,2016-01-12,1222500,428265,2280,187.83552631578948
"360 WEST 28TH STREET, 5A",2007-07-31,440000,2008-02-29,480000,40000,213,187.79342723004694
"350 WEST 42ND STREET, 41H",2006-09-14,852531,2015-01-19,1425000,572469,3049,187.75631354542472
"106 CENTRAL PARK SOUTH, 19F",2004-09-13,725000,2009-06-10,1050000,325000,1731,187.7527440785673
"230 RIVERSIDE DRIVE, 9A",2007-03-27,1359363,2013-08-30,1800000,440637,2348,187.66482112436117
"43 EAST 25 STREET, 36A",2003-05-01,610000,2006-01-11,795000,185000,986,187.6267748478702
"80 RIVERSIDE BOULEVARD, 1A",2011-07-22,2414072,2012-10-22,2500000,85928,458,187.61572052401746
"1623 3 AVENUE, 37H",2003-02-20,485860,2015-10-01,1350000,864140,4606,187.6118106817195
"1438 THIRD AVENUE, 27E",2007-08-13,2240150,2015-05-08,2770000,529850,2825,187.55752212389382
"322 WEST 57TH   STREET, 17Q",2011-07-20,524398,2016-09-27,880000,355602,1896,187.55379746835442
"233 EAST 17TH   STREET, 6",2007-09-05,3003837,2016-05-19,3600000,596163,3179,187.5316137150047
"21 SOUTH END AVENUE, 200",2013-11-07,1640000,2016-12-01,1850000,210000,1120,187.5
"16 WEST 19TH   STREET, 5-E",2007-11-30,1033523,2014-08-27,1495000,461477,2462,187.43988627132413
"7 ESSEX STREET, 8A",2003-09-16,965600,2009-11-02,1385000,419400,2239,187.31576596694953
"55 WHITE STREET, 4C",2005-03-30,1800000,2008-10-28,2045000,245000,1308,187.30886850152905
"1623 3 AVENUE, 37K",2003-02-20,512843,2015-01-15,1327000,814157,4347,187.2916954221302
"298 ELIZABETH STREET, 4",2004-07-12,1135000,2013-07-09,1750000,615000,3284,187.27161997563945
"825 WEST END AVENUE, 15-F",2003-02-20,700000,2009-05-14,1126000,426000,2275,187.25274725274724
"45 CHRISTOPHER STREET, 4F",2003-10-21,667000,2012-05-01,1250100,583100,3115,187.19101123595505
"100 RIVERSIDE BOULEVARD, 11K",2008-09-10,1140229,2015-10-14,1625000,484771,2590,187.17027027027027
"40 WEST 116 STREET, B501",2008-12-24,150600,2016-04-04,648000,497400,2658,187.1331828442438
"768 5 AVENUE, 810",2010-12-23,4150000,2014-08-20,4400000,250000,1336,187.125748502994
"16 WEST 19TH   STREET, 3-E",2008-05-22,1501918,2013-06-20,1849000,347082,1855,187.10619946091643
"2000 BROADWAY, 2A",2003-09-03,830000,2009-10-26,1250000,420000,2245,187.08240534521158
"150 WEST 51ST STREET, 19-12",2005-07-25,74757,2015-09-03,765000,690243,3692,186.95639219934995
"120 RIVERSIDE BOULEVARD, 12J",2006-02-10,755032,2007-06-28,849000,93968,503,186.81510934393637
"555 WEST 59TH STREET, 26D",2008-05-08,1792120,2013-08-06,2150000,357880,1916,186.78496868475992
"155 WEST 71 STREET, 4G",2003-07-30,195000,2006-06-08,390000,195000,1044,186.7816091954023
"2019 1 AVENUE, 9C",2013-12-03,681159,2016-02-08,830000,148841,797,186.75156838143036
"182 MULBERRY STREET, 3",2006-07-07,1378334,2018-06-29,2195000,816666,4375,186.6665142857143
"158 FRANKLIN STREET, 4",2006-08-03,252500,2014-10-13,811000,558500,2993,186.60207150016706
"350 WEST 50 STREET, 21H",2003-10-14,455000,2006-08-25,650000,195000,1046,186.4244741873805
"15 BROAD STREET, 3800",2006-12-27,1792120,2015-07-21,2375000,582880,3128,186.34271099744245
"253 WEST 73RD STREET, 14F",2009-07-01,800000,2016-02-10,1250000,450000,2415,186.33540372670808
"200 EAST 69TH STREET, 4H",2015-07-08,570000,2016-05-25,630000,60000,322,186.33540372670808
"200 CHAMBERS STREET, 19A",2007-07-18,2983472,2012-03-12,3300000,316528,1699,186.30253090052972
"41 WEST 72 STREET, 14B",2003-12-08,560038,2006-07-31,740000,179962,966,186.296066252588
"1760 2 AVENUE, 30B",2003-08-21,680000,2008-09-16,1025000,345000,1853,186.184565569347
"1641 3 AVENUE, 9H",2003-02-20,364483,2011-10-28,955000,590517,3172,186.16551071878942
"500 WEST 43 STREET, 7J",2003-07-31,405000,2006-09-28,620000,215000,1155,186.14718614718615
"235 EAST 40 STREET, 3J",2003-04-07,257000,2005-07-07,410000,153000,822,186.13138686131387
"322 WEST 57TH STREET, 34F1",2009-02-09,1629200,2015-10-28,2085500,456300,2452,186.09298531810768
"25 FIFTH AVENUE, 14C",2007-11-27,2698362,2017-06-29,3350000,651638,3502,186.07595659623072
"325 5 AVENUE, 36F",2007-01-24,1731025,2013-08-06,2175000,443975,2386,186.0750209555742
"10 WEST END AVENUE, 24B",2007-09-25,1736319,2014-07-22,2200000,463681,2492,186.06781701444623
"1965 BROADWAY, 20E",2006-01-06,2320000,2012-05-07,2750000,430000,2313,185.90575010808473
"110 WEST 90TH STREET, 1A",2011-08-05,1100000,2016-05-19,1425000,325000,1749,185.82046883933677
"225 5 AVENUE, 9R",2007-03-20,1038615,2018-06-08,1800000,761385,4098,185.794289897511
"52 PARK AVENUE, 7",2003-09-16,711757,2012-07-10,1310000,598243,3220,185.78975155279502
"400 EAST 70 STREET, 1205",2003-05-29,375000,2005-02-17,492000,117000,630,185.71428571428572
"49 EAST 21ST   STREET, 9A",2007-12-17,1900000,2014-09-29,2360000,460000,2478,185.63357546408395
"15 BROAD STREET, 3530",2007-04-20,2403070,2010-08-11,2627500,224430,1209,185.63275434243175
"40 WEST 116 STREET, A411",2008-09-16,687740,2015-12-23,1180000,492260,2654,185.47852298417484
"350 WEST 42ND STREET, 50E",2006-10-16,832419,2017-08-23,1567500,735081,3964,185.43920282542885
"475 GREENWICH STREET, 5A",2008-07-02,2443800,2011-12-28,2680000,236200,1274,185.40031397174255
"200 CHAMBERS STREET, 3F",2007-02-09,722957,2014-07-11,1225000,502043,2709,185.32410483573275
"1 MORTON SQUARE, 5A W",2004-10-28,1374637,2018-07-02,2300000,925363,4995,185.25785785785786
"211 WEST 71ST STREET, 7A",2004-08-30,871000,2016-11-03,1695000,824000,4448,185.25179856115108
"310 WEST 52ND STREET, 41B",2007-08-08,2270697,2018-05-21,3000000,729303,3939,185.14927646610815
"146 WEST 57TH   STREET, 41B",2008-03-31,1300000,2015-04-10,1775000,475000,2566,185.11301636788775
"254 PARK AVENUE SOUTH, 6HJ",2012-05-08,1310000,2017-12-21,1690000,380000,2053,185.0949829517779
"502 PARK AVENUE, 10J",2004-06-21,1417404,2012-05-08,1950000,532596,2878,185.0576789437109
"8 UNION SQUARE SOUTH, 9A",2007-11-13,3360225,2016-08-04,3950000,589775,3187,185.05647944775652
"211 EAST 13TH   STREET, PH1 E",2014-10-09,1146640,2017-10-12,1350000,203360,1099,185.04094631483167
"111 CENTRAL PARK NORTH, 10C",2007-10-25,1730006,2018-02-06,2425000,694994,3757,184.98642533936652
"2628 BROADWAY, 11A",2008-07-01,2698362,2015-06-25,3170000,471638,2550,184.95607843137256
"161 WEST 61ST   STREET, 11C",2011-09-07,755000,2017-02-28,1125000,370000,2001,184.90754622688655
"400 EAST 51 STREET, 20B",2003-07-28,1532466,2018-04-13,2525000,992534,5373,184.72622371114832
"450 WEST 17TH   STREET, 1101",2008-10-16,636406,2016-01-13,1125000,488594,2645,184.723629489603
"415 EAST 37 STREET, 12G",2003-07-29,650000,2004-10-15,732000,82000,444,184.6846846846847
"15 BROAD STREET, 1600",2006-07-24,896317,2017-07-06,1635000,738683,4000,184.67075
"2628 BROADWAY, 26A",2008-01-23,1900000,2018-05-15,2595000,695000,3765,184.5949535192563
"165 CHARLES STREET, RU6",2005-08-19,1883762,2012-07-19,2350000,466238,2526,184.57561361836898
"200 WEST END AVENUE, 20B",2008-05-27,2774731,2017-09-05,3400000,625269,3388,184.55401416765054
"120 RIVERSIDE BOULEVARD, 15A",2006-08-25,1016620,2011-06-13,1340000,323380,1753,184.4723331431831
"90 EAST END AVENUE, 2E",2010-07-23,207000,2015-08-26,550000,343000,1860,184.40860215053763
"393 WEST 49 STREET, 4N",2003-08-11,228150,2006-01-05,390000,161850,878,184.3394077448747
"2280 FREDERICK DOUGLASS B, 7F",2011-12-19,559000,2016-01-08,832000,273000,1481,184.33490884537474
"2 CORNELIA STREET, 601",2003-04-09,550000,2011-08-03,1110000,560000,3038,184.33179723502303
"3 WEST 13TH   STREET, 6",2008-07-21,2291062,2013-02-21,2600000,308938,1676,184.33054892601433
"90 WILLIAM STREET, 4C",2009-02-06,804000,2016-05-25,1295000,491000,2665,184.24015009380864
"21 LUDLOW STREET, 5B",2012-11-14,605858,2018-06-07,980000,374142,2031,184.21565731166913
"333 EAST 34 STREET, 16H",2004-04-21,468975,2006-08-16,625000,156025,847,184.2089728453365
"275 WEST 96TH STREET, 9E",2004-12-21,1280000,2017-02-28,2100000,820000,4452,184.18688230008985
"322 WEST 57TH   STREET, 21B2",2008-03-18,2021226,2017-02-24,2622500,601274,3265,184.1574272588055
"1619 3 AVENUE, 7E",2003-02-20,124926,2007-07-12,420000,295074,1603,184.07610729881472
"164 PEARL STREET, 3K",2004-12-23,550000,2008-02-28,763875,213875,1162,184.0576592082616
"504 WEST 136 STREET, 5D",2006-11-30,192660,2012-07-13,570220,377560,2052,183.99610136452242
"200 RIVERSIDE BOULEVARD, 9C",2006-06-02,1150000,2007-09-07,1235000,85000,462,183.982683982684
"150 NASSAU STREET, 8B",2003-04-10,380454,2007-08-28,675000,294546,1601,183.97626483447846
"1 IRVING PLACE, P7O",2010-12-17,807000,2016-05-13,1170000,363000,1974,183.89057750759878
"235 WEST END AVENUE, 4C",2003-03-26,424000,2007-07-26,715000,291000,1583,183.82817435249527
"415 EAST 54TH   STREET, 10F",2008-11-24,1100000,2010-01-06,1175000,75000,408,183.8235294117647
"1619 3 AVENUE, 19K",2003-02-20,453208,2014-03-10,1195000,741792,4036,183.7938553022795
"52 PARK AVENUE, 14",2005-02-28,1018250,2013-10-25,1599000,580750,3161,183.72350521986712
"200 CHAMBERS STREET, 14F",2007-04-23,967337,2013-09-06,1395000,427663,2328,183.70403780068727
"109 NORFOLK STREET, 2",2007-11-08,1578287,2013-05-24,1950000,371713,2024,183.65266798418972
"170 EAST END AVENUE, 3F",2008-04-18,3399825,2013-03-21,3730000,330175,1798,183.63459399332592
"80 RIVERSIDE BOULEVARD, 7T",2010-08-09,966319,2014-06-18,1225000,258681,1409,183.5919091554294
"119 FULTON STREET, 9",2007-03-09,1221900,2016-12-05,1875000,653100,3559,183.5066029783647
"280 PARK AVENUE SOUTH, 6J",2003-04-28,580000,2008-02-05,900000,320000,1744,183.4862385321101
"515 EAST 72ND   STREET, 8D",2010-02-18,833215,2015-06-11,1188888,355673,1939,183.43115007735946
"120 RIVERSIDE BOULEVARD, PH4D",2007-01-16,1715512,2017-01-31,2388000,672488,3668,183.3391494002181
"45 PARK AVENUE, 1503",2008-01-07,2016898,2014-02-11,2425000,408102,2227,183.25190839694656
"319 WEST 38 STREET, 3211R",2003-08-04,242500,2006-07-17,440000,197500,1078,183.2096474953618
"120 RIVERSIDE BOULEVARD, 9S",2006-02-10,1344090,2013-04-19,1825000,480910,2625,183.20380952380953
"394 MANHATTAN AVENUE, 5",2007-02-15,1275000,2017-11-21,1995000,720000,3932,183.11291963377417
"2300 FREDRICK DOUGLASS BL, 7E",2011-09-15,441090,2012-11-19,520000,78910,431,183.0858468677494
"255 HUDSON STREET, PHD",2007-04-05,1375000,2014-09-26,1875000,500000,2731,183.08311973636032
"415 MAIN STREET, 14-F",2012-04-02,1041160,2015-05-18,1250000,208840,1141,183.03242769500437
"33 WEST 56TH   STREET, 4E",2011-07-27,2934801,2016-04-15,3250000,315199,1724,182.8300464037123
"57 READE STREET, 19B",2012-08-13,2225000,2017-02-10,2525000,300000,1642,182.70401948842874
"249 EAST 118 STREET, 4D",2010-10-26,326172,2014-12-04,600000,273828,1500,182.552
"505 GREENWICH STREET, 2F",2005-01-19,641497,2012-05-18,1130000,488503,2676,182.54970104633782
"195 BOWERY, 7E",2006-07-20,826819,2015-11-24,1450000,623181,3414,182.53690685413005
"75 WALL STREET, 27M",2010-07-06,1400093,2015-04-24,1720000,319907,1753,182.4911580148317
"393 WEST 49 STREET, 5H",2003-07-18,283920,2006-07-24,485000,201080,1102,182.4682395644283
"445 5 AVENUE, 33-B",2003-11-20,1400000,2015-11-23,2200000,800000,4386,182.3985408116735
"78 BEDFORD STREET, 2A",2011-12-09,1185000,2016-08-31,1500000,315000,1727,182.39722061378112
"2 SOUTH END AVENUE, TH3",2008-06-02,1380000,2016-01-29,1890000,510000,2797,182.33821952091526
"100 WEST 18TH STREET, 6C",2008-06-04,2392887,2011-11-29,2625000,232113,1273,182.33542812254518
"133 WEST 22ND   STREET, 3A",2009-06-29,605858,2014-03-18,920000,314142,1723,182.32269297736505
"340 WEST 86TH   STREET, 8D",2009-08-07,1128000,2016-11-02,1610000,482000,2644,182.29954614220878
"260 PARK AVENUE SOUTH, 10C",2006-07-25,1883762,2011-04-25,2200000,316238,1735,182.26974063400576
"1601 3 AVENUE, 27H",2003-02-20,439012,2016-04-29,1317000,877988,4817,182.26863192858625
"304 WEST 115 STREET, 5A",2007-04-24,845000,2015-08-25,1400000,555000,3045,182.26600985221674
"100 RIVERSIDE BOULEVARD, 20E",2008-11-18,1373517,2016-08-23,1890000,516483,2835,182.1809523809524
"261 WEST 28TH STREET, 2E",2007-11-13,1476462,2014-03-26,1900000,423538,2325,182.1668817204301
"275 GREENWICH STREET, 6MS",2003-07-16,455000,2008-03-13,765000,310000,1702,182.13866039952995
"261 WEST 112 STREET, 5B",2011-02-22,670000,2017-08-10,1100000,430000,2361,182.12621770436255
"165 WEST 91ST STREET, 2C",2013-12-16,1374637,2018-08-30,1687500,312863,1718,182.10884749708964
"90 EAST END AVENUE, 3A",2004-07-12,5300000,2015-10-22,6050000,750000,4119,182.0830298616169
"247 WEST 46TH   STREET, 2002",2008-11-21,1242265,2013-12-20,1580000,337735,1855,182.06738544474393
"1623 3 AVENUE, 11A",2003-02-20,467404,2013-05-28,1150000,682596,3750,182.0256
"245 SEVENTH AVENUE, 8B",2005-05-14,2400000,2012-11-20,2900000,500000,2747,182.01674554058974
"310 EAST 53RD STREET, 8A",2006-11-02,1895981,2016-11-09,2562125,666144,3660,182.00655737704918
"117 BEEKMAN STREET, 5A",2003-06-18,560000,2007-06-14,825000,265000,1457,181.8805765271105
"400 5 AVENUE, 45F",2011-06-09,1578287,2018-07-16,2050000,471713,2594,181.84772552043177
"99 BATTERY PLACE, 5-K",2003-05-29,248000,2005-02-03,360000,112000,616,181.8181818181818
"209 WEST 104 STREET, 3A",2003-06-06,317000,2008-07-30,659000,342000,1881,181.8181818181818
"520 WEST 19TH STREET, 3A",2008-10-06,1934675,2012-04-09,2167500,232825,1281,181.75253708040594
"220 RIVERSIDE BOULEVARD, 10A",2009-10-21,800000,2015-07-13,1180000,380000,2091,181.73122907699664
"433 EAST 74TH   STREET, 6A",2009-06-30,4887600,2011-02-11,4995000,107400,591,181.7258883248731
"210 WEST 19TH STREET, 3B",2007-09-07,437500,2014-09-23,905000,467500,2573,181.69452001554606
"10 WEST END AVENUE, 25D",2007-09-27,1573501,2018-04-24,2275000,701499,3862,181.64137752459865
"416 WEST 52ND STREET, 417",2017-11-22,1322000,2018-06-27,1361400,39400,217,181.5668202764977
"120 RIVERSIDE BOULEVARD, PH3F",2006-08-04,1033900,2010-08-09,1300000,266100,1466,181.51432469304228
"120 RIVERSIDE BOULEVARD, 8L",2006-03-10,1491736,2016-11-15,2200000,708264,3903,181.46656418139892
"350 WEST 42ND STREET, 53H",2006-10-27,868058,2014-02-04,1350000,481942,2657,181.38577342867896
"85 WEST BROADWAY, 11N",2010-03-18,650000,2015-02-12,975000,325000,1792,181.36160714285714
"200 RIVERSIDE BOULEVARD, 31D",2012-10-10,1645000,2018-01-22,1995000,350000,1930,181.34715025906735
"75 WALL STREET, 26E",2013-10-04,814600,2016-01-12,965000,150400,830,181.20481927710844
"203 WEST 90 STREET, 9A",2003-02-04,865600,2017-08-22,1828000,962400,5313,181.14059853190287
"210 LAFAYETTE STREET, 4G",2006-02-13,2087412,2018-01-09,2875000,787588,4348,181.13799448022078
"247 WEST 46TH   STREET, 3502",2008-12-12,1496827,2015-04-09,1915000,418173,2309,181.1056734517107
"160 CENTRAL PARK SOUTH, 3910",2009-05-04,1300000,2014-08-19,1650000,350000,1933,181.0657009829281
"21 LUDLOW STREET, 9B",2009-07-01,776238,2017-06-02,1300000,523762,2893,181.044590390598
"181 EAST 90TH STREET, 11A",2008-10-15,2150000,2016-08-10,2667000,517000,2856,181.02240896358543
"220 MANHATTAN AVENUE, 1V",2007-07-16,325000,2015-06-19,849000,524000,2895,181.00172711571676
"2101 BROADWAY, 41227",2003-11-26,475000,2008-08-04,785000,310000,1713,180.96906012842965
"305 2 AVENUE, 507",2006-11-21,1176153,2014-09-29,1695000,518847,2869,180.84593935169048
"510 EAST 80TH STREET, 3C",2012-09-13,725000,2017-06-21,1040000,315000,1742,180.82663605051664
"175 WEST 12TH   STREET, 2H",2013-07-22,995000,2017-02-14,1230465,235465,1303,180.7099002302379
"347 WEST 57TH STREET, 15D",2007-08-06,840000,2015-05-01,1350000,510000,2825,180.53097345132744
"250 EAST 40TH   STREET, 7E",2011-12-22,690000,2016-05-16,980000,290000,1607,180.46048537647792
"111 FULTON STREET, PH203",2009-07-22,810000,2016-08-11,1275000,465000,2577,180.44237485448195
"200 EAST 61 STREET, 18A",2003-09-05,730000,2010-09-21,1194000,464000,2573,180.33424018655265
"320 ALBANY STREET, 9C",2004-01-30,474000,2007-12-03,727000,253000,1403,180.327868852459
"199 BOWERY, 8A",2006-05-10,896060,2016-05-25,1557500,661440,3668,180.32715376226827
"302 WEST 12TH STREET, 6C",2005-01-18,995000,2011-03-15,1400000,405000,2247,180.24032042723633
"400 CENTRAL PARK WEST, 10C",2006-06-28,1090000,2015-07-29,1688000,598000,3318,180.22905364677516
"11 EAST 29TH   STREET, 38C",2008-06-27,1114983,2013-01-18,1415000,300017,1666,180.08223289315725
"250 EAST 53RD STREET, 2903",2008-07-08,1395046,2014-08-07,1795000,399954,2221,180.07834308869877
"55 WALL STREET, 940",2010-07-16,1097836,2015-10-26,1445000,347164,1928,180.0643153526971
"225 EAST 34TH   STREET, 16C",2008-07-14,1323725,2012-12-18,1615000,291275,1618,180.02163164400494
"1623 3 AVENUE, 27F",2003-02-20,420202,2016-12-23,1330000,909798,5055,179.97982195845697
"1623 3 AVENUE, 37F",2003-02-20,468115,2008-12-12,850000,381885,2122,179.9646559849199
"692 BROADWAY, 1122",2006-03-28,2200000,2014-08-11,2750000,550000,3058,179.85611510791367
"60 EAST 55TH STREET, 21A",2014-07-23,2495000,2017-09-05,2700000,205000,1140,179.82456140350877
"392 CENTRAL PARK WEST, 2C",2007-07-25,975000,2015-07-23,1499999,524999,2920,179.7941780821918
"393 WEST 49 STREET, 3O",2004-01-05,292000,2004-09-28,340000,48000,267,179.77528089887642
"333 RECTOR PLACE, 813",2011-05-26,549973,2017-06-29,950000,400027,2226,179.70664869721475
"225 EAST 34TH STREET, 16F",2007-12-03,1013158,2015-06-29,1510000,496842,2765,179.68969258589513
"768 5 AVENUE, 601",2008-07-11,9340008,2018-08-01,10000000,659992,3673,179.6874489518105
"220 EAST 65TH STREET, 10J",2009-09-29,638000,2012-04-10,804000,166000,924,179.65367965367966
"20 WEST STREET, 44B",2006-09-07,574000,2009-09-30,775000,201000,1119,179.62466487935657
"1965 BROADWAY, 14C",2003-06-09,715000,2013-07-01,1375000,660000,3675,179.59183673469389
"111 EAST 30TH   STREET, 17A",2009-01-27,1125000,2015-03-05,1525000,400000,2228,179.53321364452424
"354 BOWERY, 5",2003-09-04,164450,2015-11-24,965695,801245,4464,179.49036738351253
"1619 3 AVENUE, 11B",2003-02-20,144800,2008-09-16,510000,365200,2035,179.45945945945945
"150 NASSAU STREET, 12D",2003-05-15,937528,2015-10-09,1750000,812472,4530,179.35364238410597
"150-56 WEST 56 STREET, 3209",2003-05-13,357000,2003-11-13,390000,33000,184,179.34782608695653
"120 RIVERSIDE BOULEVARD, 11S",2006-01-25,1383190,2013-10-11,1888000,504810,2816,179.26491477272728
"540 WEST 28TH STREET, 7J",2013-07-23,1050000,2017-05-18,1300000,250000,1395,179.21146953405017
"150 NASSAU STREET, 9D",2003-03-21,506500,2006-01-08,690000,183500,1024,179.19921875
"15 BROAD STREET, 2616",2006-07-18,1086913,2014-07-29,1612500,525587,2933,179.19774974428913
"1619 3 AVENUE, 1K",2003-02-20,370516,2018-02-08,1350000,979484,5467,179.1629778672032
"225 WEST 60TH STREET, 14D",2010-05-13,655000,2015-07-24,995000,340000,1898,179.1359325605901
"50 FRANKLIN STREET, 4E",2010-07-27,783034,2015-03-23,1087500,304466,1700,179.09764705882353
"100 UNITED NATIONS PLAZA, 46D",2003-12-12,1350000,2013-02-13,1950000,600000,3351,179.05102954341987
"256 WEST 123 STREET, GARD1",2011-04-13,687318,2016-08-31,1039500,352182,1967,179.04524656837825
"524 EAST 72 STREET, 29B",2004-07-09,676115,2006-05-04,795000,118885,664,179.04367469879517
"1 YORK STREET, 5G",2008-08-04,1780068,2016-07-18,2300000,519932,2905,178.97831325301206
"60 RIVERSIDE BOULEVARD, 1106",2011-09-26,1454006,2013-12-20,1600000,145994,816,178.9142156862745
"100 RIVERSIDE BOULEVARD, 25C",2008-07-18,1517192,2013-11-27,1867000,349808,1958,178.65577119509703
"166 DUANE STREET, 10C",2007-01-25,4300000,2011-09-01,4600000,300000,1680,178.57142857142858
"330 EAST 75TH STREET, 14E",2004-11-01,917500,2015-06-16,1610000,692500,3879,178.5253931425625
"305 SECOND AVENUE, 501",2007-02-09,1255502,2015-06-17,1800000,544498,3050,178.52393442622952
"125 WEST 22ND   STREET, 7A",2008-10-02,997885,2016-10-05,1519999,522114,2925,178.50051282051282
"340 EAST 23RD STREET, 9D",2008-02-26,1242265,2015-07-24,1725000,482735,2705,178.46025878003698
"92 LAIGHT STREET, 2D",2005-09-21,2392887,2010-06-08,2700000,307113,1721,178.45031958163858
"1438 THIRD AVENUE, 14B",2014-02-06,975000,2017-07-21,1200000,225000,1261,178.42981760507533
"15 BROAD STREET, 3120",2006-09-29,2087412,2014-09-08,2605000,517588,2901,178.41709755256807
"416 WASHINGTON STREET, 2J",2007-12-17,3190000,2018-02-02,3850000,660000,3700,178.3783783783784
"5 EAST 22ND STREET, 28T",2004-08-31,665935,2006-09-22,800000,134065,752,178.2779255319149
"100 UNITED NATIONS PLAZA, 22C",2004-12-01,695000,2006-07-13,800000,105000,589,178.26825127334465
"43 EAST 25TH   STREET, 29C",2013-07-26,1690000,2018-04-30,2000000,310000,1739,178.26336975273145
"188 EAST 70 STREET, 5E",2004-08-10,535000,2007-10-04,740000,205000,1150,178.2608695652174
"310 WEST 52ND   STREET, 10D",2007-02-26,656771,2014-05-07,1125000,468229,2627,178.23715264560335
"416 WEST 52ND STREET, 602",2017-11-22,1280000,2018-06-27,1318633,38633,217,178.03225806451613
"502 PARK AVENUE, 16D",2005-05-13,2138325,2018-08-14,3000000,861675,4841,177.99524891551332
"199 BOWERY, 2C",2010-10-15,293370,2014-09-26,550000,256630,1442,177.96809986130376
"159 WEST 53RD STREET, 28H",2009-10-16,800000,2014-07-24,1110000,310000,1742,177.95637198622273
"395 BROADWAY, 11D",2005-09-13,1230000,2018-04-27,2050000,820000,4609,177.91277934476025
"426 WEST 58TH   STREET, 2C",2013-05-01,2875000,2016-10-17,3100000,225000,1265,177.86561264822134
"668 RIVERSIDE DRIVE, 6E",2013-10-18,359970,2017-02-08,575000,215030,1209,177.85773366418528
"320 ALBANY STREET, 2K",2005-07-25,437500,2007-07-26,567500,130000,731,177.83857729138168
"462 WEST 58TH   STREET, 2C",2010-06-11,1235000,2017-12-27,1725000,490000,2756,177.79390420899855
"250 EAST 49TH   STREET, 21D",2011-03-09,1451006,2015-04-30,1720000,268994,1513,177.78849966953072
"255 CABRINI BOULEVARD, 3H",2004-03-12,27236,2015-01-08,730000,702764,3954,177.73495194739505
"111 CENTRAL PARK NORTH, 16C",2007-11-16,2367431,2018-01-31,3030000,662569,3729,177.68007508715473
"250 EAST 40 STREET, 33C",2003-01-28,285000,2005-06-30,442000,157000,884,177.60180995475113
"400 EAST 67TH   STREET, 23B",2012-07-31,3034385,2014-05-13,3150000,115615,651,177.59600614439324
"130 WEST 30TH STREET, 11A",2004-10-13,1013158,2010-10-01,1400000,386842,2179,177.53189536484626
"148 EAST 24TH   STREET, 15A",2012-01-20,1285000,2017-02-21,1615000,330000,1859,177.5147928994083
"99 JOHN STREET, 2304",2010-04-20,707000,2015-11-25,1070000,363000,2045,177.50611246943765
"80 RIVERSIDE BOULEVARD, 9D",2009-08-05,761651,2015-07-17,1147000,385349,2172,177.41666666666666
"402 EAST 90TH   STREET, 6B",2010-09-15,1035000,2013-08-21,1225000,190000,1071,177.40429505135387
"115 NORFOLK STREET, 304",2011-07-15,1370525,2016-05-05,1682000,311475,1756,177.377562642369
"1601 3 AVENUE, 21K",2003-02-20,433689,2010-07-27,915000,481311,2714,177.34377302873986
"372 CENTRAL PARK WEST, 9S",2003-12-19,332000,2004-12-14,396000,64000,361,177.2853185595568
"154 ATTORNEY STREET, 103",2006-12-27,1425550,2008-02-20,1500000,74450,420,177.26190476190476
"309 WEST 118TH STREET, 4L",2013-07-03,790000,2017-10-16,1067500,277500,1566,177.2030651340996
"392 CENTRAL PARK WEST, 16F",2012-11-09,550000,2014-11-13,680000,130000,734,177.1117166212534
"581 ACADEMY STREET, 2H",2003-12-09,110000,2005-11-28,237500,127500,720,177.08333333333334
"445 FIFTH AVENUE, 29G",2005-06-13,625000,2006-10-06,710000,85000,480,177.08333333333334
"225 5 AVENUE, PHD",2007-11-15,1769209,2012-03-19,2050000,280791,1586,177.0435056746532
"15 BROAD STREET, 2626",2006-11-28,870603,2015-02-05,1400000,529397,2991,176.9966566365764
"240 RIVERSIDE BOULEVARD, 9 O-T",2006-03-07,1054250,2013-05-21,1520000,465750,2632,176.9566869300912
"129 LAFAYETTE STREET, 4B",2005-01-03,962246,2013-04-02,1495000,532754,3011,176.93590169378945
"254 WEST 10TH STREET, 3A",2007-09-19,1597000,2011-08-19,1850000,253000,1430,176.92307692307693
"1 MORTON SQUARE, 3D E",2004-01-14,1629200,2010-07-20,2050000,420800,2379,176.88104245481296
"146 WEST 57TH   STREET, 70D",2007-02-28,1789000,2010-02-12,1980000,191000,1080,176.85185185185185
"310 EAST 53RD STREET, 20C",2006-10-17,3670791,2013-06-10,4100000,429209,2428,176.77471169686984
"230 RIVERSIDE DRIVE, 7J",2008-06-30,146000,2011-01-04,308256,162256,918,176.74945533769062
"322 WEST 57TH   STREET, 54F",2011-01-14,725000,2017-09-12,1155000,430000,2433,176.7365392519523
"1601 3 AVENUE, 15A",2003-02-20,484084,2012-07-25,1092500,608416,3443,176.71100784199825
"249 EAST 118TH STREET, 8A",2010-08-04,341768,2014-11-26,620000,278232,1575,176.6552380952381
"230 RIVERSIDE DRIVE, 9H",2008-06-30,475000,2011-03-18,650000,175000,991,176.58930373360243
"443 WEST 151ST STREET, 3D",2005-08-23,155000,2008-06-13,336000,181000,1025,176.58536585365854
"20 PINE STREET, 1711",2010-02-25,883841,2017-03-24,1340000,456159,2584,176.53212074303406
"310 WEST 52ND   STREET, 21H",2007-03-09,1608835,2012-02-02,1925000,316165,1791,176.52987158012283
"447 WEST 18TH   STREET, PH11A",2008-10-31,3610000,2013-05-01,3900000,290000,1643,176.50639074863057
"159 WEST 53RD STREET, 23H",2013-09-12,999990,2016-05-31,1175000,175010,992,176.42137096774192
"505 WEST 47TH   STREET, 6G-S",2011-07-22,999000,2017-10-12,1400000,401000,2274,176.34124890061565
"21 LUDLOW STREET, 8B",2010-02-12,590000,2017-07-27,1070000,480000,2722,176.3409257898604
"15 BROAD STREET, 2930",2007-03-08,804417,2012-07-19,1150000,345583,1960,176.31785714285715
"52 EAST END AVENUE, 25B",2006-07-17,1150000,2014-07-16,1665000,515000,2921,176.30948305374872
"111 CENTRAL PARK NORTH, 6A",2008-08-18,2240150,2016-07-19,2750000,509850,2892,176.2966804979253
"84 BEDFORD STREET, 1S",2012-08-24,1020250,2017-05-19,1325000,304750,1729,176.25795257374205
"630 1 AVENUE, 15D",2010-09-27,964000,2013-12-09,1170000,206000,1169,176.21899059024807
"106 CENTRAL PARK SOUTH, 14K",2012-09-05,585000,2014-07-18,705000,120000,681,176.21145374449338
"15 BROAD STREET, 2624",2007-01-16,845147,2010-08-13,1075000,229853,1305,176.13256704980842
"458 WEST 146 STREET, 1N",2006-12-01,891223,2016-05-20,1499999,608776,3458,176.04858299595142
"55 WHITE STREET, 4A",2004-08-12,565000,2007-12-17,780000,215000,1222,175.94108019639935
"260 PARK AVENUE SOUTH, 5E",2006-04-12,906242,2017-04-24,1615250,709008,4030,175.93250620347393
"80 RIVERSIDE BOULEVARD, 3R",2009-11-18,926607,2013-01-18,1130000,203393,1157,175.79343128781332
"220 RIVERSIDE BOULEVARD, 6V",2013-05-17,850000,2015-08-20,995000,145000,825,175.75757575757575
"353 WEST 56TH   STREET, 3G",2013-12-16,500000,2016-05-05,653000,153000,871,175.6601607347876
"137 DUANE STREET, 4C",2008-07-09,743322,2011-09-23,949000,205678,1171,175.64304013663536
"250 WEST 88TH STREET, 803",2005-05-05,1075000,2017-09-26,1870000,795000,4527,175.6129887342611
"392 CENTRAL PARK WEST, 5Y",2012-03-14,522500,2017-02-24,840000,317500,1808,175.608407079646
"125 WEST 22ND STREET, 3A",2008-04-29,941881,2016-08-08,1472500,530619,3023,175.52729077075753
"88 GREENWICH STREET, 2701",2014-01-08,950000,2016-05-12,1100000,150000,855,175.43859649122808
"175 WEST 12TH STREET, 20C",2007-04-18,1252447,2017-04-03,1890000,637553,3638,175.2482133040132
"400 EAST 51ST   STREET, 4A",2007-03-28,950000,2014-04-08,1400000,450000,2568,175.2336448598131
"251 WEST 123 STREET, 4",2003-03-06,278884,2013-03-06,919000,640116,3653,175.2302217355598
"325 FIFTH AVENUE, 34E",2010-11-29,1160000,2017-01-31,1555000,395000,2255,175.16629711751662
"150 WEST 51ST   STREET, 41239",2004-12-06,450000,2007-07-06,615000,165000,942,175.15923566878982
"99 JOHN STREET, 608",2011-04-27,570000,2016-06-14,898000,328000,1875,174.93333333333334
"240 EAST 46 STREET, 3C",2004-12-22,300000,2006-08-03,403000,103000,589,174.87266553480475
"90 WILLIAM STREET, 12H",2009-10-28,700000,2016-05-26,1120000,420000,2402,174.85428809325563
"25 CENTRAL PARK WEST, 11S",2003-01-27,815000,2004-03-31,890000,75000,429,174.82517482517483
"1601 3 AVENUE, 10H",2003-02-20,383292,2018-07-26,1368000,984708,5635,174.74853593611357
"415 MAIN STREET, 4-H",2010-01-19,635000,2016-07-21,1050000,415000,2375,174.73684210526315
"505 GREENWICH STREET, 9F",2005-02-02,702592,2017-04-27,1483000,780408,4467,174.70517125587642
"2000 BROADWAY, PH1C",2011-07-13,3000000,2013-02-05,3100000,100000,573,174.52006980802793
"301 EAST 79TH   STREET, 33 M",2010-02-03,620000,2015-04-09,950000,330000,1891,174.51084082496033
"309 EAST 49TH STREET, 8C",2015-09-21,888000,2018-08-28,1075000,187000,1072,174.4402985074627
"779 RIVERSIDE DRIVE, B-20",2014-08-11,417905,2015-10-27,495000,77095,442,174.42307692307693
"515 PARK AVENUE, 5A",2006-03-31,6700000,2010-12-15,7000000,300000,1720,174.41860465116278
"1623 3 AVENUE, 8H",2003-02-20,378325,2012-08-01,980000,601675,3450,174.3985507246377
"115 MERCER STREET, 3A",2007-10-03,2978381,2012-05-30,3275000,296619,1701,174.37918871252205
"15 BROAD STREET, 3408",2006-09-22,1756481,2014-07-21,2255000,498519,2859,174.36831059811124
"1619 3 AVENUE, 20K",2003-02-20,458888,2009-10-30,885000,426112,2444,174.35024549918168
"99 JANE STREET, 4A",2004-07-23,1367500,2010-12-17,1775000,407500,2338,174.29426860564584
"15 BROAD STREET, 1702",2006-08-16,570220,2016-04-13,1185000,614780,3528,174.25736961451247
"130 WEST 20TH   STREET, 7C",2009-05-29,990757,2015-02-23,1356000,365243,2096,174.2571564885496
"1619 3 AVENUE, 23F",2003-02-20,414169,2014-08-15,1145000,730831,4194,174.25631855030997
"15 BROAD STREET, 3430",2007-01-17,1425550,2012-12-05,1800000,374450,2149,174.24383434155422
"51 WALKER STREET, 7B",2007-01-05,2138325,2013-06-25,2550000,411675,2363,174.21709691070672
"58 WEST 129 STREET, 4C",2015-07-27,430950,2018-01-25,590000,159050,913,174.20591456736034
"45 PARK AVENUE, 504",2007-12-18,1069162,2015-12-01,1575000,505838,2905,174.12667814113598
"677 WASHINGTON STREET, 6C",2003-06-19,565000,2013-06-13,1200000,635000,3647,174.11571154373456
"25 FIFTH AVENUE, 12G",2008-02-29,1277903,2016-05-16,1800000,522097,2999,174.09036345448482
"252 SEVENTH AVENUE, 12Z",2004-08-02,805000,2007-07-30,995000,190000,1092,173.99267399267399
"201 WEST 74TH STREET, 15J",2010-02-09,780000,2018-05-04,1303000,523000,3006,173.9853626081171
"220 EAST 65 STREET, 10E",2004-10-14,275000,2005-06-01,315000,40000,230,173.91304347826087
"199 BOWERY, 7A",2006-05-11,768778,2017-01-31,1450000,681222,3918,173.8698315467075
"250 EAST 53RD STREET, 2204",2008-02-28,2606397,2016-09-20,3150000,543603,3127,173.84170131116085
"515 EAST 72ND   STREET, 30G",2009-08-31,1354272,2017-07-21,1855000,500728,2881,173.80354043734815
"101 WARREN STREET, 5H",2008-04-07,3008623,2018-07-12,3660000,651377,3748,173.79322305229456
"2000 BROADWAY, 7G",2015-09-08,1025000,2017-12-21,1170000,145000,835,173.65269461077844
"240 EAST 46TH   STREET, 8G",2012-03-16,565000,2015-09-04,785000,220000,1267,173.63851617995263
"200 CHAMBERS STREET, 6N",2007-04-04,872640,2015-07-29,1400000,527360,3038,173.58788676761026
"372 CENTRAL PARK WEST, 3U",2003-07-29,295000,2004-11-01,375000,80000,461,173.53579175704988
"1400 5 AVENUE, 8J",2011-03-18,532000,2017-02-21,908000,376000,2167,173.51176742039686
"325 FIFTH AVENUE, 31D",2007-01-23,1527375,2009-10-14,1700000,172625,995,173.4924623115578
"127 MADISON AVENUE, 3",2008-06-26,1629200,2017-04-27,2189000,559800,3227,173.47381468856523
"581 ACADEMY STREET, GLA",2005-03-18,265000,2007-08-17,418000,153000,882,173.46938775510205
"177 EAST 77TH   STREET, 8B",2008-07-29,989000,2013-09-06,1312500,323500,1865,173.45844504021449
"20 WEST 64TH STREET, 35M",2011-08-25,990000,2016-09-12,1310000,320000,1845,173.44173441734418
"200 WEST 109 STREET, D5",2005-06-30,740000,2014-04-28,1299000,559000,3224,173.38709677419354
"295 GREENWICH STREET, 3LN",2005-03-08,690000,2008-08-28,910000,220000,1269,173.36485421591806
"1600 BROADWAY, 7C",2006-05-24,1344090,2013-08-05,1800000,455910,2630,173.34980988593156
"130 WEST 19TH   STREET, 7D",2007-09-20,1578287,2014-05-13,1999000,420713,2427,173.34693036670788
"255 HUDSON STREET, PHE",2006-11-27,2545625,2017-03-29,3200000,654375,3775,173.34437086092714
"15 CHARLES STREET, 8B",2003-07-17,560000,2010-11-11,1023350,463350,2674,173.27973074046372
"350 WEST 42ND STREET, 39B",2006-09-12,1471371,2014-06-03,1960000,488629,2821,173.21127259836936
"80 RIVERSIDE BOULEVARD, 28A",2009-11-19,3192213,2017-02-13,3650000,457787,2643,173.207340143776
"260 PARK AVENUE SOUTH, 4E",2006-03-31,896060,2014-03-20,1400000,503940,2911,173.1157677773961
"101 WARREN STREET, 1030",2008-10-22,1344090,2014-01-16,1675000,330910,1912,173.07008368200837
"350 WEST 42ND STREET, 47H",2006-09-26,837510,2015-08-21,1400000,562490,3251,173.02060904337128
"130 WEST 79TH STREET, 10A",2004-09-07,650000,2007-09-05,839000,189000,1093,172.91857273559012
"362 ST NICHOLAS AVENUE, 9A",2012-03-06,463220,2017-11-09,821800,358580,2074,172.89296046287367
"104 CHARLTON STREET, 6E",2003-12-10,1272813,2018-07-18,2195000,922187,5334,172.88845144356955
"845 UNITED NATIONS PLAZA, 18H",2004-09-07,1329000,2014-07-09,1950000,621000,3592,172.88418708240533
"170 EAST END AVENUE, 2L",2008-03-31,1508236,2014-11-06,1925000,416764,2411,172.8593944421402
"144 COLUMBUS AVENUE, 8D",2005-07-11,2395000,2013-07-11,2900000,505000,2922,172.8268309377139
"100 UNITED NATIONS PLAZA, 12A",2003-12-23,970000,2017-12-01,1850000,880000,5092,172.82010997643363
"315 SEVENTH AVENUE, 10B",2011-09-07,770000,2014-01-22,920000,150000,868,172.8110599078341
"140 WEST 23RD   STREET, D2",2011-06-30,665000,2016-04-29,970000,305000,1765,172.80453257790367
"25 MURRAY STREET, 2G",2008-07-23,1400093,2017-12-27,1995000,594907,3444,172.73722415795586
"20 RENWICK STREET, 7",2003-01-09,352745,2007-09-26,650000,297255,1721,172.7222545031958
"50 FRANKLIN STREET, 10E",2010-07-15,874676,2016-10-20,1270000,395324,2289,172.7059851463521
"299 WEST 12TH   STREET, 17K",2007-04-30,1612500,2010-04-20,1800000,187500,1086,172.65193370165747
"25 CENTRAL PARK WEST, 3G",2004-08-06,630000,2013-09-12,1203800,573800,3324,172.62334536702767
"50 FRANKLIN STREET, 9B",2010-11-04,616041,2013-09-06,795000,178959,1037,172.5737704918033
"344 WEST 23RD STREET, 4A",2009-10-28,941000,2017-04-07,1410000,469000,2718,172.5533480500368
"1619 3 AVENUE, 7K",2003-02-20,402104,2014-08-12,1125000,722896,4191,172.48771176330231
"505 WEST 47TH   STREET, 1G-S",2009-10-16,1119056,2015-11-03,1500000,380944,2209,172.45088275237663
"325-33 EAST 45 STREET, 24A",2003-04-11,345000,2003-10-31,380000,35000,203,172.41379310344828
"117 EAST 57TH   STREET, 48G",2013-02-06,990000,2016-06-08,1200000,210000,1218,172.41379310344828
"275 GREENWICH STREET, 6GS",2011-06-14,750000,2018-01-16,1165000,415000,2408,172.3421926910299
"210 WEST 19TH   STREET, 1F",2007-04-02,1359000,2013-08-15,1760000,401000,2327,172.3248818220885
"502 PARK AVENUE, 11K",2004-11-04,712775,2017-03-29,1493000,780225,4528,172.31117491166077
"475 GREENWICH STREET, 4A",2008-07-01,2438708,2010-08-02,2570000,131292,762,172.29921259842519
"393 WEST 49 STREET, 2O",2003-08-19,270738,2006-10-19,470000,199262,1157,172.22299049265342
"322 WEST 57TH   STREET, 17E",2011-06-21,529490,2017-02-16,885000,355510,2067,171.9932268988873
"635 WEST 42ND STREET, 36K",2007-06-26,1349181,2013-11-12,1750000,400819,2331,171.95152295152295
"240 RIVERSIDE BOULEVARD, 14 OT",2006-03-27,1097250,2017-06-05,1800000,702750,4088,171.90557729941293
"200 CHAMBERS STREET, 19G",2007-05-17,1858306,2013-03-20,2225000,366694,2134,171.83411433926898
"20 WEST 64TH   STREET, 41-M",2007-03-09,700000,2016-09-30,1300000,600000,3493,171.7721156598912
"270 WEST 19TH   STREET, 3B",2014-05-29,1825000,2017-12-29,2050000,225000,1310,171.75572519083968
"392 CENTRAL PARK WEST, 14R",2007-01-11,1075000,2010-07-30,1297500,222500,1296,171.6820987654321
"40 SUTTON PLACE, 6B",2013-04-17,355000,2015-08-10,500000,145000,845,171.5976331360947
"200 EAST 66TH   STREET, B0901",2013-07-01,4285000,2018-02-15,4575000,290000,1690,171.5976331360947
"90 WILLIAM STREET, 5G",2008-07-02,843111,2015-12-14,1310000,466889,2721,171.5872840867328
"20 PINE STREET, 2011",2013-08-26,620000,2015-11-20,760000,140000,816,171.5686274509804
"135 EAST 54 STREET, 4N",2003-07-09,220000,2006-02-28,385500,165500,965,171.50259067357513
"315 7 AVENUE, 9B",2010-05-21,650000,2018-07-12,1160000,510000,2974,171.4862138533961
"57 WEST 58TH STREET, 7G",2009-04-20,625000,2013-03-19,870000,245000,1429,171.44856543037088
"300 ALBANY STREET, 5M",2003-09-10,229000,2004-09-29,295000,66000,385,171.42857142857142
"200 RIVERSIDE BOULEVARD, 14D",2006-04-10,2000000,2013-06-17,2450000,450000,2625,171.42857142857142
"425 5 AVENUE, 48E",2004-03-08,997885,2014-04-14,1630000,632115,3689,171.35131471943617
"230 RIVERSIDE DRIVE, 8L",2006-11-15,405600,2018-05-15,1125000,719400,4199,171.32650631102644
"120 RIVERSIDE BOULEVARD, PH2K",2006-06-29,1486645,2015-07-01,2050000,563355,3289,171.28458498023716
"350 WEST 42ND   STREET, 17A",2009-11-04,810000,2016-06-24,1225000,415000,2424,171.2046204620462
"21 SOUTH END AVENUE, 523",2004-03-01,398000,2006-12-01,570000,172000,1005,171.14427860696517
"2628 BROADWAY, 4C",2007-10-12,1216808,2016-09-16,1775000,558192,3262,171.11955855303495
"80 RIVERSIDE BOULEVARD, 22A",2011-06-02,3021611,2018-06-01,3458906,437295,2556,171.0856807511737
"45 PARK AVENUE, 806",2007-11-05,1013158,2014-10-09,1445915,432757,2530,171.0501976284585
"380 RECTOR PLACE, 2M",2012-02-14,902000,2018-06-29,1300000,398000,2327,171.03566824237214
"450 EAST 83RD STREET, 22B",2007-03-02,3024202,2014-09-15,3495000,470798,2754,170.9506172839506
"468 WEST 23RD STREET, 5A",2004-12-03,813581,2014-02-26,1390000,576419,3372,170.94276393831555
"2360 AMSTERDAM AVENUE, PH1",2011-04-05,468215,2015-04-17,720000,251785,1473,170.9334691106585
"144 COLUMBUS AVENUE, 26E",2003-05-09,725000,2015-10-07,1500000,775000,4534,170.9307454786061
"330 EAST 38TH   STREET, 23E",2007-12-20,1140440,2016-03-18,1655000,514560,3011,170.8933909000332
"10 WEST END AVENUE, 22B",2007-10-17,1692715,2018-06-27,2360000,667285,3906,170.83589349718383
"93 WORTH STREET, 406",2014-01-29,763688,2016-08-31,925000,161312,945,170.7005291005291
"400 FIFTH AVENUE, 43F",2012-11-05,1731025,2017-07-10,2022500,291475,1708,170.65281030444964
"252 WEST 123 STREET, GARD1",2010-09-20,670000,2017-05-01,1082000,412000,2415,170.60041407867496
"450 WEST 17TH STREET, 1017",2008-09-19,3334768,2011-05-16,3500000,165232,969,170.51805985552116
"40 WEST 116 STREET, A609",2009-02-20,610000,2015-01-30,980000,370000,2170,170.50691244239633
"350 WEST 42ND   STREET, 45G",2007-02-14,1272812,2009-11-20,1445000,172188,1010,170.4831683168317
"80 RIVERSIDE BOULEVARD, 6T",2010-01-21,967337,2015-07-24,1310000,342663,2010,170.47910447761194
"10 WEST END AVENUE, 17C",2007-08-28,1704316,2014-12-22,2160000,455684,2673,170.47661803217358
"1601 3 AVENUE, 17H",2003-02-20,410620,2010-12-02,895000,484380,2842,170.43631245601688
"2098 FREDRICK DOUGLASS BL, 2D",2013-05-22,515000,2018-02-16,810000,295000,1731,170.42172154823803
"415 EAST 37TH STREET, 10L",2012-09-24,565025,2016-06-28,799000,233975,1373,170.41150764748724
"92 PERRY STREET, 3",2013-04-18,810000,2016-02-09,985000,175000,1027,170.39922103213243
"845 UNITED NATIONS PLAZA, 11B",2005-05-23,1200000,2007-12-18,1360000,160000,939,170.3940362087327
"845 UNITED NATIONS PLAZA, 25F",2003-02-07,468975,2007-08-15,750000,281025,1650,170.3181818181818
"11 EAST 29TH   STREET, 41B",2008-07-30,1593561,2015-01-12,1995000,401439,2357,170.3177768349597
"418 CENTRAL PARK WEST, 22",2003-01-22,400000,2014-12-15,1140000,740000,4345,170.31070195627157
"120 RIVERSIDE BOULEVARD, 6D",2005-12-19,341800,2012-02-17,725000,383200,2251,170.23545091070636
"29 KING STREET, 4H",2005-03-29,995000,2012-07-23,1450000,455000,2673,170.22072577628134
"444 WEST 19TH STREET, 605",2006-07-10,1120000,2011-01-10,1400000,280000,1645,170.2127659574468
"2628 BROADWAY, 3C",2007-10-02,1109892,2014-01-10,1500000,390108,2292,170.2041884816754
"11 EAST 29TH   STREET, 45B",2008-05-27,1496827,2011-07-12,1691000,194173,1141,170.17791411042944
"505 GREENWICH STREET, 7H",2004-12-17,1921437,2010-04-01,2250000,328563,1931,170.15173485240808
"350 WEST 42ND STREET, 48D",2007-05-09,1575000,2014-03-11,2000000,425000,2498,170.13610888710969
"170 EAST 87TH STREET, W6H",2007-03-22,1075000,2014-07-11,1528800,453800,2668,170.08995502248877
"200 RECTOR PLACE, 18M",2015-08-18,565000,2017-10-20,700000,135000,794,170.02518891687657
"135 WEST 70TH STREET, 2K",2010-04-01,1500000,2018-03-22,1995000,495000,2912,169.98626373626374
"280 PARK AVENUE SOUTH, 11M",2004-02-20,700000,2017-01-09,1500000,800000,4707,169.95963458678563
"1 MORTON SQUARE, 12E W",2004-12-10,1461188,2012-01-05,1900000,438812,2582,169.95042602633617
"186 WEST 80 STREET, 8H",2004-02-09,280000,2006-03-15,410000,130000,765,169.9346405228758
"222 RIVERSIDE DRIVE, 3E",2003-05-23,412500,2008-01-03,699000,286500,1686,169.9288256227758
"249 EAST 118 STREET, 7B",2009-12-14,456300,2016-09-12,875000,418700,2464,169.92694805194805
"411 EAST 53RD STREET, 3G",2006-12-29,250000,2017-08-31,912000,662000,3898,169.8306824012314
"236 EAST 47TH STREET, 12C",2009-08-26,805000,2017-05-11,1283000,478000,2815,169.80461811722913
"1641 3 AVENUE, 13F",2003-02-20,378679,2010-09-27,850000,471321,2776,169.7842219020173
"395 BROADWAY, 15C",2007-04-24,1295000,2017-11-15,1950000,655000,3858,169.77708657335407
"243 WEST 60TH STREET, 4E",2010-08-25,1330000,2013-07-03,1507010,177010,1043,169.712368168744
"420 WEST 25TH   STREET, 5C",2008-03-07,1247356,2014-09-05,1650000,402644,2373,169.67720185419302
"330 EAST 38 STREET, 31C",2003-06-10,495000,2008-12-04,835000,340000,2004,169.66067864271457
"307 CANAL STREET, 4S",2008-02-05,1425550,2014-12-12,1850000,424450,2502,169.64428457234212
"1049 5 AVENUE, 12C",2005-01-27,3080000,2013-06-21,3600000,520000,3067,169.54678839256601
"261 WEST 28TH STREET, 8E",2007-12-05,1466280,2015-06-02,1930000,463720,2736,169.48830409356725
"42 WEST 120 STREET, 4C",2013-09-13,288750,2016-09-16,475000,186250,1099,169.4722474977252
"40 BROAD STREET, 25G",2011-06-16,692207,2017-04-26,1055000,362793,2141,169.45025688930406
"145 EAST 48TH   STREET, 18C",2009-06-24,555000,2012-05-22,735000,180000,1063,169.33207902163687
"301 EAST 79 STREET, 6 F",2004-09-23,482000,2006-11-30,617000,135000,798,169.17293233082708
"39 EAST 29TH STREET, 16D",2008-09-16,1028432,2015-06-15,1445000,416568,2463,169.13032886723508
"330 EAST 38TH   STREET, 11L",2010-10-13,950000,2014-10-31,1200000,250000,1479,169.03313049357675
"252 SEVENTH AVENUE, 3M",2007-01-17,1050000,2015-04-23,1560000,510000,3018,168.98608349900596
"170 EAST 77TH   STREET, 6E",2009-07-08,746116,2013-02-22,970000,223884,1325,168.9690566037736
"182 MULBERRY STREET, 4",2003-12-16,914389,2013-07-12,1505000,590611,3496,168.93907322654462
"505 GREENWICH STREET, 1B",2005-04-15,1013158,2011-05-26,1390000,376842,2232,168.83602150537635
"199 BOWERY, 8E/8F",2006-11-02,1094618,2017-04-21,1740000,645382,3823,168.81558985090243
"11 WEST 131 STREET, C1",2007-11-30,743322,2018-07-26,1399999,656677,3891,168.76818298637883
"250 EAST 54 STREET, 11B",2003-04-29,267000,2005-12-20,430000,163000,966,168.73706004140786
"120 RIVERSIDE BOULEVARD, 8F",2006-01-04,952104,2014-10-01,1490000,537896,3192,168.51378446115288
"45 PARK AVENUE, 201",2007-10-17,1151131,2013-08-16,1510000,358869,2130,168.4830985915493
"1600 BROADWAY, 14C",2006-10-25,1476462,2015-04-17,1998000,521538,3096,168.45542635658916
"80 ELIZABETH STREET, 2F",2003-05-22,260000,2012-11-23,845000,585000,3473,168.4422689317593
"220 WEST 15 STREET, 3-B",2003-03-11,515000,2004-06-28,595000,80000,475,168.42105263157896
"143 AVENUE B, 9E",2004-04-27,234239,2011-07-27,680000,445761,2647,168.40234227427277
"250 EAST 54TH STREET, 9E",2004-09-10,368000,2007-08-21,549000,181000,1075,168.37209302325581
"111 FULTON STREET, 610",2010-05-17,595676,2014-01-10,820280,224604,1334,168.3688155922039
"350 ALBANY STREET, 3J",2014-07-18,590000,2018-05-15,825000,235000,1397,168.21760916249104
"250 EAST 53RD STREET, 3301",2008-06-04,2100653,2016-07-21,2600000,499347,2969,168.18693162681038
"199 BOWERY, 11A",2006-05-24,926607,2016-07-18,1550000,623393,3708,168.12108953613807
"249 EAST 118 STREET, 7A",2010-07-01,317356,2015-03-04,604250,286894,1707,168.06912712360867
"159 WEST 53RD   STREET, 18G",2009-10-09,590000,2010-06-04,630000,40000,238,168.0672268907563
"80 RIVERSIDE BOULEVARD, 10N",2010-04-08,1574614,2017-08-09,2025000,450386,2680,168.05447761194029
"310 WEST 52ND   STREET, 3D",2007-08-28,1061525,2017-03-30,1650000,588475,3502,168.03969160479727
"253 WEST 73RD STREET, 11H",2004-11-08,1175000,2015-11-09,1850000,675000,4018,167.9940268790443
"77 8 AVENUE, 501",2005-02-24,4734862,2015-12-30,5400000,665138,3961,167.9217369351174
"1965 BROADWAY, 23K",2004-02-24,730000,2010-05-06,1110000,380000,2263,167.91869200176757
"4 MORTON SQUARE, 4 MS",2011-05-05,7000000,2015-06-02,7250000,250000,1489,167.897918065816
"1 MORTON SQUARE, 2C W",2004-10-14,1629200,2012-11-14,2125000,495800,2953,167.89705384354895
"1601 3 AVENUE, 24K",2003-02-20,440431,2014-06-19,1135000,694569,4137,167.891950688905
"261 WEST 28TH STREET, 4B",2007-12-12,1578287,2015-03-27,2025000,446713,2662,167.81104432757326
"140 EAST 56TH   STREET, 16G",2010-07-13,590000,2015-05-06,885000,295000,1758,167.80432309442548
"188 EAST 76TH STREET, 26B",2007-08-01,3050000,2016-07-22,3600000,550000,3278,167.78523489932886
"1438 3 AVENUE, 17E",2009-09-03,2000000,2018-03-29,2525000,525000,3129,167.78523489932886
"1235 PARK AVENUE, 1A",2003-03-05,970000,2010-07-08,1420000,450000,2682,167.78523489932886
"106 CENTRAL PARK SOUTH, 7L",2005-12-01,625000,2008-01-15,755000,130000,775,167.74193548387098
"416 EAST 117TH STREET, 1A",2010-12-01,534581,2015-06-12,812000,277419,1654,167.7261185006046
"263 9 AVENUE, 6A",2006-05-30,1272812,2017-06-20,1950000,677188,4039,167.66229264669474
"269 BROADWAY, 15D",2004-09-08,1318633,2007-01-29,1465000,146367,873,167.659793814433
"130 WEST 30TH STREET, 5A",2007-08-13,1575000,2014-07-22,2000000,425000,2535,167.65285996055226
"252 7 AVENUE, 7L",2003-10-20,755000,2013-02-11,1325000,570000,3402,167.5485008818342
"165 CHARLES STREET, RU12",2006-07-21,5677966,2013-06-13,6100000,422034,2519,167.540293767368
"10 WEST END AVENUE, 18C",2008-03-13,1781937,2015-01-16,2200000,418063,2500,167.2252
"415 EAST 54TH STREET, 29D",2005-07-15,1890000,2017-02-28,2600000,710000,4246,167.21620348563354
"300 EAST 23RD   STREET, 14B",2012-07-18,2825000,2017-11-13,3150000,325000,1944,167.18106995884773
"15 BROAD STREET, 1706",2006-06-20,651680,2017-09-28,1340000,688320,4118,167.14910150558524
"502 PARK AVENUE, 17B",2005-01-13,1425550,2016-02-01,2100000,674450,4036,167.10852329038653
"295 GREENWICH STREET, 5GN",2014-08-08,1107000,2017-10-06,1300000,193000,1155,167.0995670995671
"225 EAST 86TH STREET, 304",2012-10-05,530000,2015-09-18,710000,180000,1078,166.97588126159556
"11 EAST 29TH   STREET, 40B",2008-05-01,1649565,2013-10-31,1985000,335435,2009,166.96615231458438
"200 WEST END AVENUE, 5H",2007-12-19,1552831,2017-10-05,2150000,597169,3578,166.900223588597
"230 RIVERSIDE DRIVE, 17O",2008-06-30,187000,2016-11-15,697501,510501,3060,166.83039215686276
"50 FRANKLIN STREET, 16A",2011-03-11,1547740,2012-11-13,1650000,102260,613,166.8189233278956
"225 5 AVENUE, 8B",2007-05-11,1491736,2011-03-10,1725000,233264,1399,166.73624017155112
"186 WEST 80TH   STREET, 10C",2009-05-14,610000,2017-01-31,1080000,470000,2819,166.7257892869812
"425 5 AVENUE, 26D",2003-12-29,554946,2015-03-20,1238000,683054,4099,166.6391802878751
"1280 5 AVENUE, 15D",2013-08-21,1807393,2017-08-17,2050000,242607,1457,166.51132463967056
"159 WEST 53RD STREET, 15A",2014-06-11,595000,2016-12-22,749000,154000,925,166.48648648648648
"10 WEST END AVENUE, 10K",2007-07-27,1288086,2013-07-09,1650000,361914,2174,166.47378104875804
"400 EAST 70TH STREET, 2001",2004-12-28,680000,2008-01-29,867501,187501,1127,166.3717834960071
"392 CENTRAL PARK WEST, 4S",2003-10-16,285000,2008-02-04,546500,261500,1572,166.34860050890586
"30 LITTLE WEST STREET, 24D",2014-05-21,925000,2017-03-08,1095000,170000,1022,166.34050880626222
"1991 BROADWAY, 21B",2012-12-20,870000,2014-04-15,950000,80000,481,166.32016632016632
"333 EAST 34TH   STREET, 5E",2007-01-25,380000,2016-07-15,955000,575000,3459,166.2330153223475
"422 EAST 72ND STREET, 7A",2004-07-09,1665000,2011-09-08,2100000,435000,2617,166.2208635842568
"165 EAST 104 STREET, 2C",2014-10-28,268000,2016-10-31,390000,122000,734,166.2125340599455
"25 CENTRAL PARK WEST, 12H",2003-11-10,580403,2015-04-20,1275000,694597,4179,166.2112945680785
"15 BROAD STREET, 1102",2006-08-04,519307,2014-06-30,999000,479693,2887,166.15621752684447
"48 WEST 138 STREET, 2K",2014-02-28,258570,2017-11-22,485000,226430,1363,166.1261922230374
"99 JOHN STREET, 1408",2012-02-03,825000,2017-03-30,1137500,312500,1882,166.04675876726887
"63 DOWNING STREET, 7D",2007-03-21,925000,2017-01-11,1520000,595000,3584,166.015625
"400 CENTRAL PARK WEST, 10T",2003-04-03,316368,2006-07-31,518000,201632,1215,165.9522633744856
"15 BROAD STREET, 2326",2007-04-24,855330,2010-06-10,1045000,189670,1143,165.94050743657044
"270 WEST 19TH STREET, 1B",2005-11-17,1522283,2012-07-11,1925000,402717,2428,165.8636738056013
"250 EAST 49TH   STREET, 10A",2010-11-23,692410,2015-12-22,999999,307589,1855,165.81617250673855
"170 EAST 87 STREET, E16H",2004-05-19,739000,2008-06-11,985000,246000,1484,165.76819407008085
"1641 3 AVENUE, 14F",2003-02-20,381519,2018-08-22,1320000,938481,5662,165.7507947721653
"368 WEST 117 STREET, 1E",2005-01-14,163442,2014-07-07,737000,573558,3461,165.72031204854088
"222 WEST 14TH STREET, 3N",2010-12-09,780000,2018-04-17,1225000,445000,2686,165.67386448250187
"163 WEST 18TH   STREET, 11B",2011-12-08,2150000,2016-01-26,2400000,250000,1510,165.56291390728478
"247 WEST 46TH   STREET, 308",2008-10-21,722957,2015-01-16,1100000,377043,2278,165.51492537313433
"20 WEST STREET, 4G",2008-07-16,725000,2015-07-28,1150000,425000,2568,165.49844236760126
"58 WEST 58 STREET, 7A",2003-01-31,500000,2016-04-21,1299000,799000,4829,165.45868709877823
"203 WEST 90TH STREET, 9C",2006-11-06,1999000,2016-12-16,2610036,611036,3693,165.45789331167072
"40 EAST 94TH STREET, 23F",2006-08-07,1920000,2016-03-01,2498000,578000,3494,165.42644533485975
"825 WEST END AVENUE, 1-I",2009-03-18,78000,2014-07-11,399000,321000,1941,165.3786707882535
"100 RIVERSIDE BOULEVARD, 5S",2008-02-06,1349690,2014-09-23,1750000,400310,2421,165.3490293267245
"100 UNITED NATIONS PLAZA, 36C",2004-06-16,999000,2014-05-01,1595000,596000,3606,165.28008874098725
"240 EAST 47TH   STREET, 16F",2011-05-26,1035000,2014-12-17,1250000,215000,1301,165.2574942352037
"5 EAST 22ND   STREET, 24-D",2007-04-24,1750000,2013-12-09,2150000,400000,2421,165.22098306484924
"25 MURRAY STREET, 4H",2008-07-03,1669930,2012-02-10,1887500,217570,1317,165.20121488230828
"2109 BROADWAY, 14143",2012-05-25,375000,2016-02-16,600000,225000,1362,165.19823788546256
"300 EAST 23RD   STREET, 14C",2013-06-10,2443800,2017-08-09,2695000,251200,1521,165.15450361604206
"88 GREENWICH STREET, 1111",2009-10-29,711756,2015-04-09,1040000,328244,1988,165.11267605633802
"240 EAST 46 STREET, 9G",2003-01-13,365000,2005-03-11,495000,130000,788,164.9746192893401
"350 WEST 42ND STREET, 18L",2006-07-05,1048797,2015-12-29,1620000,571203,3464,164.89693995381063
"215 EAST 81ST   STREET, 7E",2013-08-01,499902,2016-12-12,702500,202598,1229,164.84784377542718
"130 BARROW STREET, 309",2012-10-02,1250000,2016-04-04,1461000,211000,1280,164.84375
"41 SPRING STREET, 5A",2004-07-28,350000,2014-03-17,930000,580000,3519,164.81955100880933
"135 EAST 54TH   STREET, 8B",2007-02-20,850000,2013-08-14,1240000,390000,2367,164.765525982256
"109 READE STREET, F",2007-03-30,1500000,2013-11-21,1900000,400000,2428,164.74464579901152
"138 WEST 124TH STREET, 9B",2008-01-15,1593561,2016-11-14,2125000,531439,3226,164.73620582765034
"310 WEST 52ND   STREET, 10B",2007-02-14,1237173,2014-11-24,1705000,467827,2840,164.72781690140846
"63 WEST 17TH STREET, 4B",2007-08-29,1800000,2015-02-20,2250000,450000,2732,164.71449487554904
"5 EAST 22ND   STREET, 5-P",2007-10-09,999000,2014-06-09,1400000,401000,2435,164.6817248459959
"48 WEST 138 STREET, 6F",2013-12-27,192660,2016-03-31,328500,135840,825,164.65454545454546
"30 EAST 37TH   STREET, 2H",2007-02-20,179550,2011-01-20,415000,235450,1430,164.65034965034965
"199 BOWERY, 7D",2006-06-26,901151,2014-09-30,1398000,496849,3018,164.62856196156395
"350 WEST 50TH STREET, 31B",2009-08-24,1120000,2018-06-19,1650000,530000,3221,164.54517230673704
"372 CENTRAL PARK WEST, 16U",2006-06-09,548000,2007-09-20,625000,77000,468,164.52991452991452
"462 WEST 58TH STREET, 9C",2009-11-18,855000,2016-06-15,1250000,395000,2401,164.51478550603915
"150 NASSAU STREET, 8H",2003-05-15,741780,2014-04-28,1400000,658220,4001,164.51387153211698
"1600 BROADWAY, PH1A",2006-08-30,1114938,2014-07-28,1590000,475062,2889,164.43821391484943
"27 WEST 72ND   STREET, 507",2009-12-15,1495000,2017-07-13,1950000,455000,2767,164.438019515721
"327 CENTRAL PARK WEST, 12C",2004-04-01,687370,2011-02-14,1100000,412630,2510,164.39442231075697
"502 PARK AVENUE, 11A",2004-12-03,819691,2012-02-03,1250000,430309,2618,164.3655462184874
"116 WEST 22ND   STREET, 7",2007-02-09,1720842,2017-02-02,2320000,599158,3646,164.33296763576521
"206 EAST 95TH STREET, 14B",2013-06-17,910000,2014-10-17,990000,80000,487,164.2710472279261
"1485 FIFTH AVENUE, 20E",2011-05-19,1422666,2013-01-31,1525000,102334,623,164.26003210272873
"220 RIVERSIDE BOULEVARD, 15K",2010-01-11,1250000,2012-04-12,1385000,135000,822,164.23357664233578
"415 MAIN STREET, 1-B",2009-11-23,610000,2017-05-26,1060000,450000,2741,164.17365924844947
"100 UNITED NATIONS PLAZA, 18B",2005-01-11,1200000,2015-01-14,1800000,600000,3655,164.15868673050616
"250 EAST 53RD STREET, 904",2008-03-03,2555700,2018-07-02,3175000,619300,3773,164.1399416909621
"45 PARK AVENUE, 704",2007-10-12,1191352,2014-08-12,1601000,409648,2496,164.12179487179486
"117 EAST 57TH   STREET, 27H",2007-07-03,1300000,2012-09-04,1610000,310000,1890,164.02116402116403
"240 EAST 10TH STREET, 8C",2006-06-28,1850000,2013-06-27,2269000,419000,2556,163.9280125195618
"310 WEST 52ND   STREET, 15H",2007-03-15,1170987,2015-09-15,1680000,509013,3106,163.88055376690278
"1965 BROADWAY, 14F",2003-09-18,795000,2017-01-30,1595000,800000,4883,163.83370878558264
"400 EAST 67TH STREET, 5C",2011-10-03,1600000,2017-08-09,1950000,350000,2137,163.78100140383717
"11 EAST 29TH   STREET, 41C",2008-06-23,1405185,2014-10-14,1782500,377315,2304,163.76519097222223
"310 WEST 52ND   STREET, 4J",2012-10-15,1125000,2017-12-21,1435000,310000,1893,163.76122556788167
"2101 BROADWAY, 41131",2005-09-27,716500,2007-02-13,799000,82500,504,163.6904761904762
"15 BROAD STREET, 1206",2006-05-11,717866,2016-12-07,1350000,632134,3863,163.63810509966348
"400 EAST 70TH   STREET, 1201",2011-06-15,645000,2015-12-21,915000,270000,1650,163.63636363636363
"1760 2 AVENUE, 23A",2004-08-09,565000,2007-06-14,735000,170000,1039,163.61886429258902
"99 JOHN STREET, 1404",2010-04-20,698000,2016-12-12,1095000,397000,2428,163.50906095551895
"130 BARROW STREET, PH12",2005-12-07,2375000,2016-04-25,2995000,620000,3792,163.50210970464136
"167 EAST 82ND STREET, 5C",2010-09-17,935000,2018-07-02,1400000,465000,2845,163.44463971880492
"500 WEST 43 STREET, 29D",2003-10-31,272500,2008-03-12,533000,260500,1594,163.4253450439147
"350 WEST 50 STREET, 35H",2003-08-28,413980,2004-06-23,463000,49020,300,163.4
"279 CENTRAL PARK WEST, 15C",2006-03-01,2625000,2011-08-11,2950000,325000,1989,163.3986928104575
"16 WEST 19TH   STREET, 11-B",2008-02-27,1883762,2014-10-31,2282000,398238,2438,163.34618539786712
"15 BROAD STREET, 1830",2006-09-18,575311,2011-10-28,880000,304689,1866,163.28456591639872
"1623 3 AVENUE, 33F",2003-02-20,446821,2017-06-15,1300000,853179,5229,163.1629374641423
"155 PERRY STREET, 1D",2005-06-29,1740000,2015-09-24,2350000,610000,3739,163.14522599625568
"135 WEST 14TH   STREET, RES 6",2010-01-15,2220000,2012-03-22,2350000,130000,797,163.1116687578419
"519 WEST 135 STREET, 2B",2003-06-09,344760,2008-06-23,645000,300240,1841,163.08527973927212
"505 GREENWICH STREET, 10G",2005-03-08,641497,2013-05-21,1130000,488503,2996,163.05173564753005
"630 1 AVENUE, 11M",2003-02-11,535000,2016-12-19,1360000,825000,5060,163.04347826086956
"80 RIVERSIDE BOULEVARD, 6G",2010-03-26,1629200,2016-10-17,2020000,390800,2397,163.03712974551522
"15 BROAD STREET, 2506",2006-06-29,860421,2013-07-16,1280000,419579,2574,163.0066045066045
"200 WEST END AVENUE, 6M",2008-08-05,941881,2014-04-11,1280000,338119,2075,162.9489156626506
"310 WEST 52ND   STREET, 30A",2007-04-25,936790,2016-10-11,1500000,563210,3457,162.918715649407
"280 PARK AVENUE SOUTH, 24M",2003-08-27,700000,2015-06-03,1400000,700000,4298,162.86644951140065
"306 MOTT STREET, 5A",2004-01-09,465000,2008-07-24,735000,270000,1658,162.84680337756333
"99 JANE STREET, 3J",2004-05-12,1346000,2012-03-01,1810000,464000,2850,162.80701754385964
"120 RIVERSIDE BOULEVARD, 11A",2006-02-06,977520,2011-12-01,1323300,345780,2124,162.79661016949152
"300 WEST 135TH STREET, 2F",2005-06-03,387676,2018-03-02,1145000,757324,4655,162.690440386681
"200 EAST 89TH STREET, 33A",2010-07-19,1325000,2017-07-13,1740000,415000,2551,162.6813014504116
"1991 BROADWAY, 16A",2004-08-24,990000,2016-01-04,1665000,675000,4150,162.65060240963857
"200 WEST END AVENUE, 16H",2009-01-07,1056943,2013-08-13,1330000,273057,1679,162.63073257891602
"211 EAST 46TH   STREET, 24E",2009-09-15,641497,2015-07-29,990000,348503,2143,162.62389174055062
"350 WEST 42ND   STREET, 24F",2011-04-27,815000,2017-05-19,1175000,360000,2214,162.60162601626016
"163 WEST 18TH   STREET, 3A",2007-08-06,1608835,2016-12-05,2163100,554265,3409,162.58873569961867
"555 WEST 23RD STREET, N3Q",2010-06-25,585000,2015-05-14,875000,290000,1784,162.55605381165918
"40 BROAD STREET, 22E",2010-06-17,985000,2014-12-04,1250000,265000,1631,162.4770079705702
"209 EAST 51ST   STREET, 12B",2009-12-07,1349181,2017-11-13,1820000,470819,2898,162.46342305037956
"368 WEST 117 STREET, 1C",2004-09-24,144761,2015-07-10,785000,640239,3941,162.45597564070033
"475 GREENWICH STREET, 4C",2008-06-26,1016213,2017-01-23,1525000,508787,3133,162.39610596872006
"50 BAYARD STREET, 7D",2003-04-16,250000,2009-09-11,630000,380000,2340,162.39316239316238
"386 COLUMBUS AVENUE, 12A",2005-01-05,1525000,2013-01-08,2000000,475000,2925,162.39316239316238
"52 EAST END AVENUE, 11B",2004-03-12,505000,2007-01-23,675000,170000,1047,162.3686723973257
"225 EAST 34TH   STREET, 19G",2008-06-19,1155713,2016-10-20,1650000,494287,3045,162.32742200328408
"161 WEST 61ST STREET, 34H",2004-10-08,760000,2006-03-16,845000,85000,524,162.21374045801528
"40 MERCER STREET, 24",2007-05-23,2672906,2013-04-01,3020000,347094,2140,162.19345794392524
"100 WEST 58TH STREET, 15A",2009-06-29,675000,2011-08-09,800000,125000,771,162.12710765239947
"5 EAST 22ND   STREET, 23-F",2005-04-25,1150000,2013-04-02,1620000,470000,2899,162.12487064505
"500 WEST 43 STREET, 16D",2003-06-02,260000,2005-09-12,395000,135000,833,162.06482593037214
"211 EAST 51ST STREET, 7F",2011-06-15,977520,2016-01-22,1250000,272480,1682,161.99762187871582
"275 GREENWICH STREET, 10DS",2006-06-05,417000,2016-12-21,1041000,624000,3852,161.99376947040497
"252 7 AVENUE, 6K",2003-04-17,645000,2010-04-22,1060000,415000,2562,161.98282591725214
"42 EAST 20TH STREET, 6C",2005-04-27,1690000,2018-03-02,2450000,760000,4692,161.9778346121057
"392 CENTRAL PARK WEST, 8T",2004-06-29,355000,2006-08-10,480000,125000,772,161.91709844559585
"15 CHARLES STREET, 17B",2009-05-01,550000,2014-10-30,875000,325000,2008,161.85258964143426
"330 EAST 38TH STREET, 26E",2012-08-23,1400000,2018-06-25,1745000,345000,2132,161.81988742964353
"333 RECTOR PLACE, 307",2011-08-31,446160,2014-12-11,640000,193840,1198,161.80300500834724
"20 PINE STREET, 1111",2011-04-27,885000,2017-08-31,1260000,375000,2318,161.77739430543573
"220 EAST 65 STREET, 5E",2003-12-16,260000,2008-06-11,525000,265000,1639,161.68395363026235
"2628 BROADWAY, 24B",2008-07-31,2036500,2016-06-06,2500000,463500,2867,161.66724799441926
"188 EAST 64TH STREET, 1805",2010-09-28,647500,2016-05-16,980000,332500,2057,161.64316966456005
"265 WEST 122ND STREET, C",2009-07-10,860000,2018-06-01,1385000,525000,3248,161.63793103448276
"505 GREENWICH STREET, 4F",2006-06-26,950000,2017-06-30,1600000,650000,4022,161.6111387369468
"28 PERRY STREET, 4R",2009-07-13,560037,2015-05-18,905000,344963,2135,161.5751756440281
"247 WEST 46TH   STREET, 1403",2008-10-08,1792120,2017-05-18,2300000,507880,3144,161.53944020356235
"280 PARK AVENUE SOUTH, 2H",2004-09-01,728048,2016-06-29,1425600,697552,4319,161.5077564250984
"67 LIBERTY STREET, PHB",2014-04-30,957155,2015-08-25,1035000,77845,482,161.50414937759336
"251 WEST 123 STREET, 5",2003-03-18,299164,2013-12-27,935000,635836,3937,161.50266700533402
"100 UNITED NATIONS PLAZA, 47A",2005-05-03,1630000,2011-08-11,2000000,370000,2291,161.5015277171541
"303 GREENWICH STREET, 3G",2006-07-25,755000,2017-05-31,1395000,640000,3963,161.49381781478678
"21 SOUTH END AVENUE, 605",2014-06-24,850000,2016-11-07,990000,140000,867,161.47635524798156
"1641 THIRD AVENUE, 12A",2005-03-23,1030000,2016-08-02,1700000,670000,4150,161.44578313253012
"1965 BROADWAY, 29F",2004-01-05,765000,2013-02-13,1302000,537000,3327,161.40667267808837
"102 MADISON STREET, 2A",2008-09-18,105000,2014-01-22,420000,315000,1952,161.37295081967213
"81 WHITE STREET, 4E",2005-08-17,1893945,2014-08-07,2422681,528736,3277,161.3475740006103
"325 5 AVENUE, 12D",2010-07-07,999000,2013-12-04,1200000,201000,1246,161.31621187800963
"120 EAST 87TH   STREET, P8-H",2012-05-21,630000,2015-11-13,835000,205000,1271,161.29032258064515
"352 CATHEDRAL PARKWAY, 8A-N",2006-01-18,712775,2018-07-26,1450000,737225,4572,161.24781277340333
"1437 3 AVENUE, 15C",2006-06-13,1375000,2018-07-05,2085000,710000,4405,161.18047673098752
"38 STUYVESANT STREET, 9",2009-01-21,1250000,2014-06-30,1570000,320000,1986,161.12789526686808
"76 MADISON AVENUE, 9A",2007-09-27,3170100,2017-05-19,3737500,567400,3522,161.1016467915957
"255 WEST 92ND STREET, 4C",2012-11-16,612250,2017-09-20,897000,284750,1769,160.96664782362916
"211 EAST 46TH   STREET, 21H",2008-05-12,565525,2015-09-02,995000,429475,2669,160.91232671412513
"300 EAST 79TH STREET, 8B",2008-06-11,2112868,2016-04-22,2575000,462132,2872,160.90947075208913
"251 WEST 98TH STREET, 2A",2006-12-08,1400000,2015-06-12,1900000,500000,3108,160.87516087516087
"555 WEST 23RD STREET, N3N",2009-08-13,687000,2015-08-17,1040000,353000,2195,160.82004555808655
"300 WEST 138 STREET, 2575C",2003-11-12,340000,2007-09-05,564000,224000,1393,160.80402010050253
"211 EAST 46TH   STREET, 26E",2009-08-19,625205,2013-06-17,850000,224795,1398,160.7975679542203
"346 EAST 119 STREET, PHB",2011-06-13,490000,2017-08-10,851500,361500,2250,160.66666666666666
"50 WEST STREET, 55A",2017-05-03,3955901,2018-08-28,4033333,77432,482,160.64730290456433
"280 PARK AVENUE SOUTH, 23D",2008-01-25,945276,2015-09-25,1395000,449724,2800,160.6157142857143
"200 RIVERSIDE BOULEVARD, 19J",2006-12-29,1252000,2014-01-14,1665000,413000,2573,160.51301982122035
"100 CENTRAL PARK SOUTH, 9E",2014-11-18,694000,2017-03-02,828000,134000,835,160.47904191616766
"1619 3 AVENUE, 11A",2003-02-20,412040,2012-09-28,975000,562960,3508,160.478905359179
"502 PARK AVENUE, 14F",2004-11-03,990000,2009-09-14,1275000,285000,1776,160.47297297297297
"77 PARK AVENUE, 8H",2008-04-30,835000,2013-12-17,1165000,330000,2057,160.42780748663102
"160 CENTRAL PARK SOUTH, 1801",2006-02-21,1500000,2012-02-13,1850000,350000,2183,160.3298213467705
"310 WEST 52ND   STREET, 7C",2007-05-22,812818,2014-05-05,1220000,407182,2540,160.30787401574804
"2000 BROADWAY, 8I",2004-10-26,620000,2008-09-30,850000,230000,1435,160.2787456445993
"100 RIVERSIDE BOULEVARD, 28A",2008-08-15,1680112,2014-02-03,2000000,319888,1998,160.1041041041041
"475 GREENWICH STREET, 5C",2008-07-09,1028432,2016-12-14,1521500,493068,3080,160.087012987013
"70 BATTERY PLACE, 19D",2009-09-14,1680112,2015-03-06,2000000,319888,1999,160.024012006003
"479 WEST 152 STREET, 5C",2015-01-13,514216,2017-09-13,670000,155784,974,159.94250513347023
"300 EAST 55TH STREET, 21B",2005-04-07,2128142,2011-08-19,2500000,371858,2325,159.9389247311828
"1400 5 AVENUE, TH-E1",2007-01-04,1431861,2015-06-16,1925000,493139,3085,159.85056726094004
"555 WEST 23RD   STREET, S11L",2007-02-06,1160551,2017-06-15,1765000,604449,3782,159.82258064516128
"2 COLUMBUS AVENUE, 2A",2003-12-28,615000,2015-01-15,1260000,645000,4036,159.81169474727452
"115 4 AVENUE, 3G",2008-09-26,1072500,2013-01-23,1325000,252500,1580,159.81012658227849
"416 EAST 11TH STREET, 4A",2012-02-16,1043500,2018-05-29,1410000,366500,2294,159.7646033129904
"350 WEST 42ND STREET, 47F",2006-11-27,773870,2014-01-14,1190000,416130,2605,159.74280230326295
"133 ESSEX STREET, 602",2007-04-18,655000,2015-07-10,1135000,480000,3005,159.73377703826955
"350 WEST 42ND   STREET, 27G",2006-12-18,1114983,2014-06-03,1550000,435017,2724,159.69787077826726
"43 WEST 61 STREET, 17M",2003-08-26,840000,2009-12-29,1210000,370000,2317,159.68925334484246
"40 BROAD STREET, 26C",2011-05-05,516252,2013-06-18,640000,123748,775,159.67483870967743
"225 WEST 83RD   STREET, 11L",2007-08-28,1310000,2017-06-07,1880000,570000,3571,159.6191542985158
"309 WEST 118 STREET, 3C",2005-04-05,415740,2015-12-21,1040000,624260,3912,159.57566462167688
"300 ALBANY STREET, 8J",2004-04-20,235000,2006-07-14,365000,130000,815,159.50920245398774
"80 PARK AVENUE, 2M",2003-09-12,350000,2008-05-29,624500,274500,1721,159.50029052876235
"309 WEST 118 STREET, 3L",2005-03-24,365040,2018-06-12,1135000,769960,4828,159.47804473902238
"45 PARK AVENUE, 1506",2007-12-07,1280958,2014-09-12,1675000,394042,2471,159.46661270740591
"255 HUDSON STREET, 2A",2006-10-06,1781937,2014-05-16,2225000,443063,2779,159.43252968693776
"350 WEST 42ND   STREET, 59F",2006-12-12,896060,2015-09-09,1405000,508940,3193,159.39242092076418
"416 EAST 117TH STREET, 5A",2010-01-15,539672,2016-04-15,903333,363661,2282,159.3606485539001
"502 PARK AVENUE, 9A",2004-04-26,795000,2017-07-19,1565000,770000,4832,159.3543046357616
"160 CENTRAL PARK SOUTH, 407",2007-07-19,2545625,2013-08-20,2900000,354375,2224,159.34127697841726
"2109 BROADWAY, 5-160",2011-02-18,1100000,2018-01-03,1500000,400000,2511,159.2990840302668
"275 WEST 96TH STREET, 7C",2004-10-21,520000,2007-12-27,705000,185000,1162,159.20826161790018
"1641 THIRD AVENUE, 14C",2011-12-14,572500,2013-09-18,675000,102500,644,159.1614906832298
"25 MURRAY STREET, 3F",2008-09-09,1436966,2018-05-18,2000000,563034,3538,159.13906161673262
"635 WEST 42ND   STREET, 39K",2007-07-20,1283147,2012-04-24,1560000,276853,1740,159.11091954022987
"2101 BROADWAY, 8-112",2005-02-14,420000,2005-09-22,455000,35000,220,159.0909090909091
"530 EAST 76 STREET, 20B",2004-07-02,750000,2006-11-14,887500,137500,865,158.95953757225433
"115 4 AVENUE, 6H",2004-01-16,950000,2018-08-06,1795000,845000,5316,158.95410082768998
"170 WEST 23RD   STREET, 2A",2013-12-23,696500,2017-01-19,875000,178500,1123,158.94924309884237
"400 CENTRAL PARK WEST, 11B",2006-11-22,610950,2014-06-16,1050000,439050,2763,158.90336590662324
"415 MAIN STREET, 6-D",2010-05-11,534836,2015-07-13,835000,300164,1889,158.90100582318686
"400 EAST 70TH STREET, 402",2004-12-27,355000,2008-05-08,550000,195000,1228,158.79478827361564
"22 WEST 15TH STREET, 3E",2006-01-31,780000,2014-01-07,1240000,460000,2898,158.73015873015873
"179 GRAND STREET, 2F",2013-10-30,750000,2017-12-20,990000,240000,1512,158.73015873015873
"200 EAST 66TH   STREET, D1103",2008-12-08,2126381,2013-08-28,2400000,273619,1724,158.711716937355
"145 EAST 48TH STREET, 6D",2004-11-05,519000,2008-09-29,745000,226000,1424,158.7078651685393
"48 WEST 138 STREET, 6E",2013-10-15,255000,2016-03-16,395000,140000,883,158.55039637599094
"18 ELDRIDGE STREET, 2B",2008-05-20,405600,2008-10-21,430000,24400,154,158.44155844155844
"200 RECTOR PLACE, 39B",2004-07-12,920000,2013-10-18,1456250,536250,3385,158.4194977843427
"225 FIFTH AVENUE, 11N",2007-08-02,1120075,2017-08-11,1700000,579925,3662,158.3629164391043
"300 EAST 55TH STREET, 21C",2005-03-16,1781937,2014-08-26,2328000,546063,3450,158.27913043478262
"1212 5 AVENUE, 12C",2012-01-09,850238,2016-05-05,1100000,249762,1578,158.27756653992395
"111 EAST 88TH   STREET, 8E",2009-03-12,1210000,2015-07-06,1575000,365000,2307,158.21413090593845
"15 CHARLES STREET, 9D",2003-03-28,539676,2012-12-28,1103000,563324,3563,158.10384507437553
"374 BROADWAY, 7E",2004-06-29,475000,2007-07-11,650000,175000,1107,158.08491418247516
"200-210 EAST 65TH STREET, 10D",2008-06-04,1290000,2016-05-23,1750000,460000,2910,158.07560137457045
"467 CENTRAL PARK WEST, 5B",2006-05-09,962246,2013-02-26,1355000,392754,2485,158.04989939637827
"10 WEST STREET, 27B",2003-12-23,712775,2007-11-30,940000,227225,1438,158.0146036161335
"100 WEST 93RD   STREET, 5K",2009-07-16,595000,2015-11-12,960000,365000,2310,158.00865800865802
"2000 BROADWAY, 8H",2003-08-04,635000,2007-10-02,875000,240000,1520,157.89473684210526
"50 WEST 15TH STREET, 5E",2008-10-28,1639382,2018-07-19,2200000,560618,3551,157.87609124190368
"1400 5 AVENUE, 2S",2004-10-04,382590,2013-11-21,909000,526410,3335,157.84407796101948
"100 RIVERSIDE BOULEVARD, 14P",2010-04-23,1273321,2016-06-30,1630000,356679,2260,157.8225663716814
"200 RIVERSIDE BOULEVARD, 16C",2006-12-05,1120000,2016-03-17,1655000,535000,3390,157.81710914454277
"119 FULTON STREET, 10",2007-01-25,1272812,2016-02-17,1795000,522188,3310,157.7607250755287
"85 WEST BROADWAY, 11E",2010-08-10,901151,2016-05-09,1232000,330849,2099,157.62220104811814
"157 LUDLOW STREET, PHR",2005-11-11,1629200,2014-01-15,2100000,470800,2987,157.6163374623368
"350 WEST 42ND   STREET, 28A",2006-12-04,661862,2016-04-14,1200000,538138,3419,157.39631471190407
"10 WEST END AVENUE, 18D",2008-03-10,1619017,2015-07-07,2040000,420983,2675,157.37682242990655
"115 NORFOLK STREET, 401",2012-06-14,1136000,2016-11-15,1390000,254000,1615,157.27554179566565
"40 SUTTON PLACE, 7F",2004-11-09,375000,2007-06-21,525000,150000,954,157.23270440251574
"220 EAST 65TH STREET, 14D",2005-01-25,316875,2013-05-14,793333,476458,3031,157.1949851534147
"304 BOWERY, 5A",2005-09-28,987702,2016-12-06,1630000,642298,4087,157.1563494005383
"200 EAST 69TH STREET, 19E",2005-07-27,800000,2016-06-16,1425000,625000,3977,157.15363339200402
"505 GREENWICH STREET, 8C",2005-01-12,834965,2010-05-07,1140000,305035,1941,157.15352910870686
"210 EAST 47TH   STREET, 11F",2015-07-24,999999,2016-12-30,1082500,82501,525,157.1447619047619
"82 BEAVER STREET, 805",2007-02-28,1282995,2017-02-16,1855000,572005,3641,157.10107113430377
"92 PERRY STREET, 14",2010-11-24,925000,2018-07-26,1365000,440000,2801,157.0867547304534
"25 CENTRAL PARK WEST, 6U",2003-02-10,535000,2015-06-29,1245000,710000,4522,157.01017249004866
"171 EAST 84TH STREET, 10E",2006-06-28,640000,2007-08-16,705000,65000,414,157.0048309178744
"62 BEACH STREET, 4G",2007-04-27,1525000,2016-06-22,2050000,525000,3344,156.9976076555024
"200 EAST 58TH STREET, 17H",2004-07-30,745000,2013-05-16,1249000,504000,3212,156.9115815691158
"768 5 AVENUE, 808",2008-06-20,2167822,2014-04-07,2500000,332178,2117,156.90977798771846
"393 WEST 49TH   STREET, 6Q",2013-08-09,520000,2016-03-22,670000,150000,956,156.90376569037656
"300 ALBANY STREET, 7H",2003-06-02,213988,2005-09-14,345000,131012,835,156.90059880239522
"188 EAST 76TH STREET, 9C",2005-08-30,1810000,2014-03-19,2300000,490000,3123,156.9004162664105
"425 WEST 53RD   STREET, 701",2010-12-06,808250,2017-08-17,1192000,383750,2446,156.88879803761242
"15 BROAD STREET, 2330",2006-12-07,491790,2013-09-16,880000,388210,2475,156.85252525252525
"200 EAST 66TH   STREET, B0601",2009-09-25,1344704,2013-04-26,1550000,205296,1309,156.8342245989305
"170 EAST 87TH STREET, W8D",2007-07-10,1725000,2017-07-24,2300000,575000,3667,156.80392691573493
"530 WEST END AVENUE, 6B",2007-06-07,4000000,2014-08-04,4410000,410000,2615,156.78776290630975
"2000 BROADWAY, 22A",2013-06-13,1325000,2017-05-19,1550000,225000,1436,156.68523676880224
"516 WEST 47TH STREET, S7A",2011-06-13,770000,2018-07-11,1175000,405000,2585,156.67311411992264
"15 BROAD STREET, 2614",2006-07-18,798443,2014-06-09,1250000,451557,2883,156.62747138397503
"122 GREENWICH AVENUE, 15",2009-09-29,2306336,2015-01-20,2610000,303664,1939,156.60856111397626
"120 RIVERSIDE BOULEVARD, 9F",2006-05-17,939820,2010-10-07,1191000,251180,1604,156.59600997506234
"101 WEST 24TH   STREET, 3B",2008-09-17,1074253,2013-02-05,1325000,250747,1602,156.52122347066168
"120 RIVERSIDE BOULEVARD, PH3H",2006-03-16,1461188,2012-07-27,1825000,363812,2325,156.47827956989246
"254 WEST 139 STREET, O",2003-10-14,350000,2016-12-13,1102500,752500,4809,156.47743813682678
"240 RIVERSIDE BOULEVARD, 7 O-T",2006-08-03,1225000,2016-03-18,1775000,550000,3515,156.47226173541964
"220 RIVERSIDE BOULEVARD, 6A",2004-07-15,830000,2008-07-08,1057500,227500,1454,156.46492434663
"635 WEST 42ND   STREET, 3A",2013-07-02,950000,2017-11-16,1200000,250000,1598,156.44555694618273
"505 GREENWICH STREET, PHA",2005-09-09,2902012,2011-10-13,3250000,347988,2225,156.3991011235955
"237 WEST 26TH STREET, 3",2007-08-01,1600000,2013-09-16,1950000,350000,2238,156.38963360142984
"161 WEST 61 STREET, 28B",2004-05-07,1450000,2010-06-23,1800000,350000,2238,156.38963360142984
"230 RIVERSIDE DRIVE, 1B",2008-07-01,475000,2017-02-14,967500,492500,3150,156.34920634920636
"240 PARK AVENUE SOUTH, 14A2",2008-05-27,2950000,2017-02-27,3450000,500000,3198,156.3477173233271
"1991 BROADWAY, 18B",2004-01-29,460000,2014-05-30,1050000,590000,3774,156.33280339162692
"40 WEST 116 STREET, A1106",2008-10-29,853400,2017-07-11,1350000,496600,3177,156.31098520616933
"80 RIVERSIDE BOULEVARD, 6D",2009-08-07,806454,2016-04-26,1190000,383546,2454,156.29421352893235
"100 RIVERSIDE BOULEVARD, 23E",2008-07-24,1206626,2015-06-16,1600000,393374,2518,156.22478157267673
"318 WEST 100 STREET, 1D",2003-07-09,610000,2014-07-24,1240000,630000,4033,156.21125712868832
"420 WEST 25TH   STREET, 5E",2008-01-18,1349181,2013-04-29,1650000,300819,1928,156.02645228215766
"300 SPRING STREET, 2A",2007-01-10,880000,2012-11-27,1215000,335000,2148,155.95903165735567
"100 RIVERSIDE BOULEVARD, 7R",2008-03-12,1298268,2015-07-20,1717000,418732,2686,155.89426656738644
"2148 BROADWAY, PH6C",2012-07-31,11550000,2016-12-21,11800000,250000,1604,155.86034912718205
"35 EAST 38 STREET, 2-G",2003-02-03,639000,2005-12-02,800000,161000,1033,155.8567279767667
"100 UNITED NATIONS PLAZA, 23E/F",2005-05-02,2200000,2014-12-30,2750000,550000,3529,155.85151601020118
"845 UNITED NATIONS PLAZA, 55A",2004-07-02,2240150,2017-11-07,3000000,759850,4876,155.83470057424117
"130 WEST 19TH   STREET, 9C",2007-07-18,1475434,2016-10-05,2000000,524566,3367,155.7962577962578
"280 RECTOR PLACE, 4M",2015-01-21,485000,2017-11-13,645000,160000,1027,155.7935735150925
"905 WEST END AVENUE, 74",2010-03-05,1576390,2017-07-13,1995000,418610,2687,155.79084480833643
"40 BROAD STREET, 22C",2011-07-13,507088,2013-09-09,630000,122912,789,155.78200253485426
"20 CLINTON STREET, 3B",2005-03-08,646588,2007-12-20,805000,158412,1017,155.76401179941004
"103 WEST 119TH STREET, 2",2010-03-29,456300,2015-09-01,765000,308700,1982,155.75176589303734
"299 WEST 12TH STREET, 3L",2008-11-05,500000,2015-09-08,889000,389000,2498,155.724579663731
"17 CORNELIA STREET, 3B",2007-08-24,1700000,2010-09-21,1875000,175000,1124,155.69395017793593
"106 WEST 59 STREET, 19O",2003-03-14,308000,2004-02-11,360000,52000,334,155.688622754491
"150 WEST 56TH   STREET, 4509",2010-07-30,560000,2014-04-09,770000,210000,1349,155.67086730911785
"85 WEST BROADWAY, 14E",2010-03-10,621132,2016-06-01,975000,353868,2275,155.54637362637362
"255 CABRINI BOULEVARD, 7G",2004-12-06,29133,2010-01-19,320000,290867,1870,155.54385026737967
"350 WEST 42ND   STREET, 22C",2006-12-28,563000,2009-05-27,700000,137000,881,155.5051078320091
"807 RIVERSIDE DRIVE, 1B",2010-06-11,499950,2016-07-08,845000,345050,2219,155.49797205948624
"22 RIVERSIDE DRIVE, 2A",2008-10-10,865512,2014-08-25,1199000,333488,2145,155.47226107226106
"75 WALL STREET, 35B",2010-12-03,1043706,2014-12-30,1275000,231294,1488,155.43951612903226
"2280 FREDERICK DOUGLASS B, 6D",2012-06-12,499000,2017-05-25,780000,281000,1808,155.4203539823009
"15 BROAD STREET, 3224",2006-12-06,1329834,2015-08-27,1825000,495166,3186,155.4193345888261
"322 WEST 57TH STREET, 27C",2007-12-07,1069162,2015-12-18,1525000,455838,2933,155.41697920218206
"450 EAST 83RD STREET, 23C",2006-06-27,2051773,2014-10-28,2525000,473227,3045,155.4111658456486
"100 RIVERSIDE BOULEVARD, 10N",2008-05-02,1925001,2016-12-19,2415000,489999,3153,155.407231208373
"40 BROAD STREET, 27A",2012-06-01,921516,2017-04-28,1200000,278484,1792,155.40401785714286
"230 RIVERSIDE DRIVE, 15J",2008-06-30,159000,2013-04-15,430950,271950,1750,155.4
"301 EAST 79TH   STREET, 16 B",2008-09-03,1100000,2017-06-26,1600000,500000,3218,155.37600994406463
"143 LEXINGTON AVENUE, 10",2011-09-30,1667500,2017-08-09,2000000,332500,2140,155.37383177570092
"425 CENTRAL PARK WEST, 6D",2007-10-22,1047779,2017-07-10,1599000,551221,3549,155.31727247111863
"310 WEST 52ND   STREET, 10J",2007-02-15,992793,2015-03-09,1450000,457207,2944,155.30129076086956
"420 EAST 58TH STREET, 8B",2004-11-10,832500,2006-06-29,925000,92500,596,155.2013422818792
"116 CENTRAL PARK SOUTH, 8D",2009-06-23,775000,2011-08-31,899000,124000,799,155.19399249061325
"88 GREENWICH STREET, 301",2012-05-11,482353,2014-05-07,595000,112647,726,155.1611570247934
"40 BROAD STREET, 26A",2011-04-21,798054,2018-02-27,1186500,388446,2504,155.13019169329073
"216 EAST 47TH STREET, 4B",2011-08-22,499000,2018-02-06,865000,366000,2360,155.08474576271186
"90 WILLIAM STREET, 9C",2008-07-02,911333,2014-06-25,1250000,338667,2184,155.06730769230768
"223 WEST 10TH STREET, 2A",2005-11-15,316602,2012-11-28,715000,398398,2570,155.01867704280156
"57 READE STREET, 5D",2012-08-07,851257,2017-12-19,1155000,303743,1960,154.97091836734694
"310 WEST 52ND STREET, 11C",2007-10-12,955000,2015-04-17,1380000,425000,2744,154.88338192419826
"104 WEST 70TH   STREET, 8H",2014-12-02,1100000,2017-07-28,1250000,150000,969,154.79876160990713
"225 5 AVENUE, 5C",2007-10-03,1568105,2013-07-15,1895000,326895,2112,154.77982954545453
"301 EAST 79TH   STREET, 14 K",2010-10-20,212500,2018-01-04,620000,407500,2633,154.76642612988985
"130 BEEKMAN STREET, 3A",2004-06-02,1100000,2007-08-22,1282000,182000,1176,154.76190476190476
"247 WEST 46TH   STREET, 405",2008-09-17,972428,2015-07-09,1357000,384572,2486,154.69509251810138
"258 ST NICHOLAS AVENUE, 5C",2008-06-03,739807,2016-10-31,1215000,475193,3072,154.68522135416666
"650 AVENUE OF THE AMER, 3L",2010-05-26,1248000,2017-07-07,1650000,402000,2599,154.67487495190457
"100 RIVERSIDE BOULEVARD, 11J",2009-07-28,942798,2013-12-17,1190690,247892,1603,154.64254522769806
"350 WEST 42ND STREET, 10D",2006-05-17,596694,2016-03-17,1152000,555306,3592,154.59521158129175
"381 LENOX AVENUE, 3-A",2007-10-09,720259,2015-08-26,1165000,444741,2878,154.53127171646977
"304 WEST 114 STREET, 5B",2010-11-19,534581,2017-02-03,885000,350419,2268,154.50573192239858
"380 RECTOR PLACE, 21A",2003-09-29,695000,2007-09-05,917000,222000,1437,154.48851774530272
"110 EAST 71ST   STREET, 6",2008-10-24,1550000,2014-07-29,1875000,325000,2104,154.46768060836501
"27 WEST 72ND   STREET, 1203",2007-08-03,1496827,2018-04-12,2100000,603173,3905,154.46171574903968
"725 RIVERSIDE DRIVE, 7A",2007-08-17,807300,2013-09-13,1150000,342700,2219,154.4389364578639
"150 EAST 85TH STREET, 7F",2011-04-25,620000,2016-01-05,885000,265000,1716,154.42890442890442
"159 WEST 118TH STREET, 2C",2014-04-22,461370,2018-07-16,700000,238630,1546,154.35316946959895
"455 MAIN STREET, 3F",2006-06-14,992793,2016-01-26,1535000,542207,3513,154.34301167093653
"124 EAST 79TH   STREET, 12B",2012-01-27,1050000,2017-05-24,1350000,300000,1944,154.320987654321
"15 BROAD STREET, 1502",2006-05-24,560037,2016-11-10,1150000,589963,3823,154.3193826837562
"240 PARK AVENUE SOUTH, 8B",2008-04-14,3273673,2018-07-06,3850000,576327,3735,154.30441767068274
"300 WEST 110TH STREET, 3K",2004-12-17,336000,2007-07-02,479000,143000,927,154.26105717367852
"15 BROAD STREET, 3920",2007-11-01,3599513,2011-05-24,3800000,200487,1300,154.22076923076924
"2000 BROADWAY, 17D",2004-11-22,1275000,2012-10-17,1720000,445000,2886,154.1926541926542
"2 COLUMBUS AVENUE, 25C",2006-04-18,1845000,2012-01-26,2170000,325000,2109,154.10146989094358
"350 WEST 42ND   STREET, 48F",2006-12-15,775263,2017-08-11,1375000,599737,3892,154.0948098663926
"211 EAST 2ND   STREET, 5",2008-01-16,1681243,2013-09-16,2000000,318757,2070,153.98888888888888
"340 EAST 23RD   STREET, PH4A",2010-05-24,1013158,2016-08-25,1365000,351842,2285,153.9789934354486
"11 EAST 29TH   STREET, 27B",2008-01-30,941881,2015-04-27,1349000,407119,2644,153.9784417549168
"455 MAIN STREET, 14M",2006-05-04,616041,2007-02-20,661000,44959,292,153.96917808219177
"39 EAST 29TH STREET, 26D",2008-12-18,1338998,2017-11-15,1840000,501002,3254,153.96496619545175
"15 UNION SQUARE WEST, 1",2009-06-25,1120075,2014-01-06,1375000,254925,1656,153.94021739130434
"199 BOWERY, 4D",2006-09-21,885877,2014-12-23,1350000,464123,3015,153.9379767827529
"80 RIVERSIDE BOULEVARD, 3K",2009-06-18,997885,2013-09-25,1238000,240115,1560,153.9198717948718
"1080 MADISON AVENUE, PH",2003-09-03,5500000,2009-11-24,5850000,350000,2274,153.91380826737029
"382 CENTRAL PARK WEST, 4P",2004-08-26,826500,2014-05-30,1375000,548500,3564,153.90011223344555
"845 UNITED NATIONS PLAZA, 59B",2005-09-16,3971175,2011-07-25,4300000,328825,2138,153.8002806361085
"80 RIVERSIDE BOULEVARD, 3C",2009-11-23,2313830,2017-08-29,2750000,436170,2836,153.79760225669958
"48 WEST 138 STREET, 6A",2013-10-15,224015,2017-01-30,409000,184985,1203,153.76974231088946
"124 WEST 93RD STREET, 4C",2010-05-14,825000,2017-01-17,1200000,375000,2440,153.68852459016392
"350 ALBANY STREET, 4I",2010-07-14,455500,2017-07-24,850000,394500,2567,153.68134008570317
"41 SPRING STREET, 2B",2003-09-19,335000,2014-09-04,950000,615000,4003,153.63477391956033
"112 WEST 72ND STREET, 2G",2005-07-05,895000,2014-09-15,1411000,516000,3359,153.6171479607026
"140 7 AVENUE, 3P",2005-08-23,675000,2007-04-27,769000,94000,612,153.59477124183007
"420 WEST 25TH STREET, 2J",2013-07-30,795000,2016-10-14,975000,180000,1172,153.5836177474403
"150 CHAMBERS STREET, 5WEST",2008-06-12,2025000,2014-09-08,2375000,350000,2279,153.57612988152698
"555 WEST 59TH STREET, 11F",2008-06-18,1731025,2015-01-16,2100000,368975,2403,153.54764877236786
"1601 3 AVENUE, 5D",2003-02-20,253399,2008-11-15,575000,321601,2095,153.50883054892603
"280 PARK AVENUE SOUTH, 27L",2006-09-14,1012140,2016-04-18,1550000,537860,3504,153.49885844748857
"21 SOUTH END AVENUE, 722",2014-01-30,1300000,2018-07-17,1550000,250000,1629,153.4683855125844
"99 JOHN STREET, 615",2011-05-13,735000,2014-04-23,900000,165000,1076,153.3457249070632
"63 DOWNING STREET, 3D",2005-05-06,751500,2014-07-01,1263800,512300,3343,153.24558779539336
"99 JOHN STREET, 413",2011-03-24,564000,2016-08-09,865000,301000,1965,153.18066157760813
"240 RIVERSIDE BOULEVARD, 12 F",2005-11-03,1081750,2015-06-02,1617500,535750,3498,153.1589479702687
"10 WEST STREET, 16D",2003-12-29,682228,2007-05-08,870000,187772,1226,153.15823817292008
"250 BOWERY, 6A",2013-07-15,1725933,2017-12-28,1975000,249067,1627,153.0835894283958
"5 EAST 22ND   STREET, 29S",2009-06-30,737500,2010-06-08,790000,52500,343,153.0612244897959
"200 WEST END AVENUE, 12C",2008-11-17,2138325,2018-02-15,2655000,516675,3377,152.99822327509625
"8 UNION SQUARE SOUTH, 4B",2007-11-07,2097595,2018-08-08,2698362,600767,3927,152.98370257193787
"200 WEST END AVENUE, 10B",2008-02-22,962246,2014-05-15,1310000,347754,2274,152.92612137203167
"201 WEST 74TH STREET, PHB",2008-06-11,1650000,2014-09-17,2000000,350000,2289,152.9051987767584
"170 EAST END AVENUE, 2E",2008-04-09,2318062,2011-10-19,2515000,196938,1288,152.90217391304347
"445 WEST 19TH STREET, 7B",2009-07-16,620000,2016-01-29,985000,365000,2388,152.84757118927973
"235 EAST 40 STREET, 2J",2003-07-31,240000,2004-03-16,275000,35000,229,152.83842794759826
"35 EAST 38TH   STREET, 4C",2007-05-05,391250,2017-10-20,975000,583750,3821,152.77414289453023
"415 MAIN STREET, PH2-D",2010-01-11,585493,2015-09-01,900000,314507,2059,152.7474502185527
"120 RIVERSIDE BOULEVARD, 5S",2005-12-21,1593561,2015-10-09,2140000,546439,3579,152.67924001117632
"225 5 AVENUE, 7P",2007-02-28,1028432,2012-01-12,1300000,271568,1779,152.65205171444632
"14 EAST 96TH STREET, 7",2005-01-20,1030000,2017-12-20,1750000,720000,4717,152.63938944244222
"16 WEST 19TH   STREET, 5-F",2007-11-28,1260000,2015-06-11,1680000,420000,2752,152.61627906976744
"340 EAST 23RD STREET, PH2C",2009-05-07,1825772,2016-12-16,2250000,424228,2780,152.6
"420 EAST 58TH   STREET, 10C",2011-06-21,439000,2017-11-09,795000,356000,2333,152.59322760394343
"246 WEST 17TH   STREET, 2A",2009-01-14,4989425,2012-10-25,5200000,210575,1380,152.59057971014494
"2360 AMSTERDAM AVENUE, 3C",2011-04-12,308965,2018-01-11,685000,376035,2466,152.48783454987836
"825 WEST END AVENUE, 15-G",2005-01-26,1250000,2014-06-25,1773900,523900,3437,152.42944428280478
"220 RIVERSIDE BOULEVARD, 4U",2009-06-17,670000,2011-10-18,800000,130000,853,152.40328253223916
"227 EAST 111 STREET, 6B",2005-03-31,498942,2009-04-23,725000,226058,1484,152.33018867924528
"21 SOUTH END AVENUE, 731",2003-12-19,490000,2008-08-21,750000,260000,1707,152.31400117164617
"120 RIVERSIDE BOULEVARD, 11W",2006-01-27,708192,2014-12-02,1200000,491808,3231,152.21541318477253
"10 LITTLE WEST STREET, 19E",2011-03-01,2000000,2018-05-11,2400000,400000,2628,152.20700152207002
"25 FIFTH AVENUE, 5A",2008-06-24,2749275,2017-06-14,3248000,498725,3277,152.1895025938358
"99 JOHN STREET, 926",2010-06-11,435000,2015-06-25,715000,280000,1840,152.17391304347825
"165 ELIZABETH STREET, 4R",2003-06-03,465000,2015-05-21,1130000,665000,4370,152.17391304347825
"301 EAST 79 STREET, 18 K",2004-04-15,377500,2005-04-28,435000,57500,378,152.11640211640213
"115 NORFOLK STREET, 302",2012-12-13,911333,2018-02-23,1200000,288667,1898,152.09009483667018
"252 7 AVENUE, 8R",2003-01-10,1550000,2004-03-29,1617500,67500,444,152.02702702702703
"310 WEST 52ND   STREET, 27J",2007-03-19,1244810,2014-01-22,1625000,380190,2501,152.01519392243102
"100 UNITED NATIONS PLAZA, 22B",2005-01-05,1366000,2015-03-05,1930000,564000,3711,151.98059822150364
"350 WEST 42ND   STREET, 44G",2006-11-10,1751390,2017-02-10,2320000,568610,3745,151.83177570093457
"10 WEST END AVENUE, 8H",2007-07-26,1466544,2017-03-02,1999000,532456,3507,151.82663244938695
"505 GREENWICH STREET, 11G",2004-12-23,2972271,2010-06-09,3275000,302729,1994,151.81995987963893
"210 LAFAYETTE STREET, 9B",2006-01-25,2645000,2014-04-10,3100000,455000,2997,151.8184851518185
"300 ALBANY STREET, 3I",2003-04-28,525000,2016-05-26,1250000,725000,4777,151.76889261042496
"1438 3 AVENUE, 25A",2009-03-12,845000,2016-01-19,1225000,380000,2504,151.75718849840257
"170 EAST END AVENUE, 4M",2008-06-23,1802937,2017-06-12,2300000,497063,3276,151.72863247863248
"300 RECTOR PLACE, 3J",2012-02-14,345000,2016-09-21,600000,255000,1681,151.69541939321832
"254 PARK AVENUE SOUTH, 11M",2010-11-19,636406,2014-01-07,810000,173594,1145,151.61048034934498
"80 RIVERSIDE BOULEVARD, 3T",2009-10-28,828855,2018-01-24,1285000,456145,3010,151.54318936877075
"240 PARK AVENUE SOUTH, 12C",2008-04-15,2265606,2017-12-11,2800000,534394,3527,151.51516869861072
"2000 BROADWAY, 9B",2010-10-13,600000,2013-12-11,775000,175000,1155,151.5151515151515
"200 RECTOR PLACE, 7D",2013-06-06,490000,2016-04-05,646666,156666,1034,151.5145067698259
"170 EAST END AVENUE, 4F",2008-05-28,3563875,2013-07-30,3850000,286125,1889,151.46903123345686
"200 CHAMBERS STREET, 2B",2007-04-27,1400450,2012-09-25,1700000,299550,1978,151.44084934277046
"62 BEACH STREET, 5E",2005-10-11,2695000,2018-07-12,3400000,705000,4657,151.3850118101782
"160 WOOSTER STREET, 4B",2005-02-23,1425550,2009-10-01,1680000,254450,1681,151.36823319452708
"502 PARK AVENUE, 16C",2005-06-06,1527375,2015-10-16,2100000,572625,3784,151.3279598308668
"45 PARK AVENUE, PH01",2008-01-31,2484530,2018-04-27,3050000,565470,3739,151.235624498529
"147 WEST 142 STREET, 3A",2013-02-12,278850,2017-10-03,535000,256150,1694,151.21015348288074
"200 EAST 61ST   STREET, PH2",2009-03-31,3750000,2013-10-10,4000000,250000,1654,151.14873035066506
"330 EAST 49TH STREET, 10D",2007-05-18,246450,2013-05-01,575000,328550,2175,151.05747126436782
"322 WEST 57TH STREET, 24S",2007-12-05,1374637,2018-05-10,1950000,575363,3809,151.05355736413756
"15 BROAD STREET, 1614",2006-06-06,1725933,2014-03-20,2155000,429067,2844,150.86744022503515
"455 CENTRAL PARK WEST, 17A",2006-06-16,2443800,2018-05-14,3100000,656200,4350,150.8505747126437
"240 PARK AVENUE SOUTH, 10C",2008-04-30,2265606,2010-10-08,2400000,134394,891,150.83501683501683
"555 WEST 59TH   STREET, 14C",2010-01-12,900000,2018-03-15,1350000,450000,2984,150.80428954423593
"200 WEST END AVENUE, 17H",2008-11-14,1064071,2013-06-05,1315000,250929,1664,150.7986778846154
"801 RIVERSIDE DRIVE, 3H",2014-05-29,359000,2017-06-20,527580,168580,1118,150.7871198568873
"11 EAST 29TH   STREET, 7C",2008-08-06,1424531,2017-01-19,1890000,465469,3088,150.7347797927461
"120 RIVERSIDE BOULEVARD, 7B",2005-12-21,518085,2015-05-13,1035000,516915,3430,150.70408163265307
"2001 BROADWAY, 24-F",2004-09-02,828000,2013-11-19,1335000,507000,3365,150.66864784546806
"41 WEST 72ND   STREET, 14F",2011-07-27,795000,2015-03-03,993000,198000,1315,150.5703422053232
"18 WEST 48TH STREET, 22C",2011-05-05,1090000,2018-06-28,1483000,393000,2611,150.51704327843737
"200 EAST 32ND STREET, 5A",2015-02-03,815000,2016-06-02,888000,73000,485,150.51546391752578
"188 EAST 64 STREET, 1506",2004-12-17,1625000,2009-01-21,1850000,225000,1496,150.40106951871658
"300 WEST 135TH STREET, 5E",2005-08-11,230489,2018-07-13,940000,709511,4719,150.35198135198135
"254 PARK AVENUE SOUTH, 5M",2010-11-30,623678,2013-06-27,765000,141322,940,150.34255319148937
"1991 BROADWAY, 3C",2013-04-15,705000,2016-02-10,860000,155000,1031,150.33947623666344
"301 EAST 79TH   STREET, 5 D",2009-11-30,544000,2014-07-14,797500,253500,1687,150.26674570243034
"301 EAST 79TH   STREET, 5 C",2009-11-30,544000,2014-07-14,797500,253500,1687,150.26674570243034
"421 WEST 54TH   STREET, 5B",2008-02-15,1265000,2013-01-16,1535000,270000,1797,150.25041736227044
"255 HUDSON STREET, 9A",2007-05-30,2420889,2017-11-15,2995000,574111,3822,150.21219256933543
"124 WEST 93RD STREET, 5C",2010-05-26,860000,2016-01-19,1170000,310000,2064,150.19379844961242
"40 BROAD STREET, 12G",2010-06-04,616041,2014-09-09,850000,233959,1558,150.16623876765084
"15 BROAD STREET, 3008",2006-08-21,1756481,2018-05-16,2400000,643519,4286,150.14442370508633
"80 PARK AVENUE, 10A",2005-12-23,447174,2007-07-31,535000,87826,585,150.12991452991454
"175 WEST 12TH   STREET, 18B",2007-07-02,1425550,2014-05-01,1800000,374450,2495,150.08016032064128
"130 FULTON STREET, 7A",2006-07-13,1664838,2015-11-03,2175000,510162,3400,150.04764705882354
"400 EAST 54TH STREET, 16F",2004-04-13,738231,2016-05-11,1400000,661769,4411,150.02697800952166
"310 WEST 52ND   STREET, 38J",2007-06-13,1331361,2013-07-15,1665000,333639,2224,150.01753597122303
"30 WEST 90TH   STREET, 6B",2011-05-02,2535000,2017-07-17,2875000,340000,2268,149.91181657848324
"140 EAST 63RD STREET, 10B",2007-09-10,1349181,2011-08-03,1562500,213319,1423,149.90794096978215
"333 RECTOR PLACE, 1106",2011-11-10,544763,2015-11-05,763000,218237,1456,149.88804945054946
"425 WEST 53RD   STREET, PH11",2012-07-23,2138325,2018-04-03,2450000,311675,2080,149.84375
"301 EAST 79TH   STREET, 6 E",2012-09-14,638500,2017-05-23,895000,256500,1712,149.82476635514018
"20 CLINTON STREET, 2F",2003-08-05,469000,2017-10-11,1245000,776000,5181,149.7780351283536
"211 MADISON AVENUE, 8A",2004-03-26,617500,2018-07-18,1400000,782500,5227,149.70346278936293
"230 RIVERSIDE DRIVE, 2D",2008-01-03,1425550,2013-12-31,1753151,327601,2189,149.65783462768388
"18 WEST 48TH STREET, 23E",2008-05-28,1375000,2016-03-07,1800000,425000,2840,149.64788732394365
"88 GREENWICH STREET, 1904",2011-01-24,900000,2017-09-29,1265000,365000,2440,149.59016393442624
"14 PRINCE STREET, 1B",2006-08-08,615000,2015-06-25,1100000,485000,3243,149.55288313290163
"163 WEST 18TH   STREET, 3C",2007-04-27,1598652,2012-06-21,1880000,281348,1882,149.4941551540914
"117 EAST 57 STREET, 45F",2003-01-22,365000,2008-05-15,655000,290000,1940,149.48453608247422
"27 WEST 72ND   STREET, 208",2007-08-02,778961,2015-12-09,1235000,456039,3051,149.47197640117994
"40 BROAD STREET, 25B",2011-06-02,932750,2013-08-28,1055000,122250,818,149.44987775061125
"250 EAST 54 STREET, 17E",2003-05-02,280000,2007-01-16,482500,202500,1355,149.44649446494466
"18 WEST 48TH   STREET, 23B",2007-05-17,1273830,2017-01-05,1800000,526170,3521,149.4376597557512
"333 RECTOR PLACE, 1007",2012-08-09,815000,2018-01-05,1110000,295000,1975,149.36708860759492
"1280 5 AVENUE, 19F",2014-08-14,1828693,2017-10-04,2000000,171307,1147,149.35222319093288
"630 1 AVENUE, 19N",2004-07-22,779000,2008-06-04,990000,211000,1413,149.32767162066526
"530 PARK AVENUE, 5B",2014-01-13,2725000,2018-02-28,2950000,225000,1507,149.30325149303252
"75 WALL STREET, 38M",2009-09-11,1629200,2015-10-07,1960000,330800,2217,149.2106450157871
"261 WEST 28TH STREET, PHC",2007-12-13,2545625,2018-01-31,3098000,552375,3702,149.209886547812
"90 WILLIAM STREET, 2A",2009-07-21,835000,2017-11-30,1290000,455000,3054,148.9849377865095
"68 BRADHURST AVENUE, 5-F",2009-09-01,384252,2015-12-07,725000,340748,2288,148.92832167832168
"225 EAST 34TH STREET, 7H",2007-10-01,799326,2008-07-17,842500,43174,290,148.87586206896552
"20 PINE STREET, 1908",2009-09-10,807300,2015-07-15,1125000,317700,2134,148.87535145267103
"520 EAST 81ST   STREET, 7N",2007-05-01,79236,2015-10-01,537000,457764,3075,148.86634146341464
"53 NORTH MOORE STREET, 2J",2005-06-28,1585000,2018-08-24,2300000,715000,4805,148.80332986472425
"322 WEST 57TH   STREET, 48K",2012-02-14,758596,2017-11-08,1070000,311404,2094,148.71251193887298
"315 7 AVENUE, 7B",2004-05-03,350000,2011-03-30,725000,375000,2522,148.6915146708961
"1400 FIFTH AVENUE, 6F",2004-12-20,473000,2016-07-07,1100000,627000,4217,148.68389850604694
"255 HUDSON STREET, 5B",2007-08-27,1769209,2015-08-03,2200000,430791,2898,148.65113871635612
"88 GREENWICH STREET, 1304",2012-08-30,1395000,2017-10-27,1675000,280000,1884,148.619957537155
"340 EAST 64TH   STREET, 3N",2007-10-01,1750000,2015-04-21,2160000,410000,2759,148.6045668720551
"300 ALBANY STREET, 5K",2003-01-08,237000,2004-10-29,335000,98000,660,148.4848484848485
"29 KING STREET, 4E",2006-06-30,582750,2014-08-26,1025000,442250,2979,148.4558576703592
"99 JOHN STREET, 2508",2010-12-10,719393,2017-12-18,1100000,380607,2565,148.38479532163743
"200 RIVERSIDE BOULEVARD, 12L",2005-01-14,999000,2015-09-01,1575000,576000,3882,148.3771251931994
"56 LEONARD STREET, 35AW",2016-11-15,5055682,2018-08-13,5150000,94318,636,148.2987421383648
"250 EAST 40TH STREET, 17E",2012-07-31,749000,2016-02-09,940000,191000,1288,148.29192546583852
"124 WEST 24TH STREET, 3A",2007-11-15,1117020,2011-12-28,1340000,222980,1504,148.25797872340425
"10 WEST END AVENUE, 4H",2007-08-01,1411294,2013-07-24,1735000,323706,2184,148.21703296703296
"36 GRAMERCY PARK EAST, 3S",2013-05-29,1180000,2017-12-07,1425000,245000,1653,148.21536600120993
"505 WEST 47TH   STREET, 3H-S",2009-08-28,824782,2016-08-03,1200000,375218,2532,148.19036334913113
"30 EAST 37TH STREET, 9C",2007-01-04,322452,2009-01-23,433500,111048,750,148.064
"2000 BROADWAY, 26D",2004-09-23,1325000,2012-08-03,1750000,425000,2871,148.0320445837687
"225 WEST 60TH STREET, 11D",2014-02-28,920000,2015-12-02,1015000,95000,642,147.97507788161994
"310 EAST HOUSTON STREET, PHC",2007-07-06,1603743,2017-08-14,2150000,546257,3692,147.95693391115927
"447 WEST 18TH   STREET, 2B",2009-07-30,878240,2018-02-15,1340000,461760,3122,147.90518898142216
"1641 3 AVENUE, 35H",2003-02-20,464790,2009-04-02,795000,330210,2233,147.87729511867443
"400 CENTRAL PARK WEST, 20H",2003-11-05,350000,2015-06-04,975000,625000,4229,147.7890754315441
"200 CHAMBERS STREET, 15F",2013-11-20,1435000,2018-05-02,1675000,240000,1624,147.7832512315271
"130 WEST 20TH STREET, 4A",2009-09-23,707000,2014-03-26,950000,243000,1645,147.72036474164133
"99 JANE STREET, 4C",2007-07-09,2661500,2011-03-14,2860000,198500,1344,147.69345238095238
"450 WEST 17TH   STREET, 1012",2009-11-18,735000,2012-09-19,888000,153000,1036,147.6833976833977
"2 COLUMBUS AVENUE, 37C",2005-05-23,2025000,2010-12-15,2325000,300000,2032,147.63779527559055
"382 CENTRAL PARK WEST, 17N",2012-08-30,860000,2018-08-07,1180000,320000,2168,147.60147601476015
"175 WEST 12TH STREET, 14F",2006-05-22,987702,2018-06-28,1640000,652298,4420,147.5787330316742
"30 LITTLE WEST STREET, 15E",2012-04-19,1445000,2014-04-01,1550000,105000,712,147.47191011235955
"275 GREENWICH STREET, 3HS",2004-04-16,520000,2016-09-26,1190000,670000,4546,147.38231412230533
"515 EAST 72ND   STREET, 18H",2008-01-23,1391947,2014-09-18,1750000,358053,2430,147.3469135802469
"125 CENTRAL PARK NORTH, 5A",2006-08-16,1069162,2016-06-27,1600000,530838,3603,147.3322231473772
"101 WEST 79TH STREET, 12A",2006-03-15,965000,2016-02-24,1500000,535000,3633,147.26121662537847
"505 GREENWICH STREET, 5F",2006-08-02,1150000,2008-08-18,1260000,110000,747,147.25568942436414
"309 EAST 49TH STREET, 15D",2005-09-06,1048000,2017-01-23,1660000,612000,4157,147.2215540052923
"2280 FREDERICK DOUGLASS B, 11A",2011-05-17,671026,2016-11-30,969000,297974,2024,147.22035573122528
"99 JOHN STREET, 1107",2012-05-10,737500,2017-03-08,997000,259500,1763,147.19228587634714
"301 EAST 79 STREET, PH KY",2003-02-24,298000,2005-12-23,450000,152000,1033,147.14424007744432
"40 BROAD STREET, 18F",2012-03-01,891019,2014-01-03,990000,98981,673,147.074294205052
"120 RIVERSIDE BOULEVARD, PH3G",2006-05-23,891498,2014-06-18,1325000,433502,2948,147.04952510176392
"450 EAST 83RD STREET, 12E",2007-07-13,1832850,2016-12-21,2340000,507150,3449,147.0426210495796
"300 WEST 135TH STREET, 2Q",2005-06-15,245539,2018-07-30,950000,704461,4793,146.97704986438555
"263 9 AVENUE, 1A",2007-06-08,1221900,2017-04-12,1750000,528100,3596,146.85761957730813
"120 RIVERSIDE BOULEVARD, 15W",2006-03-02,738516,2015-12-11,1262500,523984,3571,146.73312797535704
"340 EAST 23RD STREET, 11D",2008-02-25,1282995,2013-09-11,1580000,297005,2025,146.66913580246913
"79 LAIGHT STREET, 3D",2004-08-03,2610000,2010-05-18,2920000,310000,2114,146.64143803216652
"163 ST NICHOLAS AVENUE, 2I",2004-06-11,212940,2007-09-18,388000,175060,1194,146.61641541038526
"80 JOHN STREET, 18C",2008-05-05,1037088,2015-08-03,1425000,387912,2646,146.6031746031746
"120 RIVERSIDE BOULEVARD, 15D",2006-02-28,1094618,2010-12-06,1350000,255382,1742,146.60275545350171
"90 PRINCE STREET, 5A",2004-11-12,1250000,2017-07-07,1927000,677000,4620,146.53679653679654
"140 WEST 12TH STREET, 401",2015-12-01,4502527,2016-10-20,4550000,47473,324,146.5216049382716
"255 HUDSON STREET, 3D",2006-10-31,1018250,2015-09-28,1495000,476750,3254,146.5119852489244
"99 READE STREET, 5W",2011-04-11,1925000,2012-09-04,2000000,75000,512,146.484375
"445 WEST 19TH   STREET, 8C",2009-10-16,551000,2012-05-22,690000,139000,949,146.46996838777662
"845 UNITED NATIONS PLAZA, 8H",2004-07-30,1075000,2010-08-27,1400000,325000,2219,146.46237043713384
"555 WEST 23RD   STREET, S4L",2007-02-13,942678,2011-11-02,1195000,252322,1723,146.44341265235056
"1623 3 AVENUE, 19H",2003-03-11,407782,2010-10-21,815000,407218,2781,146.42862279755482
"175 WEST 12TH STREET, 17H",2008-02-21,862000,2014-06-18,1200000,338000,2309,146.38371589432654
"210 LAFAYETTE STREET, 5A",2008-01-30,1900000,2018-05-17,2450000,550000,3760,146.27659574468086
"1595 LEXINGTON AVENUE, 4G",2013-12-27,473486,2017-01-25,638000,164514,1125,146.23466666666667
"255 HUDSON STREET, 9B",2006-10-16,1832850,2016-04-15,2340000,507150,3469,146.19486883828193
"408 EAST 79TH STREET, 18B",2005-12-15,3128519,2007-04-18,3200000,71481,489,146.17791411042944
"222 RIVERSIDE DRIVE, PH2B",2006-05-30,2150000,2014-05-16,2575000,425000,2908,146.14855570839066
"372 CENTRAL PARK WEST, 18G",2010-04-19,530000,2015-01-28,785000,255000,1745,146.13180515759313
"303 EAST 33RD   STREET, 8J",2011-06-14,595676,2014-09-19,770000,174324,1193,146.12238055322715
"254 PARK AVENUE SOUTH, 6P",2009-12-30,1405000,2013-03-08,1575000,170000,1164,146.04810996563575
"134 EAST 93RD STREET, 12C",2008-06-24,1775000,2016-10-27,2220000,445000,3047,146.04529044962257
"1438 THIRD AVENUE, 26E",2007-10-24,1695386,2017-03-06,2195000,499614,3421,146.0432622040339
"25 CENTRAL PARK WEST, 7W",2006-06-05,1102400,2007-11-19,1180000,77600,532,145.86466165413535
"88 GREENWICH STREET, 3302",2010-05-06,910000,2015-04-27,1175000,265000,1817,145.84479911942762
"354 BROOME STREET, 5I",2007-08-28,1500000,2015-03-02,1900000,400000,2743,145.82573824279984
"177 EAST 77TH STREET, 3B",2005-02-08,758596,2016-05-26,1360000,601404,4125,145.7949090909091
"1641 THIRD AVENUE, 2A",2004-03-04,710000,2011-12-20,1125000,415000,2847,145.76747453459782
"211 EAST 46TH   STREET, 12D",2008-04-07,462638,2016-03-09,884000,421362,2893,145.64880746629797
"29 KING STREET, 3I",2006-06-01,1351000,2010-07-14,1570000,219000,1504,145.61170212765958
"15 BROAD STREET, 3410",2006-10-10,1420458,2013-04-05,1765000,344542,2369,145.43773744195863
"350 WEST 42ND STREET, 39C",2006-09-12,1084436,2010-11-08,1305000,220564,1518,145.29907773386034
"835 RIVERSIDE DRIVE, 6A",2011-09-26,304200,2018-04-02,650000,345800,2380,145.2941176470588
"71 NASSAU STREET, 2A",2006-09-14,997885,2016-03-01,1500000,502115,3456,145.28790509259258
"109 NORFOLK STREET, 5",2007-09-07,1501918,2017-12-01,2045000,543082,3738,145.28678437667202
"521 PARK AVENUE, 12A",2011-07-20,1350000,2017-03-15,1650000,300000,2065,145.27845036319613
"14 PRINCE STREET, 4C",2007-10-15,1075000,2015-10-19,1500000,425000,2926,145.2494873547505
"303 EAST 33RD   STREET, 3K",2010-09-07,575311,2014-06-13,775000,199689,1375,145.22836363636364
"2360 AMSTERDAM AVENUE, 6D",2012-02-10,329550,2017-08-02,620000,290450,2000,145.225
"635 WEST 42ND STREET, 23K",2007-07-18,1136723,2017-06-26,1663820,527097,3631,145.16579454695676
"325 5 AVENUE, 42E",2013-01-17,1388000,2017-01-18,1600000,212000,1462,145.00683994528043
"300 EAST 55TH STREET, 17C",2005-02-15,1201535,2018-04-26,1900000,698465,4818,144.96990452469905
"248 EAST 31ST STREET, 2B",2008-03-27,910000,2018-06-08,1450000,540000,3725,144.96644295302013
"22 WEST 15TH STREET, 15G",2007-03-16,850000,2015-03-26,1275000,425000,2932,144.95225102319236
"77 PARK AVENUE, 8A",2005-08-26,975000,2017-06-09,1599000,624000,4305,144.94773519163763
"320 EAST 54 STREET, 12E",2003-10-27,665000,2014-04-04,1217500,552500,3812,144.9370409233998
"505 WEST 47TH   STREET, 6D-N",2012-02-01,830000,2016-06-07,1060000,230000,1588,144.83627204030228
"1601 3 AVENUE, 27G",2003-02-20,286760,2016-04-01,980000,693240,4789,144.75673418250156
"153 EAST 87 STREET, 11B",2003-04-24,260000,2007-05-01,472500,212500,1468,144.75476839237058
"67 HUDSON STREET, 3D",2003-05-27,776500,2011-05-31,1200000,423500,2926,144.73684210526315
"100 WEST 89TH STREET, 7-F",2011-06-15,1400000,2016-04-11,1655000,255000,1762,144.72190692395006
"311 GREENWICH STREET, 10C",2004-01-28,1105000,2011-10-07,1511500,406500,2809,144.71342114631543
"1400 FIFTH AVENUE, 7I",2005-01-18,309410,2015-08-21,869000,559590,3867,144.7090768037238
"650 WEST END AVENUE, 2C",2005-07-26,595000,2011-05-04,900000,305000,2108,144.68690702087287
"40 WEST 116 STREET, A1007",2008-08-22,963840,2015-06-25,1325000,361160,2498,144.57966373098478
"106 CENTRAL PARK SOUTH, 7H",2005-02-04,677500,2014-12-29,1200000,522500,3615,144.53665283540803
"404 EAST 79TH   STREET, 28A",2010-09-16,630000,2017-09-12,998900,368900,2553,144.4966705836271
"392 CENTRAL PARK WEST, 15F",2004-02-26,290000,2007-07-19,469000,179000,1239,144.47134786117837
"200 WEST END AVENUE, 5L",2008-03-26,1298268,2016-10-17,1750000,451732,3127,144.46178445794692
"224 WEST 18TH STREET, 6C",2008-10-07,2165000,2015-02-12,2500000,335000,2319,144.45881845623114
"15 BROAD STREET, 1226",2006-11-29,646588,2017-09-07,1215000,568412,3935,144.45031766200762
"382 CENTRAL PARK WEST, 17Y",2003-01-24,369000,2006-10-12,565000,196000,1357,144.43625644804717
"426 WEST 58TH STREET, 2A",2012-06-29,1567800,2018-08-08,1890000,322200,2231,144.41954280591662
"130 WEST 79TH   STREET, 10C",2014-06-17,891000,2017-06-22,1050000,159000,1101,144.4141689373297
"333 EAST 109 STREET, 5E",2011-10-27,580000,2015-04-17,763000,183000,1268,144.3217665615142
"25 FIFTH AVENUE, 10H",2008-08-08,1237173,2018-03-28,1745000,507827,3519,144.31003125888037
"20 CLINTON STREET, 4E",2005-02-17,720000,2016-11-23,1340000,620000,4297,144.2867116592972
"160 WEST 66TH STREET, 32E",2006-11-03,1040000,2014-08-15,1450000,410000,2842,144.2646023926812
"120 RIVERSIDE BOULEVARD, PH1B",2006-03-17,1466280,2013-06-28,1850000,383720,2660,144.25563909774436
"35 EAST 38TH STREET, 9C",2011-01-10,700000,2015-04-03,922680,222680,1544,144.22279792746113
"40 SUTTON PLACE, 9H",2005-07-14,680000,2018-04-03,1350000,670000,4646,144.21007318123117
"200 CHAMBERS STREET, 7J",2007-04-19,840056,2017-09-27,1390000,549944,3814,144.1908757210278
"2322 ADAM C POWELL BLVD, 4A",2014-04-30,411000,2016-12-19,550000,139000,964,144.1908713692946
"310 WEST 52ND   STREET, 39A",2007-08-27,1200000,2013-11-04,1526000,326000,2261,144.18398938522776
"303 WEST 80TH   STREET, 4B",2010-05-12,1600000,2016-01-22,1900000,300000,2081,144.16146083613648
"14 PRINCE STREET, 5F",2008-12-09,785000,2010-03-05,850000,65000,451,144.12416851441242
"350 WEST 42ND STREET, 15E",2006-06-19,538654,2013-09-16,920000,381346,2646,144.1216931216931
"211 EAST 46TH   STREET, 6F",2008-03-31,1100303,2015-09-30,1495000,394697,2739,144.10259218692954
"100 11TH   AVENUE, 11A",2010-05-27,3600000,2012-04-20,3700000,100000,694,144.0922190201729
"225 EAST 34TH   STREET, 16D",2009-03-26,845000,2016-07-14,1229000,384000,2667,143.9820022497188
"99 JANE STREET, 1E",2004-08-13,1425000,2009-11-06,1700000,275000,1911,143.90371533228677
"1600 BROADWAY, 14G",2006-07-05,1216808,2017-08-09,1800000,583192,4053,143.89143844066123
"330 EAST 38TH STREET, 45H",2013-02-15,645500,2017-08-03,880000,234500,1630,143.86503067484662
"1601 3 AVENUE, 7E",2003-02-20,126700,2009-06-25,460000,333300,2317,143.8498057833405
"240 EAST 47TH   STREET, 29C",2006-10-20,1625000,2016-10-17,2150000,525000,3650,143.83561643835617
"2120 BROADWAY, 7A",2004-08-26,416500,2006-02-02,492000,75500,525,143.8095238095238
"130 BARROW STREET, 419",2012-02-14,1500000,2015-06-15,1675000,175000,1217,143.7962202136401
"313 WEST 119 STREET, 8D",2007-08-03,1196443,2015-06-18,1610000,413557,2876,143.79589707927678
"80 RIVERSIDE BOULEVARD, 4T",2010-03-04,869500,2012-06-19,990000,120500,838,143.79474940334129
"2101 BROADWAY, 15950",2005-08-05,751000,2007-04-16,840000,89000,619,143.78029079159936
"350 WEST 42ND   STREET, 36D",2007-08-29,2050000,2014-03-25,2395000,345000,2400,143.75
"280 RECTOR PLACE, 7I",2012-06-05,379000,2017-10-02,658500,279500,1945,143.7017994858612
"66 ST NICHOLAS AVENUE, 5G",2014-03-17,540000,2016-02-11,640000,100000,696,143.67816091954023
"415 EAST 37TH STREET, 25G",2014-02-04,1125000,2018-05-21,1350000,225000,1567,143.58647096362475
"93 WORTH STREET, 404",2014-01-13,728049,2017-04-25,900000,171951,1198,143.53171953255426
"2 COLUMBUS AVENUE, 10B",2007-08-02,1750000,2015-04-24,2155000,405000,2822,143.5152374202693
"127 EAST 30TH STREET, 8D",2010-06-22,955000,2017-08-17,1330000,375000,2613,143.51320321469575
"62 WEST 62 STREET, 5B",2004-03-25,402000,2012-12-13,859000,457000,3185,143.4850863422292
"225 EAST 34TH   STREET, 10B",2008-05-29,1043706,2014-01-17,1339000,295294,2059,143.41622146673143
"514 CATHEDRAL PARKWAY, 5B",2005-06-09,465426,2008-07-24,629000,163574,1141,143.36021034180544
"462 WEST 58TH STREET, 5C",2010-04-19,1325000,2018-03-09,1738000,413000,2881,143.3530024297119
"30 EAST 37TH   STREET, M5",2007-01-05,765113,2015-03-24,1195000,429887,3000,143.29566666666668
"343 EAST 30TH   STREET, 17-K",2012-08-28,660000,2013-08-12,710000,50000,349,143.26647564469914
"1 IRVING PLACE, V20G",2010-04-15,605000,2012-05-22,715000,110000,768,143.22916666666666
"150 EAST 56TH STREET, 6C",2011-03-24,750000,2013-07-09,870000,120000,838,143.1980906921241
"2 CORNELIA STREET, 41035",2006-01-13,725000,2008-06-30,853700,128700,899,143.15906562847607
"317 EAST 48 STREET, 1B",2004-07-20,352500,2006-09-14,465000,112500,786,143.12977099236642
"845 UNITED NATIONS PLAZA, 12E",2004-06-04,1500000,2017-10-25,2200000,700000,4891,143.1200163565733
"25 CENTRAL PARK WEST, 3U",2004-02-11,500000,2015-08-05,1100000,600000,4193,143.09563558311473
"99 JOHN STREET, 1703",2009-09-17,1079770,2012-09-27,1238000,158230,1106,143.06509945750452
"200 RIVERSIDE BOULEVARD, PH2D",2006-10-13,1825000,2017-10-16,2400000,575000,4021,142.99925391693608
"220 EAST 65TH   STREET, 17A",2009-07-10,625000,2016-02-18,970000,345000,2414,142.91632145816072
"280 PARK AVENUE SOUTH, 25B",2013-10-10,2078797,2018-01-05,2300000,221203,1548,142.89599483204134
"61 LENOX AVENUE, 3A",2006-08-09,708000,2015-01-21,1149000,441000,3087,142.85714285714286
"520 EAST 81 STREET, 5D",2003-11-19,200000,2004-03-10,216000,16000,112,142.85714285714286
"300 RECTOR PLACE, 4J",2011-05-09,375000,2017-06-26,695000,320000,2240,142.85714285714286
"400 EAST 67TH   STREET, 8C",2009-03-20,1731025,2013-05-31,1950000,218975,1533,142.84083496412265
"502 PARK AVENUE, 16G",2005-06-02,4643220,2012-04-04,5000000,356780,2498,142.82626100880705
"25 CENTRAL PARK WEST, 12V",2004-04-09,701750,2012-05-21,1125000,423250,2964,142.79689608636977
"255 EAST 49TH   STREET, 15 E",2008-09-11,1030000,2014-12-05,1355000,325000,2276,142.79437609841827
"71 NASSAU ST, 3A",2006-05-31,911333,2015-09-09,1395000,483667,3388,142.75885478158204
"99 JOHN STREET, 2108",2011-07-20,692500,2016-06-20,949000,256500,1797,142.73789649415693
"90 GREENE STREET, 4",2003-01-30,2225000,2017-12-12,3000000,775000,5430,142.7255985267035
"200 WEST END AVENUE, 12L",2008-08-01,1374637,2014-04-02,1670000,295363,2070,142.68743961352658
"15 BROAD STREET, 3024",2007-02-01,1420458,2015-10-23,1875000,454542,3186,142.66854990583803
"52 EAST END AVENUE, PH1",2003-06-30,2377625,2016-09-08,3065000,687375,4819,142.63851421456735
"211 EAST 46TH   STREET, 31B",2009-06-11,672045,2015-09-28,999999,327954,2300,142.58869565217393
"455 MAIN STREET, 14K",2007-02-13,768778,2017-04-27,1300000,531222,3726,142.57165861513687
"225 WEST 60TH   STREET, 11C",2006-12-20,1170987,2014-06-24,1562000,391013,2743,142.54939846882974
"130 WEST 19TH STREET, 5C",2006-08-22,1342053,2015-12-02,1825000,482947,3389,142.50427854824432
"327 CENTRAL PARK WEST, 9C",2010-05-03,950000,2016-06-27,1270000,320000,2247,142.41210502892747
"330 EAST 33RD STREET, 21-C",2005-01-04,890000,2018-08-30,1600000,710000,4986,142.39871640593663
"224 EAST 14TH   STREET, 2",2008-03-19,973680,2013-09-20,1260000,286320,2011,142.37692690203878
"2019 1 AVENUE, 8B",2013-03-13,753505,2017-06-16,975000,221495,1556,142.34897172236504
"165 CHARLES STREET, RU21",2006-06-28,7320606,2012-05-30,7628438,307832,2163,142.31715210355986
"1 IRVING PLACE, 25A",2005-11-15,980000,2016-05-11,1525000,545000,3830,142.2976501305483
"272 WATER STREET, 1F",2012-03-16,649136,2016-03-02,855000,205864,1447,142.2695231513476
"88 JANE STREET, 3W",2004-02-02,720000,2009-03-10,985000,265000,1863,142.24369296833066
"330 EAST 38TH STREET, 17B",2007-03-30,840000,2018-01-08,1400000,560000,3937,142.24028448056896
"510 EAST 80TH STREET, 5D",2013-02-21,635000,2015-07-20,760000,125000,879,142.2070534698521
"1400 5 AVENUE, 3B",2004-10-14,270950,2016-06-01,875000,604050,4248,142.1963276836158
"140 7 AVENUE, 6R",2003-09-24,410000,2004-04-22,440000,30000,211,142.18009478672985
"100 RIVERSIDE BOULEVARD, 19E",2008-06-30,1344090,2013-03-12,1588000,243910,1716,142.13869463869463
"668 RIVERSIDE DRIVE, 5I",2010-04-22,425000,2014-08-22,650000,225000,1583,142.1351863550221
"88 GREENWICH STREET, 1114",2009-12-02,670000,2017-06-08,1060000,390000,2745,142.07650273224044
"15 BROAD STREET, 2212",2006-11-07,1288086,2014-04-23,1675000,386914,2724,142.03891336270192
"8 UNION SQUARE SOUTH, 7B",2007-11-21,2209602,2016-09-01,2665000,455398,3207,142.0012472715934
"240 RIVERSIDE BOULEVARD, 15N-T",2005-12-21,860500,2016-06-21,1405000,544500,3835,141.98174706649283
"80 PARK AVENUE, 8B",2009-11-20,390390,2012-11-13,545000,154610,1089,141.9742883379247
"65 WORTH STREET, 2E",2007-08-20,2050000,2013-09-16,2365000,315000,2219,141.9558359621451
"101 WARREN STREET, 590",2008-06-23,1603743,2014-06-25,1915000,311257,2193,141.93205654354765
"100 RIVERSIDE BOULEVARD, 14R",2008-05-21,1425550,2014-11-03,1760000,334450,2357,141.89647857445905
"25 FIFTH AVENUE, 11G",2008-05-22,1257538,2013-01-18,1499000,241462,1702,141.8695652173913
"175 WEST 12TH   STREET, 4N",2011-02-25,505000,2016-03-03,765000,260000,1833,141.84397163120568
"120 RIVERSIDE BOULEVARD, 16D",2006-04-07,2016135,2016-07-28,2550000,533865,3765,141.79681274900398
"155 WEST 71 STREET, 4D",2004-07-15,890000,2013-11-26,1375000,485000,3421,141.7714118678749
"425 5 AVENUE, 21C",2004-06-24,476580,2008-05-29,680000,203420,1435,141.7560975609756
"184 THOMPSON STREET, 6N",2007-06-21,1104983,2014-10-23,1485000,380017,2681,141.74449832152183
"88 GREENWICH STREET, 1609",2009-09-29,710000,2017-12-15,1135000,425000,2999,141.7139046348783
"155 WEST 70TH STREET, 9D",2004-12-21,1500000,2011-07-18,1840000,340000,2400,141.66666666666666
"199 BOWERY, 3D",2006-05-03,845147,2015-01-12,1295000,449853,3176,141.64137279596977
"15 BROAD STREET, 1802",2006-05-01,580402,2013-12-18,975000,394598,2788,141.53443328550932
"1 IRVING PLACE, P25A",2007-02-21,950000,2015-01-29,1360000,410000,2899,141.4280786478096
"80 JOHN STREET, 6B",2007-01-30,885368,2016-08-29,1380000,494632,3499,141.36381823378107
"350 WEST 42ND   STREET, 57E",2008-04-09,1180000,2015-06-11,1550000,370000,2619,141.27529591447117
"280 PARK AVENUE SOUTH, 13L",2004-02-06,697501,2017-09-19,1400000,702499,4974,141.23421793325292
"16 WEST 19TH   STREET, 9-C",2008-04-11,1069162,2016-12-02,1515000,445838,3157,141.2220462464365
"301 CATHEDRAL PARKWAY, 2J",2014-01-28,637500,2018-06-27,865000,227500,1611,141.21663563004344
"249 EAST 118 STREET, 5B",2009-07-29,507000,2015-12-08,835000,328000,2323,141.19672836848903
"333 RECTOR PLACE, 1402",2012-10-15,525000,2018-08-10,825000,300000,2125,141.1764705882353
"306 WEST 97TH STREET, 51",2009-11-23,1071000,2013-07-24,1260000,189000,1339,141.15011202389843
"135 WEST 70TH STREET, 2E",2007-04-18,1650000,2017-12-18,2200000,550000,3897,141.13420579933282
"160 CENTRAL PARK SOUTH, 1601",2005-01-27,2000000,2012-02-09,2362500,362500,2569,141.10548851693267
"247 WEST 46TH   STREET, 2501",2009-01-16,1282995,2016-08-26,1675000,392005,2779,141.05973371716445
"2000 BROADWAY, 6F",2010-05-06,699000,2011-08-17,765000,66000,468,141.02564102564102
"310 WEST 52ND   STREET, 36C",2007-08-27,1020500,2014-05-06,1365000,344500,2444,140.95744680851064
"90 WILLIAM STREET, 6A",2008-07-15,1126184,2015-12-01,1506000,379816,2695,140.93358070500926
"14 WEST 14TH   STREET, 3A",2010-10-14,544763,2014-09-04,745000,200237,1421,140.91273750879662
"151 WEST 17TH   STREET, 1D",2007-02-21,2425000,2012-12-20,2725000,300000,2129,140.91122592766558
"104 WEST 70TH STREET, 9A",2008-04-15,888888,2017-07-17,1365000,476112,3380,140.86153846153846
"15 BROAD STREET, 2714",2006-08-02,1496549,2015-11-20,1975000,478451,3397,140.84515749190462
"200 RECTOR PLACE, 3V",2003-12-10,750000,2014-08-21,1300000,550000,3907,140.7729715894548
"220 RIVERSIDE BOULEVARD, 8D",2005-04-19,900000,2014-07-16,1375000,475000,3375,140.74074074074073
"200 WEST END AVENUE, 11L",2008-06-11,1360891,2016-03-17,1760000,399109,2836,140.72954866008462
"415 EAST 54TH   STREET, 3E",2011-09-07,805000,2016-12-08,1075000,270000,1919,140.69828035435123
"230 RIVERSIDE DRIVE, 6D",2007-03-13,1466280,2017-09-06,2005000,538720,3830,140.6579634464752
"106 CENTRAL PARK SOUTH, 12H",2008-10-15,900000,2010-02-25,970000,70000,498,140.56224899598394
"100 WEST 93RD ST, 7J",2007-01-24,760327,2014-04-07,1130000,369673,2630,140.56007604562737
"1623 3 AVENUE, 23K",2003-02-20,428011,2012-06-06,905000,476989,3394,140.53889216263994
"400 EAST 70TH STREET, 2904",2010-04-13,1075000,2017-08-03,1450000,375000,2669,140.50206069689023
"301 WEST 57TH   STREET, 44E",2008-11-17,1110000,2013-11-06,1365000,255000,1815,140.49586776859505
"309 WEST 118 STREET, 4K",2005-03-10,425980,2015-03-17,940000,514020,3659,140.48100573927303
"315 7 AVENUE, 8B",2003-07-15,415000,2014-11-10,995950,580950,4136,140.46179883945842
"295 GREENWICH STREET, 11FN",2005-02-03,650000,2007-05-03,765000,115000,819,140.41514041514043
"1 IRVING PLACE, P19F",2006-08-29,960000,2015-03-30,1400000,440000,3135,140.35087719298247
"220 MANHATTAN AVENUE, 4J",2003-02-10,227500,2007-05-03,444000,216500,1543,140.31108230719377
"458 WEST 146TH STREET, 2N",2006-10-17,890968,2016-03-29,1375000,484032,3451,140.25847580411474
"555 WEST 23RD   STREET, S15K",2007-02-01,1250000,2016-08-26,1740000,490000,3494,140.24041213508872
"350 ALBANY STREET, 11E",2009-11-03,440000,2015-05-29,725000,285000,2033,140.18691588785046
"100 UNITED NATIONS PLAZA, 14E",2004-06-29,1110000,2016-02-12,1705000,595000,4245,140.16489988221437
"280 PARK AVENUE SOUTH, 14C",2007-01-04,995000,2016-12-21,1505000,510000,3639,140.14839241549876
"160 CENTRAL PARK SOUTH, 2405",2005-09-26,275000,2017-12-12,900000,625000,4460,140.13452914798205
"130 WEST 12TH   STREET, 7A",2013-01-25,7250000,2017-12-15,7500000,250000,1785,140.0560224089636
"82 BEAVER STREET, 404",2006-11-22,479000,2008-09-02,570000,91000,650,140.0
"220 EAST 65TH   STREET, 14K",2008-07-29,1165000,2016-02-08,1550000,385000,2750,140.0
"500 WEST 43RD STREET, 21G",2011-08-31,225000,2018-03-21,560000,335000,2394,139.93316624895573
"340 CABRINI BOULEVARD, 603",2005-03-10,870603,2007-09-17,999450,128847,921,139.89902280130292
"225 EAST 34TH   STREET, 18G",2008-06-03,1145531,2014-07-23,1459000,313469,2241,139.87907184292726
"350 WEST 42ND   STREET, 55F",2006-12-12,865512,2016-06-06,1350000,484488,3464,139.86374133949192
"101 WARREN STREET, 5G",2008-04-11,3049658,2018-05-08,3563977,514319,3679,139.79858657243815
"350 ALBANY STREET, 2H",2012-03-09,430000,2015-09-17,609856,179856,1287,139.74825174825176
"212 WARREN STREET, 3L",2015-07-30,3818437,2017-07-26,3920000,101563,727,139.70151306740027
"170 EAST 87TH   STREET, W3A",2010-10-20,645000,2017-07-25,990000,345000,2470,139.67611336032388
"123 WASHINGTON STREET, 48G",2011-05-31,1354272,2014-12-15,1535000,180728,1294,139.6661514683153
"455 EAST 86TH STREET, 14A",2009-03-04,2575000,2013-08-01,2800000,225000,1611,139.66480446927375
"315 SEVENTH AVENUE, 15B",2007-05-02,640282,2014-04-16,995000,354718,2541,139.5977961432507
"300 EAST 33 STREET, 5-P",2005-05-04,625000,2006-06-02,680000,55000,394,139.59390862944161
"170 WEST 23RD   STREET, 5G",2011-08-05,600000,2016-06-30,850000,250000,1791,139.58682300390842
"99 JOHN STREET, 1811",2010-10-21,715000,2015-10-22,970000,255000,1827,139.57307060755338
"123 BAXTER STREET, 2A",2007-11-05,1771755,2016-03-31,2200000,428245,3069,139.53893776474422
"188 EAST 64TH STREET, 4003",2006-07-17,2215000,2018-01-08,2800000,585000,4193,139.51824469353684
"250 EAST 49TH   STREET, 5F",2010-06-03,862000,2016-01-28,1150000,288000,2065,139.4673123486683
"400 CENTRAL PARK WEST, 5W",2003-04-04,511671,2017-02-28,1220000,708329,5079,139.46229572750542
"225 WEST 60TH   STREET, 17E",2007-03-27,1501918,2017-01-05,2000000,498082,3572,139.44064949608062
"280 PARK AVENUE SOUTH, 3E",2007-09-04,850000,2015-03-30,1235000,385000,2764,139.29088277858176
"50 BAYARD STREET, 5B",2003-03-27,180000,2005-06-01,291000,111000,797,139.27227101631118
"20 PINE STREET, 2208",2012-12-14,827500,2016-05-06,999999,172499,1239,139.22437449556094
"350 WEST 42ND   STREET, 38H",2006-09-18,875695,2014-01-23,1249000,373305,2684,139.08532041728762
"164 PEARL STREET, 11F",2007-05-01,129000,2017-09-27,657500,528500,3802,139.00578642819568
"309 WEST 118 STREET, 3P",2005-03-29,359970,2014-04-21,820000,460030,3310,138.98187311178248
"101 WARREN STREET, 700",2008-07-08,1267721,2014-07-28,1575000,307279,2211,138.97738579828132
"845 UNITED NATIONS PLAZA, 24D",2004-03-30,1550000,2010-02-26,1850000,300000,2159,138.95321908290876
"2250 BROADWAY, 1K",2003-02-26,499000,2016-07-29,1180000,681000,4902,138.92288861689107
"10 WEST END AVENUE, 3K",2007-09-25,1369546,2017-10-17,1880000,510454,3675,138.89904761904762
"199 BOWERY, 3B",2006-05-10,430950,2017-06-22,995000,564050,4061,138.89436099482887
"333 EAST 109 STREET, 2E",2011-11-30,572256,2016-12-29,830000,257744,1856,138.8706896551724
"450 WEST 17TH   STREET, 1119",2008-12-16,1069162,2017-06-15,1500000,430838,3103,138.8456332581373
"77 WEST 55TH   STREET, 4D",2014-07-11,592000,2017-12-08,765000,173000,1246,138.84430176565007
"1619 3 AVENUE, 11J",2003-02-20,272920,2016-08-04,955000,682080,4914,138.8034188034188
"250 EAST 49TH   STREET, 12B",2010-05-25,767050,2015-12-24,1050000,282950,2039,138.7690044139284
"225 5 AVENUE, 10T",2006-12-15,936790,2014-02-14,1300000,363210,2618,138.73567608861725
"260 PARK AVENUE SOUTH, 11K",2006-05-22,957155,2015-02-19,1400000,442845,3195,138.6056338028169
"150 WEST 51 STREET, 16-1",2004-12-01,451118,2005-11-18,499900,48782,352,138.58522727272728
"779 RIVERSIDE DRIVE, A-31",2009-11-02,500000,2016-04-05,825000,325000,2346,138.53367433930094
"100 WEST 39TH   STREET, 35D",2012-07-19,635000,2014-07-11,735000,100000,722,138.50415512465375
"18 WEST 48TH STREET, 31C",2007-06-07,1208459,2015-03-04,1600000,391541,2827,138.50053059780686
"372 CENTRAL PARK WEST, 15N",2011-01-04,915000,2018-08-15,1300000,385000,2780,138.4892086330935
"75 WALL STREET, 36B",2011-01-20,1043706,2013-10-01,1180000,136294,985,138.36954314720813
"225 5 AVENUE, 6L",2007-02-16,3344951,2010-06-29,3515000,170049,1229,138.36371033360456
"300 EAST 55TH STREET, 11B",2005-03-17,1691416,2011-01-07,1985000,293584,2122,138.35249764373233
"350 EAST 62 STREET, 2G",2003-10-16,299000,2004-12-30,360000,61000,441,138.32199546485262
"303 EAST 33RD   STREET, 8D",2010-08-06,748413,2016-07-27,1050000,301587,2182,138.2158570119157
"130 WEST 79 STREET, 7F",2004-07-08,605000,2012-03-30,995000,390000,2822,138.19985825655564
"380 LENOX AVENUE, 7J",2008-03-07,861846,2018-07-02,1382500,520654,3769,138.14115149907138
"146 WEST 57TH STREET, 61E",2004-06-21,699000,2009-06-12,950000,251000,1817,138.13979086406164
"807 RIVERSIDE DRIVE, 3A",2009-07-28,220545,2016-04-20,560000,339455,2458,138.1021155410903
"100 UNITED NATIONS PLAZA, 16E",2006-04-10,1375000,2016-10-12,1905000,530000,3838,138.09275664408545
"455 MAIN STREET, 10F",2006-03-20,911333,2012-06-08,1225000,313667,2272,138.05765845070422
"660 RIVERSIDE DRIVE, 1B",2014-09-09,266175,2017-08-22,415000,148825,1078,138.05658627087197
"200 RECTOR PLACE, 35E",2005-12-15,1250000,2017-04-05,1820000,570000,4129,138.04795349963672
"327 CENTRAL PARK WEST, 5A",2004-10-21,2300000,2010-12-16,2610000,310000,2247,137.96172674677348
"1235 PARK AVENUE, 2A",2011-03-09,1390000,2014-05-12,1550000,160000,1160,137.93103448275863
"71 NASSAU STREET, PHC",2006-09-29,1960131,2014-06-26,2350000,389869,2827,137.9090909090909
"327 CENTRAL PARK WEST, 7D",2004-11-03,1014686,2015-12-21,1575000,560314,4065,137.83862238622388
"250 EAST 40 STREET, 34A",2004-07-07,539000,2006-10-27,655000,116000,842,137.76722090261282
"275 GREENWICH STREET, 2KS",2006-05-26,692500,2015-04-10,1139000,446500,3241,137.76612156741746
"8 UNION SQUARE SOUTH, 9B",2007-11-12,2372522,2015-05-14,2750000,377478,2740,137.76569343065694
"30 LITTLE WEST STREET, 25D",2012-09-28,770000,2015-04-30,900000,130000,944,137.71186440677965
"630 FIRST AVENUE, 16K",2004-11-01,740000,2015-05-19,1270000,530000,3851,137.62659049597508
"240 WEST END AVENUE, 5D",2011-09-07,770000,2013-10-09,875000,105000,763,137.61467889908258
"2 EAST 55TH   STREET, 918",2006-12-12,544763,2007-04-02,560037,15274,111,137.6036036036036
"10 WEST END AVENUE, 6A",2007-07-10,1272812,2018-05-30,1820000,547188,3977,137.58813175760625
"2628 BROADWAY, 12A",2008-09-25,2713636,2016-03-23,3090000,376364,2736,137.55994152046785
"56 PINE STREET, 10C",2005-09-21,329550,2007-08-16,425000,95450,694,137.53602305475505
"2628 BROADWAY, 9A",2008-08-19,2596537,2017-05-12,3035000,438463,3188,137.53544542032623
"99 JOHN STREET, 320",2011-02-18,675000,2015-07-07,895000,220000,1600,137.5
"45 CHRISTOPHER STREET, 6G",2005-06-30,1250000,2018-06-19,1901250,651250,4737,137.481528393498
"333 EAST 45TH STREET, 5D",2011-05-11,515000,2014-09-29,685000,170000,1237,137.429264349232
"120 RIVERSIDE BOULEVARD, 9R",2006-02-10,865105,2013-05-21,1230000,364895,2657,137.3334587881069
"301 CATHEDRAL PARKWAY, 7D",2010-06-02,375180,2015-04-27,621000,245820,1790,137.3296089385475
"400 CENTRAL PARK WEST, 6G",2012-12-04,565000,2017-04-24,785000,220000,1602,137.32833957553058
"1 IRVING PLACE, U8L",2006-09-26,900000,2015-09-18,1350000,450000,3279,137.2369624885636
"26 WEST 97TH STREET, 2C",2015-04-30,660000,2017-08-15,775000,115000,838,137.23150357995226
"161 HUDSON STREET, 5D",2006-04-06,1360000,2018-08-20,1980000,620000,4519,137.19849524231026
"1965 BROADWAY, 9K",2004-06-11,752000,2014-05-20,1250000,498000,3630,137.1900826446281
"394 MANHATTAN AVENUE, 4",2007-01-23,749000,2016-04-07,1210000,461000,3362,137.12076145151696
"310 WEST 52ND   STREET, 38B",2007-08-22,2179055,2013-01-18,2450000,270945,1976,137.11791497975707
"76 MADISON AVENUE, 4C",2007-04-26,997885,2013-11-07,1325000,327115,2387,137.04021784666946
"200 RIVERSIDE BOULEVARD, 20C",2007-05-04,1055000,2015-03-26,1450000,395000,2883,137.01005896635448
"280 PARK AVENUE SOUTH, 11D",2005-12-01,730000,2015-08-11,1215000,485000,3540,137.00564971751413
"768 5 AVENUE, 1603",2015-07-06,10000000,2018-07-05,10150000,150000,1095,136.986301369863
"500 WEST 43RD   STREET, 3A",2009-10-01,1125000,2012-07-19,1265000,140000,1022,136.986301369863
"311 EAST 38TH STREET, 18A",2005-09-28,640000,2007-07-10,729000,89000,650,136.92307692307693
"75 WALL STREET, 31O",2010-11-24,1751390,2014-05-15,1925000,173610,1268,136.91640378548897
"245 EAST 93 STREET, 19E",2006-06-01,1125000,2017-12-01,1700000,575000,4201,136.8721732920733
"115 NORFOLK STREET, 102",2011-09-07,997885,2016-12-21,1262000,264115,1932,136.70548654244305
"25 MURRAY STREET, 3E",2008-07-17,1858306,2013-03-08,2090000,231694,1695,136.69262536873157
"144 WEST 27TH   STREET, 2R",2011-03-31,2250000,2013-04-01,2350000,100000,732,136.6120218579235
"100 RIVERSIDE BOULEVARD, 18D",2008-06-05,1863397,2017-05-19,2310000,446603,3270,136.57584097859328
"325 FIFTH AVENUE, 37D",2007-01-25,1781937,2017-06-15,2300000,518063,3794,136.5479704797048
"2 COLUMBUS AVENUE, 3C",2004-06-30,1138000,2009-10-01,1400000,262000,1919,136.529442417926
"80 RIVERSIDE BOULEVARD, 9E",2009-08-25,2060938,2017-12-14,2475000,414062,3033,136.51895812726673
"40 BROAD STREET, 14C",2011-08-10,501930,2014-04-11,635000,133070,975,136.4820512820513
"333 EAST 109 STREET, PHD",2011-08-23,529490,2017-06-28,821000,291510,2136,136.47471910112358
"393 WEST 49TH STREET, 2G",2008-09-25,925000,2018-06-19,1410000,485000,3554,136.4659538548115
"1991 BROADWAY, 14B",2006-09-01,1032500,2015-09-30,1485000,452500,3316,136.45958986731
"310 WEST 52ND   STREET, 19C",2007-07-27,901151,2013-12-19,1220000,318849,2337,136.43517329910142
"305 EAST 108 STREET, 3C",2003-09-04,525000,2018-03-23,1250000,725000,5314,136.43206624012043
"300 RECTOR PLACE, 7H",2005-05-25,435000,2008-01-03,565000,130000,953,136.41133263378805
"150 WEST 51ST   STREET, 21-10",2010-04-26,530000,2012-12-04,660000,130000,953,136.41133263378805
"333 RECTOR PLACE, 407",2011-05-09,461370,2013-10-02,581000,119630,877,136.40820980615734
"650 AVENUE OF THE AMER, 3E",2011-06-28,2238614,2014-06-06,2385000,146386,1074,136.2998137802607
"108 WEST 138 STREET, 4A",2013-07-22,299130,2017-08-04,500000,200870,1474,136.2754409769335
"45 WARREN STREET, 4",2005-09-12,3850000,2011-09-23,4150000,300000,2202,136.23978201634878
"106 CENTRAL PARK SOUTH, 20L",2009-12-07,615000,2013-08-27,800000,185000,1359,136.12950699043415
"135 EAST 54TH STREET, 5M",2004-11-15,510000,2007-06-28,640000,130000,955,136.12565445026178
"400 CENTRAL PARK WEST, 7Y",2009-11-19,532000,2018-03-12,945000,413000,3035,136.07907742998353
"120 EAST 87TH   STREET, R6-E",2010-06-17,767500,2013-06-05,915000,147500,1084,136.070110701107
"300 ALBANY STREET, 4A",2003-03-27,210000,2003-08-21,230000,20000,147,136.05442176870747
"45 CHRISTOPHER STREET, 7G",2006-09-14,1350000,2018-05-22,1930000,580000,4268,135.8950328022493
"41 SPRING STREET, 2A",2004-01-15,372500,2015-01-26,920000,547500,4029,135.8897989575577
"120 RIVERSIDE BOULEVARD, PH3C",2006-03-14,1415367,2014-12-16,1850000,434633,3199,135.86527039699905
"1641 3 AVENUE, 17J",2003-02-20,253046,2010-11-16,637000,383954,2826,135.86482661004953
"80 PARK AVENUE, 16P",2003-04-23,492500,2013-12-10,1020000,527500,3884,135.81359423274975
"101 WARREN STREET, 550",2008-06-19,1868488,2012-02-16,2050000,181512,1337,135.76065818997756
"1760 2 AVENUE, 27A",2005-06-28,1801000,2016-07-25,2350000,549000,4045,135.7231149567367
"225 EAST 34TH   STREET, 6B",2008-07-09,952063,2015-05-05,1290000,337937,2491,135.66318747490968
"48 WEST 138 STREET, 3K",2014-02-10,271890,2017-11-28,460000,188110,1387,135.62364816149963
"220 RIVERSIDE BOULEVARD, 29F",2006-09-30,960000,2015-04-08,1382000,422000,3112,135.60411311053986
"260 PARK AVENUE SOUTH, 2D",2006-03-29,2341975,2009-12-08,2525000,183025,1350,135.57407407407408
"780 WEST END AVENUE, 3D",2004-09-08,915000,2015-06-30,1450000,535000,3947,135.54598429186723
"15 BROAD STREET, 1201",2006-07-12,539672,2015-04-30,975000,435328,3214,135.4474175482265
"205 WEST 76TH   STREET, 1203",2009-10-14,1285957,2015-07-31,1572500,286543,2116,135.41729678638941
"170 EAST 87TH STREET, W3E",2010-08-05,955000,2014-07-15,1150000,195000,1440,135.41666666666666
"415 MAIN STREET, PH1-E",2011-09-06,532000,2017-08-09,825000,293000,2164,135.3974121996303
"60 RIVERSIDE BOULEVARD, 2008",2011-07-15,960155,2014-05-13,1100000,139845,1033,135.37754114230398
"2628 BROADWAY, 6A",2007-10-11,1298268,2013-07-31,1585000,286732,2120,135.2509433962264
"120 RIVERSIDE BOULEVARD, 10H",2006-07-28,803521,2014-10-30,1211437,407916,3016,135.25066312997347
"2 COLUMBUS AVENUE, 4E",2003-07-10,557000,2014-04-24,1090000,533000,3941,135.24486171022582
"25 CENTRAL PARK WEST, 2U",2013-05-15,925000,2016-11-29,1100000,175000,1294,135.23956723338486
"715 PARK AVENUE, 2E",2004-10-27,775000,2012-05-31,1150000,375000,2773,135.23260007212406
"25 CENTRAL PARK WEST, 17U",2007-05-22,790000,2009-08-20,901000,111000,821,135.20097442143728
"165 EAST 104 STREET, 2A",2014-11-18,375000,2017-11-17,523000,148000,1095,135.15981735159818
"23 WEST 116 STREET, 3C",2015-02-25,1099710,2018-08-08,1270000,170290,1260,135.15079365079364
"250 EAST 40 STREET, 30B",2004-11-05,790000,2008-11-24,990000,200000,1480,135.13513513513513
"220 RIVERSIDE BOULEVARD, 37C",2005-05-24,1950000,2010-06-17,2200000,250000,1850,135.13513513513513
"304 BOWERY, 5B",2005-07-06,1374637,2015-08-26,1875000,500363,3703,135.12368349986497
"200 EAST 61ST   STREET, 41EE",2007-11-19,2050000,2015-06-26,2425000,375000,2776,135.0864553314121
"250 EAST 40TH STREET, 45A",2006-08-15,1322500,2018-05-01,1900000,577500,4277,135.02454991816694
"350 WEST 50 STREET, 6Q",2003-09-12,263640,2006-08-31,410000,146360,1084,135.01845018450186
"200 CHAMBERS STREET, 6B",2007-03-22,1568105,2013-02-21,1860000,291895,2163,134.94914470642627
"101 WEST 24TH   STREET, 4A",2012-04-30,1210000,2018-01-04,1490000,280000,2075,134.93975903614458
"57 WEST 58TH STREET, 10F",2009-07-13,375000,2014-04-22,610333,235333,1744,134.93864678899084
"125 WEST 22ND STREET, 9A",2008-05-05,1135348,2016-04-01,1525000,389652,2888,134.92105263157896
"215 EAST 80TH STREET, 10M",2004-08-24,449000,2008-06-03,635000,186000,1379,134.8803480783176
"502 PARK AVENUE, 12K",2004-09-23,749432,2018-06-11,1425000,675568,5009,134.87083250149732
"455 CENTRAL PARK WEST, 16A",2005-10-31,2428526,2013-07-30,2810000,381474,2829,134.8441145281018
"144 COLUMBUS AVENUE, 20E",2007-06-26,990000,2009-08-13,1095000,105000,779,134.78818998716304
"117 EAST 57 STREET, 32G",2004-09-22,720000,2007-10-10,870000,150000,1113,134.77088948787062
"43 EAST 25TH   STREET, 10C",2011-04-25,740000,2016-07-29,999000,259000,1922,134.75546305931323
"25 MURRAY STREET, 2F",2008-07-22,1501918,2012-07-31,1700000,198082,1470,134.74965986394557
"50 WEST 127TH STREET, 4C",2007-09-25,799326,2014-11-10,1150000,350674,2603,134.71917018824433
"106 CENTRAL PARK SOUTH, 2E",2010-10-19,535000,2016-11-23,835000,300000,2227,134.7103726986978
"1 IRVING PLACE, G12I",2012-08-15,575000,2018-03-19,850000,275000,2042,134.6718903036239
"502 PARK AVENUE, 17A",2004-05-10,4073000,2016-02-03,4650000,577000,4286,134.62435837610826
"322 WEST 57TH   STREET, 49V",2010-02-24,738000,2016-09-12,1060000,322000,2392,134.6153846153846
"17 CORNELIA STREET, 1A",2003-07-15,699000,2018-04-23,1425000,726000,5396,134.5441067457376
"43 EAST 25TH   STREET, 16E",2007-03-02,425000,2008-05-21,485000,60000,446,134.52914798206277
"164 BANK STREET, 3A",2005-01-28,740000,2013-09-27,1165395,425395,3164,134.4484829329962
"280 RECTOR PLACE, 8A",2012-07-31,412000,2016-08-12,610000,198000,1473,134.41955193482687
"15 BROAD STREET, 1400",2006-06-13,804417,2012-06-20,1100000,295583,2199,134.4170077307867
"192 LENOX AVENUE, PHB",2015-12-09,766935,2016-08-11,800000,33065,246,134.41056910569105
"146 WEST 57TH STREET, 49F",2005-02-07,679000,2009-07-22,897500,218500,1626,134.37884378843788
"200 CHAMBERS STREET, 4E",2007-03-27,687318,2013-10-08,1008000,320682,2387,134.34520318391287
"15 BROAD STREET, 1822",2006-05-09,461370,2016-07-08,960000,498630,3713,134.2930245084837
"120 RIVERSIDE BOULEVARD, 10F",2006-03-02,986684,2013-07-30,1350000,363316,2707,134.2135205024012
"10 WEST END AVENUE, 4A",2007-11-01,1252447,2018-08-08,1780000,527553,3933,134.1350114416476
"515 EAST 72ND STREET, 29F",2014-05-21,1980000,2017-05-25,2127500,147500,1100,134.0909090909091
"15 BROAD STREET, 2204",2006-06-15,813897,2017-09-15,1365000,551103,4110,134.0883211678832
"524 EAST 72 STREET, 24F",2003-09-15,349000,2006-09-08,495000,146000,1089,134.06795224977043
"200 CHAMBERS STREET, 8F",2007-05-03,959191,2017-11-16,1475000,515809,3850,133.97636363636363
"1890 ADAM C POWELL BLVD, 3A",2014-06-18,956136,2017-11-30,1125000,168864,1261,133.91276764472642
"261 WEST 28TH STREET, 4E",2007-12-05,1496827,2015-02-24,1850000,353173,2638,133.87907505686127
"20 WEST STREET, 14E",2006-07-27,451230,2007-06-19,495000,43770,327,133.85321100917432
"630 1 AVENUE, 25E",2003-03-28,575000,2017-01-17,1250000,675000,5044,133.8223632038065
"153 EAST 87TH   STREET, 2D",2009-11-02,640000,2018-02-15,1045000,405000,3027,133.7958374628345
"201 WEST 74TH   STREET, 16D",2009-08-11,600000,2017-04-14,975000,375000,2803,133.7852301105958
"211 EAST 46TH   STREET, 32B",2009-07-02,646588,2017-07-21,1040000,393412,2941,133.76810608636518
"148 MADISON STREET, 10G",2003-10-09,354900,2004-08-04,395000,40100,300,133.66666666666666
"5 EAST 22ND   STREET, 14-G",2010-01-29,750000,2012-05-31,864000,114000,853,133.6459554513482
"2109 BROADWAY, 9-131",2009-03-18,890000,2010-08-24,960000,70000,524,133.58778625954199
"199 BOWERY, 10D",2006-07-06,916425,2014-08-19,1312500,396075,2966,133.5384356035064
"455 MAIN STREET, 12C",2006-03-23,436020,2014-07-07,840000,403980,3028,133.41479524438574
"1641 3 AVENUE, 12K",2004-11-03,625000,2009-10-07,865000,240000,1799,133.40744858254587
"121 WEST 132 STREET, 1",2010-01-21,480000,2018-03-02,875000,395000,2962,133.35584064821066
"352 CATHEDRAL PARKWAY, 15A",2006-03-13,733140,2018-05-11,1325000,591860,4442,133.24178298063936
"200 WEST END AVENUE, 17C",2008-10-15,2026317,2018-07-12,2500000,473683,3557,133.1692437447287
"203 WEST 81ST STREET, 8E",2010-04-30,860000,2013-03-13,999500,139500,1048,133.11068702290078
"845 UNITED NATIONS PLAZA, 36E",2004-04-16,1426000,2012-05-25,1820000,394000,2961,133.06315433975007
"845 UNITED NATIONS PLAZA, 10E",2004-04-13,1350000,2009-12-10,1625000,275000,2067,133.04305757135947
"350 WEST 42ND STREET, 40G",2006-09-11,1563013,2013-07-12,1895000,331987,2496,133.00761217948718
"280 RECTOR PLACE, 7N",2004-05-25,380000,2007-04-13,520000,140000,1053,132.95346628679962
"2000 BROADWAY, 10F",2005-05-09,1880000,2012-12-21,2250000,370000,2783,132.9500538986705
"225 EAST 34TH   STREET, 2K",2008-05-22,847693,2016-04-07,1230000,382307,2877,132.8839068474105
"444 EAST 57TH STREET, 3D",2011-02-25,1490000,2015-12-30,1725000,235000,1769,132.84341435839457
"2628 BROADWAY, 4A",2007-10-02,1216808,2012-07-23,1450000,233192,1756,132.79726651480638
"150 NASSAU STREET, 9H",2003-03-14,656771,2010-07-07,1011500,354729,2672,132.75785928143713
"155 WEST 70TH STREET, 7G",2005-09-20,565000,2008-07-03,700000,135000,1017,132.7433628318584
"200 CHAMBERS STREET, 3U",2007-03-30,722957,2017-01-30,1200000,477043,3594,132.73316638842516
"640 WEST END AVENUE, 9A",2005-08-26,2495000,2014-06-02,2920000,425000,3202,132.72954403497815
"111 EAST 30TH   STREET, 11A",2007-06-29,1500000,2013-07-30,1795000,295000,2223,132.70355375618533
"78 RIDGE STREET, 5F",2010-06-11,521000,2017-07-28,866500,345500,2604,132.68049155145928
"111 EAST 30TH STREET, 3C",2014-06-30,1205000,2018-07-09,1400000,195000,1470,132.6530612244898
"120 RIVERSIDE BOULEVARD, 16J",2006-03-07,1270776,2014-01-03,1650000,379224,2859,132.64218258132215
"11 EAST 29TH   STREET, 22B",2008-01-31,971410,2015-09-10,1340000,368590,2779,132.63404102195034
"2000 BROADWAY, 5I",2007-12-17,970000,2017-12-21,1455000,485000,3657,132.6223680612524
"67 HUDSON STREET, 2A",2006-12-22,1100000,2012-06-12,1365000,265000,1999,132.56628314157078
"99 JOHN STREET, 1807",2011-01-20,630000,2017-10-03,954500,324500,2448,132.55718954248366
"1 IRVING PLACE, G18H",2009-12-21,565000,2014-10-29,800000,235000,1773,132.54371122391427
"261 WEST 112 STREET, 4C",2010-06-29,447000,2015-08-14,695000,248000,1872,132.47863247863248
"200 RECTOR PLACE, 23L",2011-04-19,500000,2017-03-10,785000,285000,2152,132.43494423791822
"200 RIVERSIDE BOULEVARD, 8K",2004-08-17,1665000,2010-08-16,1955000,290000,2190,132.4200913242009
"630 1 AVENUE, 23J",2003-09-22,257504,2015-11-17,845000,587496,4439,132.34872719080875
"301 CATHEDRAL PARKWAY, 3A",2012-06-06,385000,2017-08-08,635000,250000,1889,132.34515616728427
"240 RIVERSIDE BOULEVARD, 5 G",2008-08-20,1355000,2017-06-06,1780000,425000,3212,132.31631382316314
"200 EAST 89TH   STREET, 19F",2010-07-20,645000,2016-01-22,911000,266000,2012,132.20675944333996
"59 WEST 12TH STREET, 9C",2005-06-24,1800000,2009-07-08,1995000,195000,1475,132.20338983050848
"250 EAST 53RD STREET, 3003",2008-07-22,1397602,2015-05-06,1725000,327398,2479,132.0685760387253
"45 WEST 67TH STREET, 24C",2009-06-22,890000,2018-03-09,1310000,420000,3182,131.99245757385293
"350 WEST 42ND   STREET, 21L",2006-12-28,965000,2011-07-22,1185000,220000,1667,131.9736052789442
"215 AVENUE B, 1004",2010-09-20,438000,2015-04-14,658000,220000,1667,131.9736052789442
"255 EAST 49TH   STREET, 15B",2009-02-27,712775,2013-11-08,939000,226225,1715,131.90962099125363
"40 BROAD STREET, 16F",2012-03-01,891019,2014-05-29,999000,107981,819,131.84493284493286
"15 BROAD STREET, 2302",2006-07-24,661862,2011-12-22,922500,260638,1977,131.83510369246332
"205 WEST 76TH   STREET, 9D",2009-10-29,1278671,2015-06-19,1550000,271329,2059,131.77707625060708
"524 EAST 72ND   STREET, 24A",2012-09-11,815000,2017-05-16,1040000,225000,1708,131.73302107728338
"59 JOHN STREET, 8E",2010-08-30,850000,2015-02-18,1065000,215000,1633,131.6595223515003
"635 WEST 42ND STREET, 26A",2007-09-21,1028432,2017-07-12,1500000,471568,3582,131.64935790061418
"502 PARK AVENUE, 11F",2005-03-15,952063,2012-02-16,1285000,332937,2529,131.64768683274022
"301 EAST 79TH   STREET, 9 M",2011-10-31,650000,2015-02-20,809000,159000,1208,131.6225165562914
"455 MAIN STREET, 12F",2006-04-06,334620,2017-12-21,897500,562880,4277,131.60626607435117
"108 FIFTH AVENUE, 19B",2006-07-18,1425000,2012-07-31,1715000,290000,2205,131.51927437641723
"420 WEST 23RD   STREET, 8B",2013-01-28,789000,2017-12-20,1023975,234975,1787,131.49132624510352
"301 EAST 79TH   STREET, 30 K",2006-11-27,218223,2013-10-10,548000,329777,2509,131.4376245516142
"322 WEST 57TH   STREET, 40U2",2008-06-10,5293146,2013-04-09,5525000,231854,1764,131.43650793650792
"502 PARK AVENUE, 19F",2007-11-19,1858306,2015-07-10,2225000,366694,2790,131.431541218638
"200 WEST END AVENUE, 15C",2008-04-17,2341975,2013-07-26,2595000,253025,1926,131.37331256490134
"254 WEST 10TH STREET, 5B",2006-07-06,1261000,2017-09-29,1800000,539000,4103,131.36729222520108
"111 CENTRAL PARK NORTH, 18C",2008-01-17,2341975,2016-04-15,2737500,395525,3011,131.36001328462305
"200 EAST 61ST STREET, 36F",2010-03-29,885000,2013-06-21,1040000,155000,1180,131.35593220338984
"1031 6 AVENUE, 41H",2006-07-25,692410,2008-08-06,790000,97590,743,131.34589502018844
"421 WEST 54TH   STREET, 3E",2008-02-25,987702,2016-08-22,1395000,407298,3101,131.34408255401485
"2628 BROADWAY, 7A",2007-10-19,1318633,2015-10-01,1700000,381367,2904,131.32472451790633
"1400 FIFTH AVENUE, 6K",2004-12-15,299425,2015-09-01,813000,513575,3912,131.28195296523518
"118 WOOSTER STREET, 5B",2006-01-31,1355000,2014-04-28,1750000,395000,3009,131.27284812229976
"330 EAST 49TH STREET, 8M",2007-05-18,202275,2015-06-19,590000,387725,2954,131.25423155044007
"125 WEST 22ND STREET, 8A",2008-04-11,1013158,2013-03-21,1250000,236842,1805,131.21440443213297
"610 CATHEDRAL PARKWAY, 14B",2009-01-07,946972,2014-10-27,1225000,278028,2119,131.20717319490325
"130 WEST 19TH   STREET, 8D",2007-05-18,1603743,2017-06-02,2085000,481257,3668,131.20419847328245
"555 WEST 59TH STREET, 12A",2008-04-24,921516,2016-06-02,1310000,388484,2961,131.20027017899358
"40 WEST 116 STREET, B804",2008-10-29,143070,2012-01-27,298524,155454,1185,131.18481012658228
"475 GREENWICH STREET, 4D",2008-07-16,1934675,2012-07-06,2125000,190325,1451,131.1681598897312
"505 GREENWICH STREET, 7G",2004-12-16,784052,2017-04-18,1375000,590948,4506,131.14691522414557
"350 EAST 82ND STREET, 3V",2007-12-28,1120075,2015-12-04,1500000,379925,2898,131.09903381642513
"48 WEST 138 STREET, 4F",2013-10-15,193467,2015-09-14,285000,91533,699,130.94849785407726
"15 BROAD STREET, 1428",2006-11-15,463303,2013-01-28,760000,296697,2266,130.9342453662842
"200 WEST END AVENUE, 14J",2008-03-31,1091564,2015-02-12,1420000,328436,2509,130.9031486648067
"301 EAST 79TH   STREET, 7 D",2012-12-19,645000,2017-08-15,867500,222500,1700,130.88235294117646
"200 CHAMBERS STREET, 2K",2007-01-31,738231,2015-04-14,1130000,391769,2995,130.8076794657763
"346 EAST 119 STREET, 5A",2012-03-27,405600,2016-02-05,590000,184400,1410,130.78014184397162
"1965 BROADWAY, 10G",2003-06-26,782000,2017-10-13,1465000,683000,5223,130.76775799349033
"105 WEST 77TH STREET, 3D",2014-11-21,583000,2018-08-06,760000,177000,1354,130.72378138847859
"230 RIVERSIDE DRIVE, 4O",2006-12-14,957155,2008-05-16,1025000,67845,519,130.72254335260115
"52 EAST END AVENUE, 21C",2006-07-18,740000,2015-08-28,1175000,435000,3328,130.7091346153846
"900 PARK AVENUE, 22B",2003-12-09,350000,2012-04-26,750000,400000,3061,130.67624959163672
"157 EAST 72ND STREET, 1E",2016-05-03,655000,2018-04-30,750000,95000,727,130.67400275103165
"62 EAST 1ST STREET, 4S",2009-02-03,1245319,2015-01-22,1530000,284681,2179,130.64754474529602
"16 WEST 19TH   STREET, 10-E",2007-09-24,1084436,2013-03-12,1345000,260564,1996,130.5430861723447
"692 BROADWAY, 1117",2008-01-31,1575000,2013-11-07,1850000,275000,2107,130.5173232083531
"420 WEST 25TH   STREET, 5G",2008-04-07,1781937,2014-12-12,2100000,318063,2440,130.35368852459015
"515 EAST 72ND   STREET, 7A",2012-06-08,687318,2015-03-24,820000,132682,1019,130.2080471050049
"100 ELEVENTH AVENUE, 16B",2010-04-15,2018250,2012-01-03,2100000,81750,628,130.1751592356688
"322 WEST 57TH   STREET, 27F",2008-01-31,753505,2014-11-05,1075000,321495,2470,130.15991902834008
"100 WEST 89TH   STREET, 5N",2008-11-18,1780000,2015-08-13,2100000,320000,2459,130.13420089467263
"217 WEST 14TH STREET, 3F",2006-01-26,630000,2017-01-06,1150000,520000,3998,130.06503251625813
"311 WEST BROADWAY, 5C",2010-09-02,2163781,2013-06-07,2295000,131219,1009,130.04856293359762
"415 EAST 37TH   STREET, 15L",2013-07-02,960000,2017-10-26,1165000,205000,1577,129.99365884590995
"240 PARK AVENUE SOUTH, 2A",2008-09-22,2575000,2013-04-03,2790000,215000,1654,129.98790810157195
"263 9 AVENUE, 7D",2006-01-24,1578287,2014-06-04,1975000,396713,3053,129.94202423845397
"377 RECTOR PLACE, 14F",2005-11-15,304200,2017-05-17,850000,545800,4201,129.92144727445847
"101 WARREN STREET, 1000",2008-07-30,1344090,2016-08-09,1725000,380910,2932,129.91473396998634
"382 CENTRAL PARK WEST, 15G",2004-06-15,360000,2008-10-10,565000,205000,1578,129.91128010139417
"125 EAST 12TH   STREET, 1-A",2007-07-27,2625000,2014-06-02,2950000,325000,2502,129.8960831334932
"164 PEARL STREET, 4E",2005-09-29,385000,2006-10-19,435000,50000,385,129.87012987012986
"1641 3 AVENUE, 9J",2003-02-20,241688,2015-12-11,849000,607312,4677,129.85075903356852
"130 WATER STREET, 7E",2015-08-31,499000,2018-06-25,632500,133500,1029,129.73760932944606
"350 WEST 42ND STREET, 43F",2007-04-03,920000,2015-10-20,1325000,405000,3122,129.72453555413196
"129 LAFAYETTE STREET, 9B",2005-01-05,1069162,2009-04-24,1272812,203650,1570,129.71337579617835
"15 BROAD STREET, 2630",2006-11-27,855330,2014-09-17,1225000,369670,2851,129.6632760434935
"130 BARROW STREET, 209",2013-07-10,1148000,2016-03-16,1275000,127000,980,129.59183673469389
"237 WEST 19TH STREET, B",2006-05-04,885000,2018-04-11,1450000,565000,4360,129.58715596330276
"225 EAST 34TH   STREET, PHD",2008-02-08,977520,2015-12-23,1350000,372480,2875,129.55826086956523
"322 WEST 57TH   STREET, 46K",2011-04-18,809508,2017-06-08,1100000,290492,2243,129.510477039679
"175 WEST 12TH STREET, 4B",2005-07-14,867260,2012-06-18,1195000,327740,2531,129.49032003160806
"120 RIVERSIDE BOULEVARD, 14T",2006-04-12,1192574,2014-11-25,1600000,407426,3149,129.38266116227373
"50 BAYARD STREET, 7F",2005-12-22,365000,2008-05-29,480000,115000,889,129.35883014623172
"555 WEST 59TH STREET, 27A",2008-05-01,2097595,2014-09-26,2400000,302405,2339,129.28815733219324
"322 WEST 57TH   STREET, 23B2",2008-02-27,1807393,2012-03-27,2000000,192607,1490,129.26644295302015
"15 WEST 63RD STREET, 20C",2007-01-17,1675000,2009-09-10,1800000,125000,967,129.26577042399174
"57 READE STREET, 21A",2012-09-06,1921100,2018-04-10,2185000,263900,2042,129.2360430950049
"345 EAST 80TH   STREET, 30F",2007-01-17,950000,2015-08-17,1355000,405000,3134,129.2278238672623
"200 CHAMBERS STREET, 7B",2007-04-19,1583378,2012-06-01,1825000,241622,1870,129.2096256684492
"73 WORTH STREET, 4D",2015-12-02,2800000,2018-06-18,2920000,120000,929,129.17115177610333
"212 EAST 57TH STREET, 9A",2012-06-11,1600000,2016-02-26,1775000,175000,1355,129.15129151291512
"59 WEST 12TH   STREET, 6G",2008-07-31,1220000,2015-11-25,1565000,345000,2673,129.06846240179573
"425 5 AVENUE, 31E",2004-04-28,641498,2017-10-06,1275000,633502,4909,129.0490935017315
"200 EAST 28TH STREET, 4G",2008-01-28,500000,2010-11-01,630000,130000,1008,128.96825396825398
"200 WEST END AVENUE, 15B",2008-04-18,1058980,2013-05-31,1300000,241020,1869,128.95666131621186
"2110 FREDERICK DOUGLAS BL, 2C",2010-08-18,755541,2011-06-20,795000,39459,306,128.95098039215685
"555 WEST 23RD   STREET, N11H",2007-02-26,1250000,2009-10-23,1375000,125000,970,128.8659793814433
"340 EAST 23RD STREET, 2D",2008-02-20,1420458,2017-06-23,1860000,439542,3411,128.86015831134566
"200 RIVERSIDE BOULEVARD, 17J-T",2004-05-19,1070000,2012-06-15,1450000,380000,2949,128.85723974228551
"120 RIVERSIDE BOULEVARD, PH2H",2006-05-08,1480942,2009-12-10,1650000,169058,1312,128.85518292682926
"250 EAST 40TH   STREET, 24F",2009-10-06,805000,2015-04-16,1065000,260000,2018,128.8404360753221
"2250 BROADWAY, 11D",2004-06-07,950000,2011-11-15,1300000,350000,2717,128.81854987118146
"101 WEST 24TH   STREET, 31H",2008-08-27,1165896,2010-12-22,1275000,109104,847,128.81227863046044
"1623 3 AVENUE, 35G",2003-02-20,314443,2016-11-10,960000,645557,5012,128.80227454110135
"392 CENTRAL PARK WEST, 19L",2009-08-21,505000,2017-05-25,870000,365000,2834,128.79322512350035
"1438 THIRD AVENUE, 14E",2007-07-02,930269,2018-02-15,1430000,499731,3881,128.76346302499357
"80 JOHN STREET, 9G",2007-06-26,941626,2015-09-29,1330000,388374,3017,128.72853828306265
"2628 BROADWAY, 2B",2007-11-06,1858306,2013-07-09,2125000,266694,2072,128.71332046332046
"200 CHAMBERS STREET, 25E",2007-05-24,1980496,2012-11-21,2238888,258392,2008,128.6812749003984
"214 EAST 70TH   STREET, 2-FL",2007-05-29,1805000,2016-05-05,2225000,420000,3264,128.6764705882353
"300 EAST 23RD STREET, 3H",2011-08-09,752486,2018-02-23,1060000,307514,2390,128.66694560669455
"10 WEST END AVENUE, 25B",2007-08-21,1698135,2014-01-23,2000000,301865,2347,128.6173838943332
"200 RIVERSIDE BOULEVARD, 45C",2007-04-27,1450000,2018-05-22,1970000,520000,4043,128.61736334405145
"415 MAIN STREET, PH2-E",2012-05-29,549855,2016-01-12,720010,170155,1323,128.6130007558579
"392 CENTRAL PARK WEST, 12M",2004-03-02,514216,2017-08-08,1145000,630784,4907,128.5477888730385
"130 WEST 79TH STREET, 14A",2007-02-28,730000,2016-02-09,1150000,420000,3268,128.51897184822522
"502 9 AVENUE, 9B",2013-03-21,966319,2017-06-14,1165000,198681,1546,128.51293661060802
"2109 BROADWAY, 31959",2008-10-15,737500,2010-12-22,840000,102500,798,128.44611528822054
"1600 BROADWAY, 9D",2006-12-21,748413,2010-11-04,930000,181587,1414,128.42079207920793
"250 EAST 53RD   STREET, 1702",2013-06-13,2170000,2017-07-21,2362500,192500,1499,128.41894596397597
"20 PINE STREET, 2308",2010-02-25,763687,2014-07-21,970000,206313,1607,128.38394523957686
"211 EAST 46TH   STREET, 31D",2010-09-03,709000,2015-07-15,937000,228000,1776,128.3783783783784
"252 7 AVENUE, 7Y",2003-07-29,775000,2011-11-22,1165000,390000,3038,128.3739302172482
"595 WEST END AVENUE, 1A",2012-09-05,686205,2014-05-12,765000,78795,614,128.33061889250814
"25 COLUMBUS CIRCLE, ST51F",2004-04-01,579149,2006-10-30,700000,120851,942,128.291932059448
"145 EAST 48TH STREET, 32D",2004-08-10,660000,2014-06-17,1121500,461500,3598,128.2657031684269
"138 FULTON STREET, 4",2003-12-11,602250,2007-02-05,750000,147750,1152,128.25520833333334
"75 WALL STREET, 19O",2009-02-27,1568105,2016-01-12,1890000,321895,2510,128.24501992031873
"510 EAST 80TH   STREET, 8G",2017-01-18,685000,2017-05-15,700000,15000,117,128.2051282051282
"200 RIVERSIDE BOULEVARD, 18G",2005-03-18,1225000,2007-03-29,1320000,95000,741,128.2051282051282
"668 RIVERSIDE DRIVE, 5G",2009-03-27,143097,2016-04-28,475000,331903,2589,128.19737350328313
"188 EAST 70TH STREET, 9C",2004-08-09,1195000,2009-07-09,1425000,230000,1795,128.13370473537606
"120 RIVERSIDE BOULEVARD, 11M",2006-02-07,632944,2015-10-09,1085000,452056,3531,128.02492211838006
"325 5 AVENUE, 23D",2006-12-04,1048797,2013-11-25,1375000,326203,2548,128.02315541601257
"145 EAST 48TH STREET, 25A",2011-03-28,630000,2018-01-30,950000,320000,2500,128.0
"117 EDGECOMBE AVENUE, 1",2010-10-22,465000,2017-06-09,775000,310000,2422,127.99339388934764
"260 PARK AVENUE SOUTH, 10I",2008-03-27,2012500,2017-04-10,2435000,422500,3301,127.99151772190245
"45 PARK AVENUE, 406",2007-10-04,941881,2018-07-09,1445000,503119,3931,127.987534978377
"300 SPRING STREET, 4B",2007-03-30,999000,2016-11-22,1450000,451000,3525,127.94326241134752
"845 UNITED NATIONS PLAZA, 24B",2006-04-07,1150000,2013-10-03,1500000,350000,2736,127.92397660818713
"768 5 AVENUE, 605",2008-04-15,5521187,2014-10-16,5825000,303813,2375,127.92126315789474
"15 BROAD STREET, 2420",2006-06-09,1863397,2015-10-15,2300000,436603,3415,127.84860907759882
"90 WILLIAM STREET, 3G",2008-08-11,807472,2016-08-03,1180000,372528,2914,127.840768702814
"120 RIVERSIDE BOULEVARD, 8D",2006-01-06,542400,2014-09-22,949000,406600,3181,127.8214397988054
"35 WOOSTER STREET, 4R",2005-02-15,1410000,2010-05-17,1655000,245000,1917,127.80386019822639
"404 EAST 79 STREET, 8G",2003-04-07,729000,2004-04-01,775000,46000,360,127.77777777777777
"307 EAST 105 STREET, 5S",2010-03-03,190000,2018-03-16,565000,375000,2935,127.76831345826236
"25 MURRAY STREET, 9C",2010-04-28,921516,2017-05-12,1250000,328484,2571,127.76507195643718
"715 PARK AVENUE, 11D",2004-01-30,1350000,2018-01-04,2000000,650000,5088,127.75157232704403
"50 WEST 15TH STREET, 1C",2008-11-21,987831,2013-04-23,1194000,206169,1614,127.73791821561338
"99 JOHN STREET, 219",2010-11-23,610000,2017-08-24,925000,315000,2466,127.73722627737226
"250 EAST 53RD STREET, 2403",2008-05-22,1372801,2013-02-25,1595000,222199,1740,127.70057471264367
"250 EAST 54TH STREET, 25A",2006-07-11,1475000,2016-09-16,1950000,475000,3720,127.68817204301075
"1 MORTON SQUARE, PHA-E",2004-12-16,7433225,2010-09-07,7700000,266775,2091,127.58249641319942
"120 WEST 58TH STREET, 9C",2006-03-14,400000,2016-01-27,860000,460000,3606,127.56516916250693
"77 PARK AVENUE, 9D",2006-09-05,1350000,2017-12-13,1875000,525000,4117,127.52003886324994
"258 ST NICHOLAS AVENUE, 3D",2008-07-18,686349,2017-12-18,1125000,438651,3440,127.51482558139534
"150 EAST 85TH STREET, 11A",2011-05-10,745000,2015-04-22,929000,184000,1443,127.5121275121275
"510 EAST 80TH STREET, 2G",2012-03-28,800000,2015-10-13,965000,165000,1294,127.51159196290571
"360 EAST 88TH   STREET, 2D",2006-12-14,1670000,2011-06-21,1880000,210000,1650,127.27272727272727
"120 RIVERSIDE BOULEVARD, PH4H",2006-04-17,1848123,2016-11-15,2340000,491877,3865,127.26442432082794
"322 WEST 57TH STREET, 33L",2008-03-19,794235,2014-10-17,1100000,305765,2403,127.24302954640034
"5 EAST 22 STREET, 23P",2005-07-18,1650000,2012-12-20,1995000,345000,2712,127.21238938053098
"225 EAST 34TH STREET, 14C",2007-11-15,1389911,2015-06-29,1743750,353839,2783,127.14301113905857
"200 RIVERSIDE BOULEVARD, 22E",2006-10-26,1365000,2014-01-14,1700150,335150,2637,127.09518392112248
"45 PARK AVENUE, 202",2007-10-10,1145531,2014-05-02,1450000,304469,2396,127.07387312186978
"250 EAST 53RD STREET, 1204",2008-02-04,2570698,2010-05-05,2675000,104302,821,127.04263093788063
"148 EAST 24TH   STREET, 12C",2012-05-30,899000,2017-04-13,1125000,226000,1779,127.03766160764475
"10 WEST END AVENUE, 9B",2007-07-30,1201535,2014-09-17,1532500,330965,2606,127.00115118956255
"240 RIVERSIDE BOULEVARD, 11 E",2005-10-11,2218512,2010-03-25,2425000,206488,1626,126.99138991389914
"525 EAST 11TH STREET, PH8A",2011-08-31,1630000,2013-05-22,1710000,80000,630,126.98412698412699
"515 EAST 72ND STREET, 21E",2012-02-29,795000,2016-06-22,995000,200000,1575,126.98412698412699
"20 PINE STREET, 406",2011-09-28,920000,2018-04-26,1225000,305000,2402,126.97751873438801
"1600 BROADWAY, 14B",2006-09-21,865512,2013-04-15,1170000,304488,2398,126.97581317764804
"40 BROAD STREET, 20D",2011-06-13,730656,2012-10-16,793000,62344,491,126.9735234215886
"99 BATTERY PLACE, 22-C",2003-10-28,610000,2017-08-17,1250000,640000,5042,126.93375644585483
"225 EAST 34TH STREET, 11K",2007-11-15,855330,2016-02-24,1239000,383670,3023,126.91696989745286
"165 CHARLES STREET, RU5",2005-10-13,2138325,2013-06-26,2495000,356675,2813,126.79523640241734
"120 RIVERSIDE BOULEVARD, 3E",2006-02-13,1328816,2017-02-27,1840000,511184,4032,126.78174603174604
"235 WEST END AVENUE, 5F",2003-08-22,740000,2017-05-09,1375000,635000,5009,126.7718107406668
"371 WEST 117TH STREET, 1C",2006-10-03,400000,2015-05-18,799000,399000,3149,126.70689107653223
"310 WEST 52ND STREET, 27H",2008-02-07,1850000,2012-06-04,2050000,200000,1579,126.6624445851805
"502 PARK AVENUE, 11E",2004-01-09,1181170,2010-12-01,1500000,318830,2518,126.62033359809372
"635 WEST 42ND STREET, 27D",2007-10-29,1298268,2014-05-08,1600000,301732,2383,126.61854804867814
"150 WEST 51ST   STREET, 21-21",2013-05-02,648000,2016-07-06,795000,147000,1161,126.61498708010336
"100 RIVERSIDE BOULEVARD, 8H",2008-04-07,1440823,2015-05-21,1770000,329177,2600,126.60653846153846
"121 EAST 23RD STREET, 9B",2008-01-30,1525000,2017-06-27,1960000,435000,3436,126.60069848661234
"225 WEST 83RD STREET, 20A",2005-07-20,850000,2007-09-18,950000,100000,790,126.58227848101266
"1420 YORK AVENUE, 5K",2004-07-29,245000,2005-03-23,275000,30000,237,126.58227848101266
"80 ELIZABETH STREET, 2G",2004-02-20,450000,2013-07-19,885000,435000,3437,126.56386383473959
"99 JOHN STREET, 2005",2009-04-10,700000,2016-04-22,1025000,325000,2569,126.508369015181
"350 WEST 42ND   STREET, 8F",2011-07-01,750000,2017-06-13,1025000,275000,2174,126.4949402023919
"524 EAST 72ND STREET, 45G",2005-03-07,460000,2008-03-10,599000,139000,1099,126.4786169244768
"150 NASSAU STREET, 14D",2003-10-29,992794,2018-06-28,1670000,677206,5356,126.43876026885735
"205 EAST 59TH   STREET, 20C",2011-04-08,2050000,2017-04-07,2327000,277000,2191,126.42628936558648
"255 CABRINI BOULEVARD, 2D",2004-12-06,31653,2015-05-27,515000,483347,3824,126.3982740585774
"1031 6 AVENUE, 43H",2007-01-18,743322,2008-05-20,805000,61678,488,126.38934426229508
"162 WEST 56TH   STREET, 1603",2011-03-16,997000,2017-03-24,1275000,278000,2200,126.36363636363636
"350 WEST 42ND STREET, 12G",2006-10-27,1018250,2014-08-29,1380000,361750,2863,126.35347537548027
"255 HUDSON STREET, 6C",2006-11-15,1033523,2016-11-15,1495000,461477,3653,126.32822337804544
"40 WEST 116 STREET, B408",2008-10-06,763040,2013-11-18,999000,235960,1869,126.24933119315142
"310 WEST 52ND   STREET, 15C",2007-06-05,878240,2013-10-02,1170000,291760,2311,126.24837732583298
"25 CENTRAL PARK WEST, 8T",2006-01-18,2300000,2016-11-22,2800000,500000,3961,126.23074981065388
"50 RIVERSIDE BOULEVARD, 7K",2015-09-21,1811393,2018-03-09,1925000,113607,900,126.23
"184 THOMPSON STREET, 1S",2007-06-25,859403,2017-01-17,1300000,440597,3494,126.10103033772181
"75 WALL STREET, 23H",2011-03-02,544763,2015-03-04,729000,184237,1463,125.93096377306904
"346 EAST 119 STREET, 4A",2012-02-16,384674,2016-02-19,569000,184326,1464,125.90573770491804
"106 CENTRAL PARK SOUTH, 11H",2004-01-04,665000,2010-02-05,945000,280000,2224,125.89928057553956
"1619 3 AVENUE, 7J",2003-02-20,264402,2010-07-22,605000,340598,2709,125.72831303063862
"725 RIVERSIDE DRIVE, 7D",2010-08-20,520000,2017-10-27,850000,330000,2625,125.71428571428571
"58 WEST 58 STREET, 3B",2003-06-02,390000,2012-12-31,830000,440000,3500,125.71428571428571
"240 PARK AVENUE SOUTH, 7D",2008-04-08,1176078,2018-05-17,1640000,463922,3691,125.69005689515036
"230 RIVERSIDE DRIVE, 10F",2008-06-30,152000,2018-02-23,595000,443000,3525,125.67375886524823
"200 WEST END AVENUE, 4M",2008-03-19,911333,2014-06-26,1199000,287667,2290,125.61877729257642
"215 WEST 95TH STREET, 14F",2004-11-24,1049000,2013-04-26,1435000,386000,3075,125.52845528455285
"135 WEST 70TH   STREET, 4F",2009-06-12,2300000,2012-09-19,2450000,150000,1195,125.52301255230125
"56 LEONARD STREET, 17AE",2016-05-09,2758954,2018-07-23,2860000,101046,805,125.52298136645963
"15 BROAD STREET, 1202",2006-06-16,535730,2011-07-27,770000,234270,1867,125.47937868237814
"2 SOUTH END AVENUE, 8S",2013-06-04,460000,2015-08-10,560000,100000,797,125.47051442910916
"408 EAST 79TH STREET, 5A",2005-12-07,1421986,2013-08-22,1775000,353014,2815,125.40461811722913
"76 MADISON AVENUE, 7C",2008-05-21,1040000,2013-07-08,1275000,235000,1874,125.40021344717182
"150 NASSAU STREET, 18D",2003-09-15,1140440,2007-09-26,1325000,184560,1472,125.3804347826087
"205 EAST 59TH STREET, 12A",2009-03-12,1390000,2012-11-27,1560000,170000,1356,125.36873156342183
"505 GREENWICH STREET, 5C",2007-10-01,1375000,2014-01-31,1665000,290000,2314,125.32411408815904
"555 WEST 59TH STREET, 17C",2008-07-01,896060,2017-08-02,1312000,415940,3319,125.32087978306718
"101 WARREN STREET, 790",2008-07-02,1395002,2014-12-12,1690000,294998,2354,125.3177570093458
"1623 3 AVENUE, 41C",2003-02-20,310894,2011-11-10,710000,399106,3185,125.30800627943485
"350 WEST 50 STREET, 29A",2005-01-06,415000,2006-11-08,499000,84000,671,125.18628912071534
"11 WEST 104 STREET, 9",2006-04-07,880000,2017-07-12,1395000,515000,4114,125.18230432668935
"415 EAST 54TH   STREET, 26 C",2007-05-08,1550000,2013-09-10,1840000,290000,2317,125.16184721622788
"1360-66 6 AVENUE, 20G",2003-03-03,555000,2004-02-26,600000,45000,360,125.0
"425 5 AVENUE, 24A",2004-03-11,575311,2017-03-06,1168000,592689,4743,124.96078431372548
"10 WEST END AVENUE, 29D",2007-10-11,1647347,2014-05-29,1950000,302653,2422,124.95995045417011
"408 EAST 79TH STREET, 5B",2005-12-08,733140,2015-01-26,1150000,416860,3336,124.95803357314149
"380 RECTOR PLACE, 14J",2003-10-08,740000,2010-01-05,1025000,285000,2281,124.94519947391495
"415 MAIN STREET, 8-D",2010-04-15,535000,2013-10-17,695000,160000,1281,124.9024199843872
"350 WEST 42ND   STREET, 41C",2008-07-23,1350000,2017-05-04,1750000,400000,3207,124.72715933894605
"29 WEST 65TH   STREET, 5E",2011-09-26,500000,2015-05-11,665000,165000,1323,124.71655328798185
"10 WEST END AVENUE, 21D",2007-09-17,1554935,2013-12-20,1840000,285065,2286,124.70034995625547
"100 RIVERSIDE BOULEVARD, 14H",2008-05-27,1354374,2012-09-12,1550000,195626,1569,124.68196303377948
"30 EAST 37TH STREET, 4E",2007-02-16,171518,2016-10-04,610000,438482,3518,124.63956793632745
"18 WEST 48TH STREET, 14B",2010-11-19,1100000,2018-06-18,1445000,345000,2768,124.63872832369943
"1601 3 AVENUE, 16D",2003-02-20,269015,2010-10-13,617000,347985,2792,124.63646131805157
"160 WEST 66TH STREET, 37F",2006-06-06,1080000,2017-11-10,1600000,520000,4175,124.55089820359281
"555 WEST 23RD STREET, S3D",2014-03-31,920000,2017-11-15,1085000,165000,1325,124.52830188679245
"393 WEST 49TH STREET, 6G",2006-03-10,1050000,2016-02-02,1500000,450000,3616,124.44690265486726
"261 WEST 28TH STREET, 2B",2008-05-16,1520000,2014-04-25,1790000,270000,2170,124.42396313364056
"310 WEST 97TH   STREET, 53",2007-11-26,809418,2013-03-13,1050000,240582,1934,124.39607032057911
"520 EAST 81 STREET, 6C",2003-02-04,395000,2006-01-25,530000,135000,1086,124.30939226519337
"186 WEST 80TH STREET, 6F",2011-04-08,425000,2013-04-01,515000,90000,724,124.30939226519337
"340 EAST 23RD STREET, 6E",2008-06-04,1349181,2014-07-02,1625000,275819,2219,124.29878323569176
"400 CENTRAL PARK WEST, 15E",2009-08-20,445000,2016-10-18,770000,325000,2616,124.2354740061162
"555 WEST 59TH STREET, 10A",2008-09-25,982611,2015-12-15,1310000,327389,2637,124.15206674251043
"1601 3 AVENUE, 10D",2003-02-20,259433,2017-04-07,900000,640567,5160,124.14089147286822
"15 BROAD STREET, 2822",2006-09-13,840056,2014-04-23,1185000,344944,2779,124.12522490104354
"101 WEST 24TH   STREET, 6C",2008-11-04,1150622,2016-07-20,1500000,349378,2815,124.11296625222025
"65 COOPER SQUARE, 6D",2007-10-03,790000,2016-04-01,1175021,385021,3103,124.08024492426684
"40 BROAD STREET, 21E",2010-05-27,1069162,2015-07-01,1300000,230838,1861,124.0397635679742
"140 EAST 63RD STREET, 9F",2007-09-17,982611,2013-08-12,1250000,267389,2156,124.0208719851577
"400 EAST 67TH STREET, 11B",2009-01-27,2199420,2015-09-17,2500000,300580,2424,124.0016501650165
"80 JOHN STREET, 8I",2007-03-20,740471,2016-10-24,1175000,434529,3506,123.93867655447804
"1623 3 AVENUE, 22G",2003-02-20,276113,2015-07-31,839000,562887,4544,123.87477992957747
"2112 BROADWAY, 6F",2008-02-07,4378475,2014-02-07,4650000,271525,2192,123.87089416058394
"1619 THIRD AVENUE, 13F",2005-05-18,875000,2007-05-15,965000,90000,727,123.79642365887207
"15 CHARLES STREET, 17D",2004-09-27,495000,2014-10-23,950000,455000,3678,123.70853724850463
"40 BROAD STREET, 27C",2011-04-28,490590,2015-12-16,700000,209410,1693,123.69167158889545
"261 WEST 28TH STREET, 5A",2007-11-13,1374637,2015-07-31,1723000,348363,2817,123.66453674121406
"150 NASSAU STREET, 12A",2004-04-05,1170988,2012-02-06,1525000,354012,2863,123.65071603213413
"450 WEST 17TH   STREET, 1806",2008-12-01,725961,2011-02-10,825000,99039,801,123.64419475655431
"16 WEST 19TH   STREET, 10-D",2007-12-14,585493,2008-12-08,630000,44507,360,123.63055555555556
"101 WARREN STREET, 600",2008-06-23,1197462,2012-12-18,1400000,202538,1639,123.57413056741916
"845 UNITED NATIONS PLAZA, 15D",2004-05-12,1525000,2011-01-04,1825000,300000,2428,123.55848434925865
"101 WARREN STREET, 3040",2009-09-04,2600000,2017-12-28,2975000,375000,3037,123.47711557458018
"247 WEST 46TH   STREET, 2601",2008-11-07,1476869,2014-09-09,1740000,263131,2132,123.41979362101313
"110 WEST 90TH STREET, 3B",2007-03-30,1080000,2016-04-25,1489000,409000,3314,123.41581170790586
"225 EAST 34TH   STREET, 5J",2008-02-12,883331,2016-01-12,1240000,356669,2891,123.37218955378762
"425 5 AVENUE, 24D",2004-02-10,534581,2017-10-10,1150000,615419,4991,123.30575035063113
"305 SECOND AVENUE, 727",2007-06-01,932462,2015-02-20,1280000,347538,2821,123.19673874512584
"200 CHAMBERS STREET, 3D",2007-02-22,1430641,2013-03-29,1705000,274359,2227,123.1966771441401
"150 NASSAU STREET, 15B",2003-11-14,1680113,2010-06-04,1975000,294887,2394,123.17752715121136
"2250 BROADWAY, 14B",2007-07-12,1375000,2017-10-02,1835000,460000,3735,123.15930388219545
"230 RIVERSIDE DRIVE, 15L",2008-06-30,178000,2018-07-19,630000,452000,3671,123.12721329338055
"261 WEST 28TH STREET, PHA",2007-12-12,1629200,2016-12-20,2035000,405800,3296,123.11893203883496
"150 EAST 56TH   STREET, 12C",2010-06-24,362500,2011-07-15,410000,47500,386,123.05699481865285
"148 EAST 24TH   STREET, 9A",2012-03-02,839000,2017-12-22,1100000,261000,2121,123.05516265912306
"800 TENTH AVENUE, 5N",2011-12-05,643347,2016-12-20,870000,226653,1842,123.04723127035831
"425 5 AVENUE, 46B",2004-10-15,588548,2017-05-24,1155000,566452,4604,123.03475238922675
"1400 FIFTH AVENUE, 8E",2005-02-04,595000,2018-07-24,1200000,605000,4918,123.01748678324522
"255 HUDSON STREET, 6B",2007-05-08,1756481,2017-05-23,2207500,451019,3668,122.96046892039259
"15 BROAD STREET, 3230",2007-01-05,1313542,2012-09-21,1570000,256458,2086,122.9424736337488
"150 NASSAU STREET, 9G",2003-03-20,488622,2008-06-16,724000,235378,1915,122.91279373368147
"101 WEST 24TH   STREET, 34B",2008-09-29,2881647,2011-05-20,3000000,118353,963,122.90031152647975
"275 GREENWICH STREET, 9JS",2005-01-14,620000,2015-05-26,1085000,465000,3784,122.88583509513742
"381 BROOME STREET, 6F",2004-02-11,492804,2012-01-27,850000,357196,2907,122.87444100447196
"155 WEST 68TH   STREET, 18-26",2007-05-30,1999500,2010-10-06,2150000,150500,1225,122.85714285714286
"211 EAST 46TH   STREET, PHA",2009-08-25,612500,2016-12-12,940000,327500,2666,122.84321080270068
"1641 THIRD AVENUE, 23J",2013-12-09,715000,2018-07-13,921000,206000,1677,122.83840190816935
"71 PARK AVENUE, 4B",2009-06-04,918303,2016-10-26,1250000,331697,2701,122.80525731210663
"230 RIVERSIDE DRIVE, 9K",2008-06-30,475000,2012-08-15,660000,185000,1507,122.7604512276045
"247 WEST 46TH   STREET, 1006",2008-08-15,1102764,2014-08-01,1370000,267236,2177,122.75424896646761
"150 NASSAU STREET, 8D",2003-04-21,496860,2008-07-03,730000,233140,1900,122.70526315789473
"1623 3 AVENUE, 36C",2003-02-20,293149,2010-04-27,615000,321851,2623,122.7033930613801
"120 RIVERSIDE BOULEVARD, 14M",2006-03-27,652494,2013-12-19,999000,346506,2824,122.70042492917847
"110 EAST 87TH STREET, 2C",2005-11-21,675000,2011-03-31,915000,240000,1956,122.69938650306749
"350 WEST 42ND STREET, 19C",2006-06-28,630513,2016-12-19,1100000,469487,3827,122.67755422001568
"220 MANHATTAN AVENUE, 5S",2004-09-22,530000,2007-12-18,675000,145000,1182,122.67343485617597
"515 EAST 72ND STREET, 38C",2014-10-10,1690295,2017-03-15,1799000,108705,887,122.55355129650508
"250 WEST 90TH   STREET, 7B",2013-08-09,695000,2017-06-13,867000,172000,1404,122.5071225071225
"99 JOHN STREET, 920",2011-05-20,506000,2015-06-30,690000,184000,1502,122.50332889480693
"1641 3 AVENUE, 6G",2003-02-20,242043,2014-02-28,735000,492957,4026,122.44336810730253
"220, 15P",2003-01-31,476580,2003-10-31,510000,33420,273,122.41758241758242
"80 ELIZABETH STREET, 5F",2003-01-30,520000,2018-04-16,1200000,680000,5555,122.41224122412241
"2628 BROADWAY, 3A",2007-10-11,1216808,2012-12-28,1450000,233192,1905,122.41049868766405
"200 EAST 89TH STREET, 38A",2005-08-26,1275000,2015-04-10,1705000,430000,3514,122.36767216846899
"205 EAST 68TH   STREET, T2A",2012-11-08,670000,2016-04-05,822200,152200,1244,122.34726688102894
"160 WEST 66TH   STREET, 21G",2008-02-15,1330000,2015-12-16,1680000,350000,2861,122.3348479552604
"655 SIXTH AVENUE, 3A",2013-09-12,1600000,2016-05-20,1720000,120000,981,122.32415902140673
"555 WEST 59TH STREET, 5C",2008-08-14,784052,2013-11-18,1019000,234948,1922,122.2414151925078
"350 WEST 42ND STREET, 8G",2006-06-21,946972,2011-05-11,1165000,218028,1785,122.14453781512606
"161 EAST 110 STREET, 2C",2009-10-23,410670,2013-10-22,589000,178330,1460,122.14383561643835
"421 EAST 13TH   STREET, 2C",2008-01-31,1272812,2013-09-26,1525000,252188,2065,122.12493946731234
"118 WEST 112 STREET, 4D",2010-12-22,445000,2016-02-18,675000,230000,1884,122.08067940552017
"75 WALL STREET, 30K",2009-10-01,924061,2014-08-05,1140000,215939,1769,122.06840022611645
"455 CENTRAL PARK WEST, 18C",2005-02-11,3899897,2017-06-15,4450000,550103,4507,122.05524739294431
"99 JOHN STREET, 1105",2013-04-09,540000,2015-05-07,632500,92500,758,122.03166226912928
"1760 SECOND AVENUE, 18C",2005-06-28,1215000,2015-05-13,1655000,440000,3606,122.01885745978925
"330 EAST 38 STREET, 6H",2003-01-08,340000,2004-01-12,385000,45000,369,121.95121951219512
"249 EAST 118 STREET, 3A",2010-07-19,415740,2015-01-09,615000,199260,1635,121.87155963302752
"275 GREENWICH STREET, 4MS",2004-01-26,525000,2016-06-30,1078000,553000,4539,121.83300286406697
"1623 3 AVENUE, 23G",2003-02-20,278242,2018-03-27,950000,671758,5514,121.82771128037722
"555 WEST 59TH STREET, 9D",2008-02-28,914000,2016-09-21,1295000,381000,3128,121.80306905370844
"250 SOUTH END AVENUE, 2H",2003-07-31,310000,2005-04-07,385000,75000,616,121.75324675324676
"310 WEST 52ND   STREET, 5C",2007-05-22,801871,2014-09-05,1125000,323129,2663,121.34021779947427
"455 MAIN STREET, 15C",2006-04-20,463398,2013-06-03,779000,315602,2601,121.33871587850827
"221 WEST 14TH   STREET, 1-B",2013-07-16,692000,2016-02-03,805000,113000,932,121.24463519313305
"186 WEST 80 STREET, 4D",2003-05-23,287000,2005-02-08,363000,76000,627,121.21212121212122
"164 PEARL STREET, 10D",2010-11-24,625000,2016-07-18,875000,250000,2063,121.1827435773146
"502 PARK AVENUE, 6A",2004-03-12,778961,2013-09-17,1200000,421039,3476,121.12744533947065
"100 RIVERSIDE BOULEVARD, 28D",2008-08-05,2606720,2017-06-26,3000000,393280,3247,121.1210348013551
"225 WEST 10TH   STREET, 2D",2008-08-28,615000,2014-08-25,880000,265000,2188,121.11517367458866
"333 EAST 34TH STREET, 12H",2004-07-06,554946,2006-08-30,650000,95054,785,121.08789808917197
"121 EAST 23RD STREET, 6D",2010-06-09,1330000,2018-06-19,1685000,355000,2932,121.07776261937244
"205 WEST 76TH   STREET, PH1F",2009-11-30,4701457,2012-02-22,4800000,98543,814,121.06019656019656
"199 BOWERY, 7F",2006-05-15,626223,2015-12-15,1050000,423777,3501,121.044558697515
"322 WEST 57TH STREET, 25Q",2008-04-03,745359,2015-05-01,1058000,312641,2584,120.99109907120743
"350 WEST 42ND   STREET, 18F",2011-07-28,805000,2017-11-09,1082750,277750,2296,120.9712543554007
"500 WEST 43RD   STREET, 38C",2012-09-20,850000,2014-06-02,925000,75000,620,120.96774193548387
"1080 MADISON AVENUE, 7B",2006-11-01,780000,2015-05-20,1157500,377500,3122,120.91607943625881
"124 EAST 79TH   STREET, 15A",2015-03-10,2825000,2017-02-10,2910000,85000,703,120.9103840682788
"1623 3 AVENUE, 36J",2003-02-20,325444,2016-05-19,910000,584556,4837,120.85094066570188
"10 WEST END AVENUE, 7B",2007-07-13,1216605,2013-12-13,1500000,283395,2345,120.85074626865672
"1619 3 AVENUE, 5G",2003-02-20,262273,2017-10-25,910000,647727,5361,120.82204812534975
"65 WEST 107TH STREET, 2C",2010-10-15,304200,2017-12-11,620000,315800,2614,120.81101759755164
"400 EAST 54TH STREET, 23E",2005-05-09,728048,2014-12-02,1150000,421952,3494,120.76473955352031
"99 JOHN STREET, 1908",2013-06-28,800000,2017-09-07,985000,185000,1532,120.75718015665797
"310 WEST 52ND   STREET, 15A",2007-03-02,809508,2017-06-29,1265000,455492,3772,120.7560975609756
"252 7 AVENUE, 6Z",2005-06-21,995000,2013-07-09,1350000,355000,2940,120.74829931972789
"1619 3 AVENUE, 16C",2003-02-20,271500,2017-03-01,890000,618500,5123,120.73004099160649
"330 EAST 38TH   STREET, 16F",2008-12-05,655000,2015-08-07,949000,294000,2436,120.6896551724138
"372 CENTRAL PARK WEST, 7H",2003-08-25,420810,2016-05-19,982000,561190,4651,120.66007310255858
"350 WEST 14 STREET, PHF",2007-07-27,1175000,2017-03-20,1600000,425000,3524,120.60158910329172
"400 5 AVENUE, 42B",2011-05-09,1323725,2017-08-16,1600000,276275,2291,120.59144478393715
"10 WEST END AVENUE, 8E",2007-07-26,784052,2015-11-17,1150000,365948,3036,120.53623188405797
"108 FIFTH AVENUE, 14C",2004-09-29,587000,2010-06-29,840000,253000,2099,120.53358742258219
"333 EAST 109 STREET, 5C",2011-10-28,440000,2017-08-14,695000,255000,2117,120.45347189418989
"400 EAST 67TH   STREET, 10F",2010-03-01,1873580,2012-06-20,1975000,101420,842,120.45130641330167
"200 CHAMBERS STREET, 3E",2007-03-07,646588,2017-06-12,1098000,451412,3750,120.37653333333333
"372 CENTRAL PARK WEST, 10M",2008-03-14,821000,2017-08-14,1235000,414000,3440,120.34883720930233
"1623 3 AVENUE, 27C",2003-02-20,280018,2017-09-12,920000,639982,5318,120.34261000376081
"15 BROAD STREET, 2222",2012-11-27,685000,2018-05-31,927000,242000,2011,120.33814022874192
"295 GREENWICH STREET, 3ON",2004-08-17,349150,2008-09-03,527000,177850,1478,120.33152909336941
"99 JOHN STREET, 1411",2012-03-07,675000,2017-04-20,900000,225000,1870,120.32085561497327
"158 HESTER STREET, 2A",2006-11-16,870603,2017-05-01,1330000,459397,3819,120.29248494370253
"10 WEST END AVENUE, 6H",2007-07-12,1445976,2018-08-29,1935000,489024,4066,120.27151992129858
"1623 3 AVENUE, 16D",2003-02-20,249497,2015-09-04,800000,550503,4579,120.22341122515833
"184 THOMPSON STREET, 6A",2007-09-11,1165896,2018-04-09,1630000,464104,3863,120.1408231944085
"161 WEST 133RD STREET, 3A",2010-03-01,330000,2013-08-01,480000,150000,1249,120.0960768614892
"88 GREENWICH STREET, 424",2010-06-16,500000,2014-03-21,665000,165000,1374,120.08733624454149
"15 BROAD STREET, 1228",2006-11-15,437847,2018-05-01,940000,502153,4185,119.98876941457587
"310 EAST 53RD STREET, 7B",2006-10-24,1858815,2012-04-30,2100500,241685,2015,119.94292803970224
"80 PARK AVENUE, 17G",2012-12-18,840000,2017-12-28,1060000,220000,1836,119.82570806100217
"225 EAST 34TH STREET, 15J",2007-11-20,946972,2015-09-01,1287500,340528,2842,119.8198451794511
"1619 THIRD AVENUE, 6H",2005-07-06,855000,2016-10-28,1350000,495000,4132,119.79670861568248
"415 EAST 37TH STREET, 7H",2010-01-20,565000,2016-07-27,850000,285000,2380,119.74789915966386
"15 BROAD STREET, 1122",2006-09-12,415740,2013-10-08,725000,309260,2583,119.7289972899729
"247 WEST 46TH   STREET, 205",2013-06-28,1226250,2015-03-06,1300000,73750,616,119.72402597402598
"295 GREENWICH STREET, 4ON",2004-06-21,390000,2007-11-27,540000,150000,1254,119.61722488038278
"135 EAST 54TH   STREET, 11K",2008-06-20,760000,2009-01-15,785000,25000,209,119.61722488038278
"117 EAST 18TH   STREET, 4",2009-09-15,2250000,2017-02-22,2575000,325000,2717,119.61722488038278
"199 BOWERY, 2F",2007-10-31,697501,2018-03-02,1149000,451499,3775,119.60238410596027
"15 BROAD STREET, 2416",2006-06-15,1242265,2009-09-21,1385000,142735,1194,119.54355108877722
"1641 3 AVENUE, 28D",2003-02-20,293149,2013-10-31,760000,466851,3906,119.52150537634408
"417 MANHATTAN AVENUE, B-2",2014-03-26,298116,2017-05-19,435500,137384,1150,119.46434782608695
"199 WEST 134TH STREET, 5A",2003-12-24,121423,2017-09-13,720000,598577,5012,119.42877094972067
"768 5 AVENUE, 603",2008-07-03,9175804,2014-10-16,9450000,274196,2296,119.42334494773519
"115 FOURTH AVENUE, 2D",2011-06-13,780000,2017-08-21,1050000,270000,2261,119.41618752764263
"555 WEST 23RD STREET, S12G",2009-01-06,750000,2009-12-07,790000,40000,335,119.40298507462687
"507 EAST 80TH   STREET, 6R",2012-05-04,660000,2015-07-21,800000,140000,1173,119.35208866155158
"30 LITTLE WEST STREET, 20D",2010-04-22,730000,2016-06-23,999000,269000,2254,119.34338952972493
"1485 FIFTH AVENUE, 11G",2012-07-12,406500,2014-05-01,485000,78500,658,119.30091185410335
"80 JOHN STREET, 4G",2007-08-01,877476,2014-08-22,1185000,307524,2578,119.2878200155159
"350 WEST 42ND STREET, 56H",2006-11-13,1002976,2017-02-16,1450000,447024,3748,119.2700106723586
"311 WEST BROADWAY, 6A",2011-05-31,3687500,2018-08-03,4000000,312500,2621,119.2293017932087
"243 WEST 60TH   STREET, 2C",2009-01-09,880786,2017-08-14,1255000,374214,3139,119.21439949028353
"1601 3 AVENUE, 21D",2003-02-20,286051,2011-09-23,660000,373949,3137,119.20592923175008
"11 EAST 36TH   STREET, 505",2007-05-03,1094908,2015-06-30,1450000,355092,2980,119.15838926174497
"99 BATTERY PLACE, 18-J",2013-04-26,420000,2017-03-23,590000,170000,1427,119.13104414856342
"515 EAST 72ND   STREET, 21J",2010-12-03,665000,2017-12-07,970000,305000,2561,119.09410386567747
"1641 3 AVENUE, 18E",2003-02-20,133444,2009-09-23,420000,286556,2407,119.05110095554632
"525 EAST 11TH STREET, 6A",2007-07-25,1325000,2008-06-25,1365000,40000,336,119.04761904761905
"350 WEST 42ND STREET, 7F",2006-05-31,602696,2014-05-27,950000,347304,2918,119.0212474297464
"800 TENTH AVENUE, 1B",2012-03-27,728870,2017-04-28,950000,221130,1858,119.0150699677072
"200 RIVERSIDE BOULEVARD, 6C",2004-12-15,900000,2015-12-17,1378200,478200,4019,118.98482209504851
"50 PINE STREET, 9S",2006-11-30,1131150,2015-11-20,1521000,389850,3277,118.96551724137932
"300 WEST 135TH STREET, 5K",2005-06-01,217000,2016-07-05,699000,482000,4052,118.95360315893386
"62 BEACH STREET, 6B",2006-05-02,2600000,2012-08-30,2875000,275000,2312,118.9446366782007
"514 CATHEDRAL PARKWAY, 1A",2005-05-31,686887,2010-11-23,925000,238113,2002,118.93756243756243
"82 BEAVER STREET, 507",2011-08-31,400000,2014-04-24,515000,115000,967,118.9245087900724
"20 PINE STREET, 1810",2009-11-30,829351,2013-07-01,985000,155649,1309,118.90679908326968
"150 WEST 56TH STREET, 4303",2005-08-17,1470000,2017-05-16,1980000,510000,4290,118.88111888111888
"500 WEST 43RD   STREET, 9K",2010-03-19,600000,2013-08-28,749500,149500,1258,118.83942766295708
"377 RECTOR PLACE, 8B",2005-12-29,575000,2008-02-28,669000,94000,791,118.83691529709229
"261 WEST 28TH STREET, 3C",2007-11-20,789143,2014-12-29,1097500,308357,2596,118.78158705701078
"15 BROAD STREET, 2400",2006-09-22,1629200,2014-08-01,1970000,340800,2870,118.74564459930313
"120 RIVERSIDE BOULEVARD, 6M",2005-12-16,584068,2010-02-17,765000,180932,1524,118.7217847769029
"129 WEST 20TH STREET, 2A",2004-12-29,1425000,2012-06-20,1749000,324000,2730,118.68131868131869
"380 LENOX AVENUE, 4D",2007-06-04,974893,2015-07-02,1325000,350107,2950,118.68033898305085
"635 WEST 42ND STREET, 30B",2011-08-08,840000,2015-04-13,999500,159500,1344,118.67559523809524
"382 CENTRAL PARK WEST, 6J",2004-06-03,566147,2015-12-07,1065000,498853,4204,118.66151284490961
"1600 BROADWAY, 5G",2006-05-30,1272812,2015-06-18,1665000,392188,3306,118.6291591046582
"15 BROAD STREET, 2524",2007-01-24,962246,2013-07-01,1241000,278754,2350,118.61872340425532
"401 EAST 84TH STREET, 21C",2008-06-04,1350000,2013-06-13,1567500,217500,1835,118.52861035422343
"225 EAST 34TH STREET, 11B",2007-11-15,1089527,2014-08-01,1380000,290473,2451,118.51203590371277
"171 EAST 84TH   STREET, 11G",2007-05-03,999000,2017-05-30,1435000,436000,3680,118.47826086956522
"150 NASSAU STREET, 14C",2004-02-19,1476463,2012-08-01,1842000,365537,3086,118.450097213221
"421 WEST 54TH   STREET, 3A",2008-02-12,1277903,2014-04-16,1545000,267097,2255,118.44656319290466
"404 EAST 79TH STREET, 4A",2010-08-10,1150000,2015-10-23,1375000,225000,1900,118.42105263157895
"300 RECTOR PLACE, 6A",2003-06-27,280000,2006-12-15,430000,150000,1267,118.38989739542225
"404 EAST 76 STREET, 5E",2003-08-06,555000,2006-12-13,700000,145000,1225,118.36734693877551
"325 FIFTH AVENUE, 33E",2007-03-27,1150622,2014-02-28,1450000,299378,2530,118.33122529644268
"555 WEST 59TH STREET, 6D",2008-06-17,900133,2014-08-04,1165000,264867,2239,118.2970075926753
"2101 BROADWAY, 15159",2004-03-16,907500,2006-10-23,1020000,112500,951,118.29652996845427
"225 WEST 60TH   STREET, 17D",2007-03-28,1293177,2013-07-12,1565000,271823,2298,118.28677110530896
"260 PARK AVENUE SOUTH, 5K",2006-03-29,916425,2013-12-18,1250000,333575,2821,118.24707550514002
"120 RIVERSIDE BOULEVARD, PH4K",2006-03-20,1547740,2018-04-23,2070000,522260,4417,118.23862350011319
"40 BROAD STREET, 19B",2011-09-13,920000,2014-02-18,1025100,105100,889,118.22272215973004
"111 WEST 67TH   STREET, 20-P",2012-07-16,500000,2014-02-07,567500,67500,571,118.21366024518389
"260 PARK AVENUE SOUTH, 7K",2008-03-20,1180000,2018-07-12,1625000,445000,3766,118.16250663834307
"280 PARK AVENUE SOUTH, 12J",2007-01-30,934753,2014-05-21,1250000,315247,2668,118.15854572713643
"40 WEST 116 STREET, B704",2009-06-03,140560,2016-07-28,449000,308440,2612,118.08575803981623
"382 CENTRAL PARK WEST, 7A",2009-09-24,725000,2013-10-15,900000,175000,1482,118.08367071524967
"350 ALBANY STREET, 3L",2010-08-27,330000,2016-10-19,595000,265000,2245,118.0400890868597
"715 PARK AVENUE, 5C",2004-04-28,730000,2017-07-18,1300000,570000,4829,118.03686063367157
"635 WEST 42ND   STREET, 2L",2009-08-10,875695,2016-10-14,1185000,309305,2622,117.965293668955
"243 WEST 60TH   STREET, 3C",2008-12-30,941881,2013-10-30,1150000,208119,1765,117.91444759206799
"1 IRVING PLACE, P10I",2012-06-22,580000,2017-11-16,812500,232500,1973,117.84085149518499
"1641 3 AVENUE, 19J",2003-02-20,256595,2015-03-09,775000,518405,4400,117.81931818181818
"300 WEST 135TH STREET, 6Q",2005-07-11,286559,2017-02-09,785000,498441,4231,117.80690144173954
"333 RECTOR PLACE, 1206",2011-06-24,554946,2016-08-30,778000,223054,1894,117.76874340021119
"60 HENRY STREET, 12E",2006-04-03,315000,2008-08-15,416850,101850,865,117.74566473988439
"1 YORK STREET, 3C",2008-06-04,2443800,2017-11-14,2850000,406200,3450,117.73913043478261
"340 EAST 23RD STREET, 10D",2008-05-29,1262630,2017-06-02,1650000,387370,3291,117.7058644788818
"310 WEST 52ND   STREET, 12D",2007-02-27,666953,2014-03-17,970000,303047,2575,117.68815533980583
"111 JANE STREET, E",2008-03-24,2750000,2017-06-05,3145000,395000,3360,117.55952380952381
"54 WEST 74TH STREET, 608",2004-12-09,555000,2015-04-13,999000,444000,3777,117.55361397934868
"50 RIVERSIDE BOULEVARD, 8H",2015-11-24,2396887,2017-12-13,2485000,88113,750,117.484
"392 CENTRAL PARK WEST, 5J",2010-09-03,700000,2017-08-31,999999,299999,2554,117.46241190289741
"306 MOTT STREET, 4A",2005-09-30,525000,2008-03-18,630703,105703,900,117.44777777777777
"70 WEST 107 STREET, 4A",2006-06-05,1247356,2014-08-25,1600000,352644,3003,117.43056943056943
"309 WEST 118 STREET, 3D",2005-03-10,375180,2013-10-25,745000,369820,3151,117.3659155823548
"125 WEST 22ND STREET, 1C",2008-05-21,659826,2013-11-15,895000,235174,2004,117.35229540918164
"48 WEST 138 STREET, 4N",2014-06-20,222481,2016-09-28,320000,97519,831,117.35138387484957
"255 CABRINI BOULEVARD, 2J",2004-08-12,20088,2016-03-23,517500,497412,4241,117.28648903560482
"330 EAST 49TH STREET, 10A",2011-06-15,470000,2014-01-08,580000,110000,938,117.27078891257996
"99 JOHN STREET, 718",2010-03-15,420000,2014-05-28,600000,180000,1535,117.26384364820846
"1619 3 AVENUE, 15J",2003-02-20,282147,2011-06-30,640000,357853,3052,117.25196592398427
"325 FIFTH AVENUE, 29E",2007-02-23,1160805,2013-11-25,1450000,289195,2467,117.22537494933117
"372 CENTRAL PARK WEST, 17K",2007-09-06,885000,2014-12-03,1195000,310000,2645,117.2022684310019
"21 SOUTH END AVENUE, 735",2012-02-03,400000,2016-12-30,610000,210000,1792,117.1875
"200 CHAMBERS STREET, 2R",2007-02-05,738231,2016-09-19,1150000,411769,3514,117.17956744450768
"225 EAST 34TH STREET, 7J",2007-10-24,890968,2016-04-27,1255000,364032,3108,117.12741312741312
"251 WEST 123 STREET, 3",2003-02-26,258604,2013-06-24,700000,441396,3771,117.05011933174224
"514 CATHEDRAL PARKWAY, 4B",2005-06-02,460976,2014-11-24,866000,405024,3462,116.99133448873484
"111 CENTRAL PARK NORTH, 11A",2007-11-07,2444100,2017-05-09,2850000,405900,3471,116.94036300777874
"27 WEST 72ND   STREET, 715",2007-05-23,1323725,2010-05-07,1450000,126275,1080,116.92129629629629
"186 WEST 80TH STREET, 4L",2004-08-10,415000,2008-02-14,565000,150000,1283,116.91348402182385
"372 CENTRAL PARK WEST, 9B",2008-03-20,950000,2016-05-31,1300000,350000,2994,116.9004676018704
"400 CENTRAL PARK WEST, 10D",2003-09-16,785000,2014-02-18,1230000,445000,3808,116.85924369747899
"400 EAST 67TH   STREET, 5H",2010-01-08,1200000,2016-09-12,1485000,285000,2439,116.85116851168512
"90 WILLIAM STREET, 4B",2008-07-09,1231064,2015-10-05,1540000,308936,2644,116.84417549167928
"15 BROAD STREET, 2824",2007-01-04,941881,2014-03-26,1250000,308119,2638,116.80022744503411
"216 EAST 47TH   STREET, 5B",2009-12-22,600000,2017-03-30,910000,310000,2655,116.7608286252354
"150 NASSAU STREET, 4D",2003-04-28,310566,2016-11-29,890000,579434,4964,116.72723609991942
"100 RIVERSIDE BOULEVARD, 7A",2009-10-28,909297,2017-10-05,1247500,338203,2899,116.6619523973784
"1641 3 AVENUE, 22E",2003-02-20,138411,2009-07-06,410000,271589,2328,116.66194158075601
"247 WEST 46TH   STREET, 2902",2009-01-16,1452652,2013-07-24,1645000,192348,1650,116.57454545454546
"315 SEVENTH AVENUE, 5D",2007-02-01,682360,2015-02-19,1025000,342640,2940,116.54421768707483
"186 WEST 80 STREET, 7C",2004-01-14,285000,2004-04-26,297000,12000,103,116.50485436893204
"68 BRADHURST AVENUE, 2-U",2007-08-10,455034,2018-01-15,899000,443966,3811,116.49593282602991
"220 RIVERSIDE BOULEVARD, 3H",2005-04-15,1550000,2008-10-24,1700000,150000,1288,116.45962732919254
"350 EAST 62ND STREET, 5E",2009-04-29,455000,2015-09-25,727500,272500,2340,116.45299145299145
"300 WEST 135 STREET, 5S",2005-06-27,361976,2016-11-04,845000,483024,4148,116.44744455159113
"255 EAST 49TH   STREET, 14E",2009-08-10,517500,2011-09-01,605000,87500,752,116.3563829787234
"40 BROAD STREET, 14G",2010-04-13,621132,2016-11-04,900000,278868,2397,116.34042553191489
"201 EAST 36TH   STREET, 2D",2011-03-11,629000,2014-09-29,780000,151000,1298,116.33281972265023
"215 WEST 95TH   STREET, 11D",2009-05-22,505000,2014-01-02,701000,196000,1686,116.2514827995255
"635 WEST 42ND STREET, 30F",2012-01-13,1260000,2016-06-24,1448695,188695,1624,116.19150246305419
"35 NORTH MOORE STREET, 4C",2013-06-20,5250000,2018-03-08,5450000,200000,1722,116.14401858304298
"404 EAST 76 STREET, 3L",2004-05-20,500000,2006-08-16,595000,95000,818,116.13691931540342
"30 EAST 37TH   STREET, 8K",2007-01-10,433992,2009-12-30,560000,126008,1085,116.13640552995392
"812 RIVERSIDE DRIVE, 53",2011-05-31,485000,2013-12-16,593000,108000,930,116.12903225806451
"40 BROAD STREET, 27G",2010-05-17,780000,2015-07-16,999000,219000,1886,116.118769883351
"70 BATTERY PLACE, 10C",2009-01-22,931698,2014-03-17,1150000,218302,1880,116.11808510638298
"300 RECTOR PLACE, 6K",2004-02-03,675000,2008-12-04,880000,205000,1766,116.08154020385051
"150 EAST 86TH STREET, 18B",2009-09-08,4972889,2018-08-01,5350000,377111,3249,116.0698676515851
"301 CATHEDRAL PARKWAY, 8E",2005-01-12,154283,2015-10-14,610000,455717,3927,116.0471097529921
"1623 3 AVENUE, 25C",2003-02-20,276469,2013-08-19,721000,444531,3833,115.97469345160448
"300 WEST 135 STREET, 3M",2006-05-16,159091,2017-11-14,646000,486909,4200,115.93071428571429
"1 IRVING PLACE, G16E",2006-10-05,890000,2017-08-24,1350000,460000,3976,115.69416498993964
"2109 BROADWAY, 15157",2008-11-11,700000,2018-05-01,1100000,400000,3458,115.6737998843262
"1619 3 AVENUE, 8G",2003-02-20,266531,2010-04-28,570000,303469,2624,115.65129573170732
"40 BOND STREET, 4B",2007-07-06,3894806,2012-05-15,4100000,205194,1775,115.60225352112676
"350 WEST 42ND STREET, 12C",2006-05-26,605858,2014-10-06,959000,353142,3055,115.59476268412439
"200 RECTOR PLACE, 22A",2003-06-19,200000,2011-01-18,520000,320000,2770,115.52346570397111
"40 SUTTON PLACE, 4G",2012-09-27,352000,2017-06-07,550000,198000,1714,115.51925320886815
"517 WEST 46TH   STREET, 402",2008-01-31,1025000,2014-08-08,1300000,275000,2381,115.49769004619908
"1641 3 AVENUE, 15J",2003-02-20,249497,2010-11-10,575000,325503,2820,115.42659574468085
"80 ELIZABETH STREET, 6L",2009-04-27,680000,2018-03-20,1055000,375000,3249,115.42012927054478
"400 EAST 90TH STREET, 4H",2010-11-19,650000,2016-05-04,880000,230000,1993,115.4039136979428
"1641 3 AVENUE, 31F",2005-04-26,875000,2013-08-16,1225000,350000,3034,115.35926170072511
"20 PINE STREET, 610",2010-10-29,850000,2013-03-14,950000,100000,867,115.34025374855824
"15 BROAD STREET, 1208",2006-05-22,529490,2010-03-05,689000,159510,1383,115.33622559652929
"247 WEST 46TH   STREET, 2302",2008-11-03,1237173,2014-12-16,1494800,257627,2234,115.32094897045658
"49 EAST 21ST STREET, 2C",2005-02-11,1160805,2011-07-06,1430000,269195,2336,115.23758561643835
"146 WEST 57TH STREET, 66B",2007-06-20,2900000,2013-05-29,3150000,250000,2170,115.2073732718894
"1623 3 AVENUE, 22C",2003-02-20,263337,2017-01-31,850000,586663,5094,115.16745190420102
"230 RIVERSIDE DRIVE, 5L",2006-12-12,999921,2015-11-12,1375000,375079,3257,115.16088424930918
"1400 FIFTH AVENUE, 5C",2004-12-03,327015,2018-06-06,895000,567985,4933,115.13987431583215
"176 MULBERRY STREET, PH",2007-11-29,2862500,2014-12-12,3158333,295833,2570,115.11011673151751
"595 WEST END AVENUE, 1D",2013-10-10,739249,2016-10-07,865000,125751,1093,115.0512351326624
"415-23 EAST 54 STREET, 19 H",2003-01-09,832500,2003-12-01,870000,37500,326,115.03067484662577
"581 ACADEMY STREET, 1D",2003-04-28,65500,2004-05-19,110000,44500,387,114.98708010335918
"106 CENTRAL PARK SOUTH, 21I",2006-11-28,1595000,2018-07-31,2085000,490000,4263,114.94252873563218
"415 MAIN STREET, 10-D",2009-11-03,554946,2014-06-27,750000,195054,1697,114.94048320565705
"39 EAST 29TH STREET, 30C",2008-11-19,2372522,2013-07-17,2568000,195478,1701,114.91945914168136
"311 EAST 38TH   STREET, 24C",2012-12-21,1150000,2017-05-19,1335000,185000,1610,114.90683229813665
"111 FULTON STREET, 320",2009-12-16,481000,2015-11-05,728048,247048,2150,114.9060465116279
"100 UNITED NATIONS PLAZA, 12F",2003-07-08,420000,2017-05-03,1000000,580000,5048,114.89698890649763
"420 WEST 25TH   STREET, 7E",2008-03-04,1654656,2013-08-09,1882500,227844,1984,114.84072580645162
"1619 3 AVENUE, 8A",2003-02-20,479826,2012-06-27,872000,392174,3415,114.83865300146412
"340 EAST 64TH STREET, 8S",2005-05-25,1365000,2015-10-08,1800000,435000,3788,114.83632523759239
"331 EAST 8TH   STREET, 5",2007-05-25,2490000,2014-10-16,2800000,310000,2701,114.77230655312847
"1641 3 AVENUE, 16C",2003-02-20,269015,2017-09-19,880000,610985,5325,114.73896713615024
"1 IRVING PLACE, P18E",2009-09-11,885000,2018-03-02,1240000,355000,3094,114.7382029734971
"30 LITTLE WEST STREET, 26G",2015-08-21,1925000,2017-11-09,2018000,93000,811,114.67324290998766
"300 RECTOR PLACE, 2T",2013-08-19,379000,2017-11-01,555000,176000,1535,114.65798045602605
"200 RECTOR PLACE, 8T",2014-07-11,520000,2017-01-12,625000,105000,916,114.62882096069869
"103 WEST 117TH STREET, 1",2016-12-22,1405000,2017-12-06,1445000,40000,349,114.61318051575931
"2628 BROADWAY, 15A",2008-05-07,2723818,2017-05-03,3100000,376182,3283,114.5848309473043
"342 EAST 110 STREET, 5D",2010-05-13,473800,2017-06-28,772000,298200,2603,114.56012293507492
"2109 BROADWAY, 6-135",2012-02-01,550000,2014-06-23,650000,100000,873,114.5475372279496
"1641 3 AVENUE, 18J",2003-02-20,254819,2011-05-26,600000,345181,3017,114.41199867417964
"1965 BROADWAY, 16G",2004-08-19,992000,2017-09-13,1538000,546000,4773,114.39346323067254
"99 JOHN STREET, 1102",2009-10-22,430950,2014-03-19,615000,184050,1609,114.38781852082039
"121 EAST 23RD   STREET, 11D",2008-07-28,1175000,2016-02-11,1490000,315000,2754,114.37908496732027
"468 WEST 23RD STREET, 4A",2006-03-09,560037,2015-01-16,930000,369963,3235,114.36259659969087
"264 WATER STREET, 4D",2015-05-19,1074253,2017-01-27,1145000,70747,619,114.29240710823909
"420 CENTRAL PARK WEST, 4G",2004-12-17,525000,2016-02-09,990000,465000,4071,114.22254974207812
"235 WEST END AVENUE, 10F",2003-08-28,730000,2018-07-09,1350000,620000,5429,114.20151040707313
"603 WEST 148 STREET, 1B",2013-12-03,385000,2014-07-10,410000,25000,219,114.15525114155251
"415 MAIN STREET, 14-B",2010-07-01,475000,2015-03-06,670000,195000,1709,114.10181392627267
"690 RIVERSIDE DRIVE, 5C",2008-05-28,456300,2015-07-29,755000,298700,2618,114.09472880061115
"18 WEST 48TH STREET, 24D",2010-08-06,957155,2013-06-04,1075000,117845,1033,114.08034849951598
"330 SPRING STREET, 11D",2007-05-16,2392887,2013-07-17,2650000,257113,2254,114.06965394853593
"155 WEST 70TH   STREET, PH2G",2014-08-08,765000,2016-05-27,840000,75000,658,113.98176291793312
"10 WEST END AVENUE, 7A",2007-07-27,1282995,2017-08-02,1700000,417005,3659,113.96693085542498
"200 CHAMBERS STREET, 3P",2007-02-20,824782,2013-08-19,1095000,270218,2372,113.91989881956155
"240 RIVERSIDE BOULEVARD, 4 M",2006-02-22,1030275,2010-03-23,1200000,169725,1490,113.90939597315436
"421 HUDSON STREET, 507",2014-01-08,1985587,2016-07-13,2090000,104413,917,113.86368593238822
"71 NASSAU ST, 3B",2006-05-10,605858,2008-07-01,695000,89142,783,113.84674329501915
"377 RECTOR PLACE, 12G",2005-07-12,492000,2007-08-24,580000,88000,773,113.84217335058214
"315 SEVENTH AVENUE, 9C",2007-03-20,487102,2016-07-18,875000,387898,3408,113.81983568075117
"170 EAST END AVENUE, STUO8",2009-07-01,407300,2014-06-30,615000,207700,1825,113.8082191780822
"425 5 AVENUE, 26F",2004-03-04,610950,2011-02-16,900000,289050,2540,113.7992125984252
"29 WEST 65TH STREET, 2E",2014-02-28,550000,2018-05-17,725000,175000,1539,113.71020142949968
"220 RIVERSIDE BOULEVARD, 6J",2005-06-27,2505000,2018-08-14,3050000,545000,4796,113.63636363636364
"254 PARK AVENUE SOUTH, 4M",2013-06-12,873000,2017-10-31,1055000,182000,1602,113.6079900124844
"1641 3 AVENUE, 16G",2003-02-20,254819,2017-12-18,870000,615181,5415,113.60683287165281
"220 RIVERSIDE BOULEVARD, 31C",2010-09-27,1930000,2018-06-14,2250000,320000,2817,113.59602413915513
"1619 3 AVENUE, 4C",2003-02-20,240979,2014-04-28,705000,464021,4085,113.59143206854345
"308 EAST 72ND STREET, 16C",2004-10-22,1450000,2011-06-09,1725000,275000,2421,113.58942585708385
"16 WARREN STREET, 1",2010-12-02,1934675,2016-08-04,2170000,235325,2072,113.5738416988417
"200 WEST END AVENUE, 8D",2008-01-28,936790,2015-08-18,1250000,313210,2759,113.52301558535702
"342 EAST 110 STREET, PH8E",2009-12-03,470000,2015-08-31,708000,238000,2097,113.49546971864568
"247 WEST 46TH   STREET, 2004",2008-12-10,1058980,2013-04-23,1240000,181020,1595,113.4921630094044
"200 CHAMBERS STREET, 4P",2007-03-29,840056,2013-04-09,1090000,249944,2203,113.4561960962324
"75 WALL STREET, 38F",2009-09-04,1680112,2016-06-06,1960000,279888,2467,113.45277665180382
"425 MAIN STREET, 3C",2007-05-31,511000,2007-09-19,523586,12586,111,113.38738738738739
"350 WEST 42ND STREET, 6G",2006-05-30,850238,2017-02-24,1295000,444762,3923,113.37292888095845
"382 CENTRAL PARK WEST, 15X",2006-02-28,785000,2016-10-14,1225000,440000,3881,113.37284205101778
"140 SUFFOLK STREET, 140-D",2006-02-09,727000,2017-05-31,1195000,468000,4129,113.34463550496488
"82 BEAVER STREET, PH01",2007-04-09,988720,2008-10-01,1050000,61280,541,113.27171903881701
"110 MANHATTAN AVENUE, 46",2004-06-15,718000,2014-11-25,1150000,432000,3815,113.23722149410223
"45 WEST 67TH STREET, 18E",2006-07-14,925000,2018-01-08,1400000,475000,4196,113.20305052430886
"635 WEST 42ND STREET, 37J",2007-11-15,1279076,2016-11-04,1650000,370924,3277,113.1901129081477
"45 PARK AVENUE, 506",2008-02-05,1242265,2017-02-10,1615000,372735,3293,113.19010021257212
"555 WEST 23RD   STREET, S8E",2009-12-11,708000,2018-02-05,1045000,337000,2978,113.16319677635997
"201 WEST 72ND   STREET, 10I",2008-11-18,520000,2012-10-03,680000,160000,1415,113.07420494699646
"305 WEST 18TH STREET, 1C",2009-07-29,395000,2014-07-16,600000,205000,1813,113.07225592939879
"200 RIVERSIDE BOULEVARD, 15N",2005-03-23,1215000,2013-12-10,1575000,360000,3184,113.06532663316582
"184 THOMPSON STREET, 6C",2007-08-22,935000,2018-04-18,1375000,440000,3892,113.0524152106886
"225 EAST 34TH   STREET, 4J",2008-02-06,875695,2016-01-28,1205000,329305,2913,113.04668726398901
"170 EAST 87TH STREET, W18C",2006-05-19,1950000,2014-04-03,2275000,325000,2876,113.00417246175243
"247 WEST 46TH   STREET, 2203",2008-10-22,2005952,2013-11-15,2215000,209048,1850,112.99891891891892
"300 EAST 79TH STREET, 4B",2008-06-13,1909218,2014-04-16,2150000,240782,2133,112.88420065635256
"350 WEST 42ND STREET, 52E",2006-10-24,901151,2012-12-20,1155000,253849,2249,112.87194308581591
"701 MADISON AVENUE, 7D",2004-05-19,348000,2009-05-27,555000,207000,1834,112.8680479825518
"2628 BROADWAY, 15B",2008-04-25,2509986,2013-05-30,2720000,210014,1861,112.85008060182697
"721 FIFTH AVENUE, 54H",2004-10-28,1495000,2010-04-15,1720000,225000,1995,112.78195488721805
"350 WEST 42ND   STREET, 14I",2009-11-16,568000,2015-10-02,810000,242000,2146,112.76794035414726
"80 PARK AVENUE, 18H",2003-06-24,490000,2010-07-09,780000,290000,2572,112.75272161741835
"247 WEST 46TH   STREET, 3601",2008-09-23,1624108,2015-07-21,1905000,280892,2492,112.71749598715891
"100 WEST 58TH STREET, 10E",2009-09-29,800000,2014-06-25,995000,195000,1730,112.71676300578035
"120 RIVERSIDE BOULEVARD, 14H",2006-02-21,857285,2014-06-20,1200000,342715,3041,112.69812561657349
"200 WEST END AVENUE, 4D",2008-06-26,936790,2017-01-25,1290000,353210,3135,112.66666666666667
"170 EAST END AVENUE, 6A",2008-08-15,3049658,2014-09-15,3300000,250342,2222,112.66516651665167
"18 PINE STREET, 2008",2009-11-24,752742,2015-01-21,965000,212258,1884,112.66348195329087
"631 EAST 9TH   STREET, 1A&CA",2013-11-19,760750,2017-07-06,910000,149250,1325,112.64150943396227
"71 NASSAU STREET, 4B",2010-01-21,590000,2017-01-12,877000,287000,2548,112.63736263736264
"123 WASHINGTON STREET, 35G",2012-07-16,1211147,2015-12-01,1350000,138853,1233,112.6139497161395
"300 RECTOR PLACE, 7A",2003-06-09,336000,2008-02-26,530000,194000,1723,112.59431224608241
"145 EAST 48TH STREET, 19F",2005-06-29,756000,2008-05-21,875000,119000,1057,112.58278145695364
"22 WEST 15TH STREET, 4D",2008-07-16,895000,2014-02-18,1125000,230000,2043,112.57953989231522
"257 WEST 117TH STREET, 4G",2008-07-24,646588,2016-04-22,965000,318412,2829,112.55284552845528
"106 CENTRAL PARK SOUTH, 15D",2004-07-07,307500,2007-08-14,435000,127500,1133,112.53309796999118
"200 CHAMBERS STREET, 5K",2007-03-13,850238,2017-10-11,1285000,434762,3865,112.4869340232859
"303 WEST 149 STREET, 5R",2011-04-29,233220,2015-07-31,408000,174780,1554,112.47104247104247
"99 JOHN STREET, 803",2010-12-09,470000,2013-09-27,585000,115000,1023,112.41446725317694
"555 WEST 23 STREET, N5H",2006-02-27,679965,2016-05-23,1100000,420035,3738,112.3689138576779
"467 CENTRAL PARK WEST, 14B",2005-12-19,1275000,2016-03-16,1695000,420000,3740,112.29946524064171
"75 WALL STREET, 33K",2009-05-15,984647,2015-11-03,1250000,265353,2363,112.29496402877697
"1623 3 AVENUE, 8B",2003-02-20,149058,2010-05-10,445000,295942,2636,112.26934749620638
"690 RIVERSIDE DRIVE, 2B",2010-02-19,415740,2015-06-26,635000,219260,1953,112.26830517153098
"100 CENTRAL PARK SOUTH, 3D",2006-03-17,1338998,2015-11-13,1735000,396002,3528,112.24546485260771
"225 EAST 34TH   STREET, 17I",2008-03-14,1013158,2017-10-04,1405000,391842,3491,112.2434832426239
"68 BRADHURST AVENUE, 4-R",2007-06-12,455034,2015-07-01,785000,329966,2941,112.19517171030262
"1619 3 AVENUE, 15D",2003-02-20,256240,2011-07-12,600000,343760,3064,112.19321148825065
"107 AVENUE A, 5F",2006-02-10,677138,2008-02-19,760000,82862,739,112.12719891745603
"225 WEST 83RD   STREET, 11M",2007-04-09,1250000,2011-07-18,1425000,175000,1561,112.10762331838565
"404 EAST 79TH STREET, 22H",2008-09-18,1150000,2014-07-31,1390000,240000,2142,112.04481792717087
"255 HUDSON STREET, 4G",2006-09-28,1033523,2017-07-14,1475000,441477,3942,111.9931506849315
"455 MAIN STREET, 12A",2006-04-19,396474,2014-08-29,738500,342026,3054,111.99279633267845
"515 EAST 72ND   STREET, 25H",2009-01-09,1435732,2016-07-15,1743000,307268,2744,111.97813411078717
"175 EAST BROADWAY, 6C",2014-12-01,2500000,2018-08-02,2650000,150000,1340,111.94029850746269
"425 CENTRAL PARK WEST, 6C",2008-05-21,528982,2018-07-25,945000,416018,3717,111.92305622814098
"99 JOHN STREET, 517",2014-01-30,565000,2017-02-02,688000,123000,1099,111.9199272065514
"1641 3 AVENUE, 24J",2003-02-20,268660,2011-08-25,616500,347840,3108,111.91763191763192
"144 COLUMBUS AVENUE, 8E",2007-04-05,910000,2011-09-27,1093000,183000,1636,111.85819070904645
"392 CENTRAL PARK WEST, 3A",2004-03-25,481650,2014-05-08,895000,413350,3696,111.83712121212122
"300 RECTOR PLACE, 2A",2014-05-30,355000,2015-11-06,413712,58712,525,111.83238095238096
"525 EAST 11TH STREET, 3C",2013-04-04,870000,2017-11-28,1060000,190000,1699,111.83048852266039
"252 SEVENTH AVENUE, 11N",2006-09-12,1180000,2018-05-24,1657500,477500,4272,111.77434456928839
"143 AVENUE B, 3D",2003-03-27,685000,2011-10-06,1033000,348000,3115,111.71749598715891
"505 GREENWICH STREET, 12B",2005-03-24,1659747,2010-12-29,1895000,235253,2106,111.70607787274454
"1600 BROADWAY, 9A",2006-07-19,962246,2014-10-29,1300000,337754,3024,111.69113756613757
"425 5 AVENUE, 25E",2004-01-20,585494,2013-12-20,990000,404506,3622,111.68028713418
"10 WEST END AVENUE, 10F",2007-07-30,799326,2017-05-17,1199000,399674,3579,111.67197541212629
"68 BRADHURST AVENUE, 5-N",2007-06-14,453222,2017-06-05,860000,406778,3644,111.62952799121844
"404 EAST 66 STREET, 7R",2005-04-15,357000,2007-10-25,460000,103000,923,111.59263271939328
"14 PRINCE STREET, 4B",2005-01-19,877500,2012-05-08,1175000,297500,2666,111.59039759939985
"250 EAST 40TH   STREET, 34A",2009-07-15,590000,2017-05-22,910000,320000,2868,111.57601115760112
"200 EAST 32ND STREET, 6C",2006-05-02,995000,2015-07-15,1370000,375000,3361,111.57393632847366
"2148 BROADWAY, 14C",2011-11-01,2520000,2017-05-19,2746000,226000,2026,111.54985192497531
"232-36 EAST 47 STREET, 38A",2003-05-22,740000,2004-03-31,775000,35000,314,111.46496815286625
"10 WEST END AVENUE, 7F",2007-07-16,768778,2016-03-10,1121000,352222,3160,111.4626582278481
"240 RIVERSIDE BOULEVARD, 3 F",2006-02-16,822938,2011-09-16,1050000,227062,2038,111.41413150147203
"247 WEST 46TH STREET, 204",2010-03-15,670000,2014-05-19,840000,170000,1526,111.40235910878113
"77 PARK AVENUE, 5C",2003-03-11,642000,2011-05-19,975000,333000,2991,111.33400200601805
"120 RIVERSIDE BOULEVARD, 4B",2005-11-29,539672,2013-07-19,850000,310328,2789,111.2685550376479
"240 WEST END AVENUE, 4C",2010-03-03,707683,2011-12-13,780000,72317,650,111.25692307692307
"210 WEST 19TH   STREET, 2J",2004-04-19,385000,2016-12-22,900000,515000,4630,111.23110151187905
"156-08 RIVERSIDE DRIVE WEST, 5K",2015-12-08,451230,2017-03-13,502500,51270,461,111.21475054229936
"65 LEONARD STREET, 3",2005-03-30,1695000,2012-10-02,2000000,305000,2743,111.19212541013489
"455 MAIN STREET, 10D",2006-03-16,344760,2014-08-19,687000,342240,3078,111.18908382066277
"455 MAIN STREET, 16C",2006-04-28,733140,2017-03-15,1175000,441860,3974,111.18772018117765
"5 FRANKLIN PLACE, 7A",2016-01-12,3402500,2018-06-07,3500000,97500,877,111.17445838084379
"80 JOHN STREET, 13G",2007-07-31,893514,2015-09-30,1225000,331486,2983,111.12504190412336
"184 THOMPSON STREET, 6S",2007-08-28,850238,2015-04-16,1160000,309762,2788,111.10545193687231
"655 SIXTH AVENUE, 3G",2007-07-16,1476462,2012-12-03,1695000,218538,1967,111.1021860701576
"100 RIVERSIDE BOULEVARD, 5H",2008-02-14,1395002,2014-02-28,1640000,244998,2206,111.05983680870354
"505 GREENWICH STREET, 4C",2008-08-01,1420000,2014-07-02,1660000,240000,2161,111.05969458583989
"1623 3 AVENUE, 25D",2003-02-20,270791,2014-09-15,740000,469209,4225,111.05538461538461
"200 WEST END AVENUE, 16B",2008-08-01,1064071,2015-05-22,1340000,275929,2485,111.03782696177062
"1 IRVING PLACE, V21G",2007-08-23,719000,2014-06-13,995000,276000,2486,111.02172164119067
"421 EAST 13TH   STREET, 6G",2008-04-21,855330,2015-01-30,1130000,274670,2475,110.97777777777777
"555 WEST 59TH STREET, 16D",2008-03-21,1017231,2014-12-15,1290000,272769,2460,110.88170731707316
"415 MAIN STREET, 15-D",2010-02-18,572765,2014-05-22,745000,172235,1554,110.83333333333333
"1965 BROADWAY, 15E",2006-03-03,2275000,2016-09-01,2700000,425000,3835,110.82138200782269
"135 WEST 70TH   STREET, 7H",2010-04-14,1550000,2018-04-25,1875000,325000,2933,110.80804636890555
"400 EAST 70TH STREET, 804",2011-05-03,750000,2018-04-03,1030000,280000,2527,110.80332409972299
"333 EAST 45TH STREET, 21E",2011-07-26,615000,2015-07-09,775000,160000,1444,110.80332409972299
"100 UNITED NATIONS PLAZA, 9B",2005-04-04,1100000,2010-03-16,1300000,200000,1807,110.68068622025457
"247 WEST 46TH   STREET, 1506",2009-06-05,916425,2018-04-19,1275000,358575,3240,110.67129629629629
"200 CHAMBERS STREET, 6I",2007-04-04,646588,2013-07-12,900000,253412,2291,110.61195984286339
"450 EAST 83RD STREET, 7E",2006-06-01,1535000,2010-08-16,1705000,170000,1537,110.60507482108002
"1991 BROADWAY, 23C",2003-06-30,211000,2013-02-05,599000,388000,3508,110.60433295324971
"240 PARK AVENUE SOUTH, 14D",2008-04-10,1328816,2014-05-15,1575000,246184,2226,110.59478885893981
"154 ATTORNEY STREET, 502",2006-12-05,1272812,2018-02-14,1725000,452188,4089,110.58645145512351
"99 JOHN STREET, 2008",2012-06-05,690000,2018-07-27,938000,248000,2243,110.56620597414178
"99 JOHN STREET, 2101",2010-01-12,650000,2018-04-30,985000,335000,3030,110.56105610561056
"117 BEEKMAN STREET, 4B",2003-02-07,430000,2014-04-01,880000,450000,4071,110.5379513633014
"516 WEST 47TH   STREET, S5K",2012-04-16,415000,2016-12-30,605000,190000,1719,110.52937754508436
"220 MANHATTAN AVENUE, 2J",2004-10-21,200000,2016-06-14,670000,470000,4254,110.48425011753643
"143 AVENUE B, 8C",2006-01-27,460000,2013-04-05,750000,290000,2625,110.47619047619048
"630 FIRST AVENUE, 25B",2004-08-17,775000,2012-09-06,1100000,325000,2942,110.46906866077498
"408 EAST 79TH STREET, 7A",2005-12-09,1824334,2007-04-27,1880000,55666,504,110.4484126984127
"120 RIVERSIDE BOULEVARD, 6P",2005-12-16,538124,2015-10-20,935000,396876,3595,110.39666203059805
"1600 BROADWAY, 17B",2006-06-16,896060,2016-06-22,1300000,403940,3659,110.39628313746925
"15 BROAD STREET, 2712",2006-08-02,1243215,2015-06-08,1600000,356785,3232,110.39139851485149
"301 EAST 79TH   STREET, 22C",2010-04-22,650000,2015-04-08,850000,200000,1812,110.37527593818984
"199 BOWERY, 10C",2006-05-08,430950,2008-07-23,520000,89050,807,110.34696406443618
"1619 3 AVENUE, 3B",2003-02-20,124215,2010-06-24,420000,295785,2681,110.32637075718016
"364 WEST 117 STREET, 4A",2005-03-15,129550,2013-11-25,480000,350450,3177,110.30846710733397
"160 WADSWORTH AVENUE, 407",2012-01-04,265000,2017-03-22,475000,210000,1904,110.29411764705883
"112 WEST 72ND STREET, 6G",2004-09-20,549855,2018-05-18,1100000,550145,4988,110.29370489174018
"10 WEST END AVENUE, 11G",2007-08-16,885877,2013-10-22,1135000,249123,2259,110.28021248339974
"200 CHAMBERS STREET, 8B",2007-03-29,1547740,2011-09-19,1728000,180260,1635,110.25076452599389
"100 RIVERSIDE BOULEVARD, 29E",2008-07-23,1634291,2014-01-15,1855000,220709,2002,110.24425574425574
"845 UNITED NATIONS PLAZA, 23C",2010-12-17,1065000,2018-08-29,1375000,310000,2812,110.24182076813656
"215 WEST 90TH   STREET, 2-D",2007-06-21,1745000,2017-07-12,2150000,405000,3674,110.23407729994557
"10 WEST END AVENUE, 6B",2007-07-16,1206117,2018-07-25,1650000,443883,4027,110.22671964241371
"529 WEST 147 STREET, 4A",2006-01-18,431964,2008-03-27,520000,88036,799,110.18272841051314
"220 MANHATTAN AVENUE, 5L",2004-03-12,220000,2012-05-25,550000,330000,2996,110.14686248331108
"111 FULTON STREET, 305",2010-06-18,467500,2012-07-06,550000,82500,749,110.14686248331108
"101 WEST 79TH   STREET, 5C",2007-08-02,1300000,2013-03-06,1525000,225000,2043,110.13215859030836
"801 RIVERSIDE DRIVE, 4B",2010-07-26,436000,2017-03-02,701500,265500,2411,110.12028204064704
"1619 3 AVENUE, 17G",2003-02-20,285696,2014-03-10,730000,444304,4036,110.08523290386522
"40 WEST 116 STREET, A1001",2008-08-20,321280,2014-01-28,540000,218720,1987,110.07549068948163
"14 LEONARD STREET, 6C",2004-11-18,2395000,2012-06-20,2700000,305000,2771,110.0685673042223
"220 EAST 65TH STREET, 2A",2012-11-30,690000,2018-02-20,900000,210000,1908,110.062893081761
"1 IRVING PLACE, G20B",2008-03-26,985000,2017-12-08,1375000,390000,3544,110.0451467268623
"33 WEST 56TH   STREET, 9A",2011-06-22,2830735,2014-06-10,2950000,119265,1084,110.0230627306273
"111 FULTON STREET, 711",2009-02-05,1527375,2015-11-20,1800000,272625,2479,109.97377974989915
"1600 BROADWAY, 19B",2006-07-20,890968,2016-02-12,1275000,384032,3494,109.9118488838008
"235 EAST 40TH   STREET, 31B",2009-06-30,835000,2018-02-02,1180000,345000,3139,109.90761388977381
"211 EAST 46TH   STREET, PHD",2009-05-11,556957,2018-02-07,908000,351043,3194,109.9070131496556
"113 ELDRIDGE  STREET, 4B",2009-01-15,61094,2010-04-05,109998,48904,445,109.89662921348315
"2 EAST 55TH   STREET, 903",2006-12-06,728048,2007-04-24,743322,15274,139,109.88489208633094
"250 EAST 53RD STREET, 703",2008-08-05,997885,2014-04-03,1225000,227115,2067,109.87663280116111
"1601 3 AVENUE, 18C",2003-02-20,270080,2011-07-19,607500,337420,3071,109.87300553565613
"315 SEVENTH AVENUE, 4A",2007-02-14,518262,2018-04-03,965000,446738,4066,109.87161829808166
"70 BATTERY PLACE, 7B",2008-12-16,1349181,2013-03-20,1520000,170819,1555,109.85144694533761
"302 WEST 122 STREET, 1A",2013-08-12,425000,2016-06-24,540000,115000,1047,109.83763132760268
"150 WEST 51ST   STREET, 18-12",2010-09-21,510000,2013-06-19,620000,110000,1002,109.78043912175649
"100 RIVERSIDE BOULEVARD, 4G",2008-05-06,1065000,2015-07-31,1355000,290000,2642,109.76532929598788
"515 EAST 72ND   STREET, 14G",2008-08-14,1410276,2014-09-23,1655000,244724,2231,109.69251456745855
"120 RIVERSIDE BOULEVARD, 8H",2006-01-18,808409,2017-01-26,1250000,441591,4026,109.68479880774963
"2 SOUTH END AVENUE, 8R",2005-05-11,670000,2013-11-06,1010000,340000,3101,109.64205095130603
"112 WEST 72 STREET, 4A",2004-06-14,499000,2014-05-05,895000,396000,3612,109.63455149501661
"150 NASSAU STREET, 13C",2004-02-05,1410276,2012-01-31,1730000,319724,2917,109.60713061364416
"555 WEST 23RD   STREET, N12A",2007-02-08,1250000,2010-09-23,1395000,145000,1323,109.59939531368103
"310 WEST 52ND   STREET, 36A",2007-04-26,1169460,2013-09-13,1425000,255540,2332,109.57975986277873
"2250 BROADWAY, 3F",2009-03-30,710000,2018-05-14,1075000,365000,3332,109.5438175270108
"344 EAST 50 STREET, 10/1A",2006-01-03,440000,2006-10-04,470000,30000,274,109.48905109489051
"225 EAST 34TH STREET, 3A",2007-10-24,548836,2008-06-19,575000,26164,239,109.47280334728033
"225 EAST 34TH   STREET, 12K",2007-11-27,865512,2014-04-09,1120000,254488,2325,109.45720430107527
"252 SEVENTH AVENUE, 3S",2005-08-25,1200000,2015-07-13,1595000,395000,3609,109.44860072042117
"77 PARK AVENUE, 12C",2004-05-17,785000,2016-01-08,1250000,465000,4253,109.3345873501058
"68 BRADHURST AVENUE, 5-E",2007-05-23,453222,2017-11-17,872000,418778,3831,109.31297311406944
"393 WEST 49TH STREET, 5DD",2013-09-12,930000,2016-09-14,1050000,120000,1098,109.2896174863388
"455 EAST 86TH STREET, 14E",2015-02-18,735000,2017-11-21,845000,110000,1007,109.23535253227408
"133 ESSEX STREET, 301",2007-01-23,834965,2018-06-20,1290000,455035,4166,109.22587614018244
"209 EAST 51ST   STREET, 7E",2009-10-23,1323725,2018-03-29,1660000,336275,3079,109.21565443325755
"225 EAST 34TH   STREET, 8B",2008-03-17,1023341,2013-11-22,1250000,226659,2076,109.1806358381503
"14 PRINCE STREET, 3F",2005-12-01,749000,2017-03-24,1200000,451000,4131,109.17453401113532
"235 EAST 40TH   STREET, 8F",2012-06-08,620000,2017-12-05,839000,219000,2006,109.17248255234297
"18 PINE STREET, 503",2009-05-07,556000,2015-08-05,805000,249000,2281,109.16264796142043
"125 CENTRAL PARK NORTH, 2B",2006-08-08,643637,2014-04-17,950000,306363,2809,109.06479174083303
"257 WEST 17TH   STREET, 2D",2008-04-17,2800000,2013-04-25,3000000,200000,1834,109.05125408942203
"43 WEST 64TH   STREET, 8D",2009-11-30,2429460,2012-09-27,2542000,112540,1032,109.05038759689923
"120 RIVERSIDE BOULEVARD, 9B",2006-01-11,560037,2013-07-25,860000,299963,2752,108.99818313953489
"404 EAST 79TH   STREET, 26G",2007-03-23,1085000,2013-11-18,1350000,265000,2432,108.96381578947368
"240 RIVERSIDE BOULEVARD, 3 J",2005-09-21,592500,2009-04-21,735000,142500,1308,108.94495412844037
"1601 3 AVENUE, 15C",2003-02-20,265822,2011-04-07,589000,323178,2968,108.88746630727763
"121 EAST 23RD   STREET, 5C",2013-03-15,642100,2017-07-20,815000,172900,1588,108.87909319899245
"467 CENTRAL PARK WEST, 1B",2009-01-30,550000,2017-01-04,865000,315000,2896,108.7707182320442
"505 WEST 47TH   STREET, 4E-S",2009-11-06,712000,2016-09-20,985000,273000,2510,108.76494023904382
"60 HENRY STREET, 8F1",2005-11-25,350000,2011-03-10,560000,210000,1931,108.75194199896427
"5 EAST 22ND STREET, 24T",2005-06-15,741286,2007-12-10,840000,98714,908,108.71585903083701
"372 CENTRAL PARK WEST, 5X",2005-10-03,815000,2018-06-05,1318000,503000,4628,108.68625756266206
"455 CENTRAL PARK WEST, 19A",2005-03-30,2545625,2010-10-22,2766400,220775,2032,108.64911417322834
"100 RIVERSIDE BOULEVARD, 15D",2008-05-07,1812485,2013-07-30,2020000,207515,1910,108.64659685863874
"211 EAST 46TH   STREET, 6A",2008-05-12,585493,2015-07-14,870000,284507,2619,108.63192058037419
"1619 3 AVENUE, 22J",2003-02-20,303441,2014-10-09,765000,461559,4249,108.62767710049424
"88 GREENWICH STREET, 825",2009-11-05,677000,2014-09-17,870000,193000,1777,108.61001688238605
"635 WEST 42ND   STREET, 33E",2007-05-07,1260084,2015-12-03,1600000,339916,3132,108.53001277139208
"1623 3 AVENUE, 21G",2003-02-20,273984,2012-07-02,645000,371016,3420,108.48421052631579
"250 EAST 53RD   STREET, 701",2010-09-23,1235000,2016-08-29,1470000,235000,2167,108.44485463774804
"186 WEST 80 STREET, 6M",2003-12-22,335000,2005-02-09,380000,45000,415,108.43373493975903
"500 WEST 43RD   STREET, 16B",2009-08-04,720000,2013-08-19,880000,160000,1476,108.40108401084011
"80 PARK AVENUE, 10E",2003-09-18,485000,2014-07-29,915000,430000,3967,108.39425258381648
"40 EAST 78TH STREET, 7F",2005-08-12,1807468,2011-09-28,2050000,242532,2238,108.36997319034853
"205 EAST 59TH   STREET, 8B",2008-07-31,1625000,2015-10-13,1910000,285000,2630,108.36501901140684
"1641 3 AVENUE, 20E",2003-03-12,135573,2010-01-29,408000,272427,2515,108.32087475149105
"505 GREENWICH STREET, 14G",2005-04-15,855330,2018-04-20,1370000,514670,4753,108.28318956448558
"11 PRINCE STREET, 4A",2008-07-22,924000,2015-01-12,1180000,256000,2365,108.24524312896406
"90 WILLIAM STREET, 10G",2008-07-17,878000,2017-12-15,1250000,372000,3438,108.2024432809773
"280 PARK AVENUE SOUTH, 11F",2005-12-15,800000,2016-01-29,1200000,400000,3697,108.19583446037328
"100 UNITED NATIONS PLAZA, 32C",2004-06-14,1065000,2009-02-19,1250000,185000,1711,108.1239041496201
"322 WEST 57TH STREET, 20J",2007-09-20,661862,2016-01-11,990000,328138,3035,108.11795716639209
"10 WEST END AVENUE, 8G",2007-07-18,894204,2014-08-28,1175000,280796,2598,108.0816012317167
"350 WEST 42ND STREET, 53F",2007-05-22,972500,2017-05-02,1365000,392500,3633,108.03743462703001
"421 EAST 13TH   STREET, 5H",2008-02-04,799326,2013-10-24,1025000,225674,2089,108.02967927237913
"80 JOHN STREET, 10C",2007-06-22,1513628,2015-07-01,1830000,316372,2931,107.93995223473217
"110 WEST 86TH STREET, 11E",2010-03-10,650000,2018-07-24,980000,330000,3058,107.9136690647482
"247 WEST 46TH   STREET, 1003",2008-08-20,1781937,2017-06-20,2130000,348063,3226,107.893056416615
"200 WEST END AVENUE, 9L",2008-02-15,1400093,2017-02-17,1755000,354907,3290,107.87446808510639
"350 WEST 42ND STREET, 5E",2006-04-14,545782,2014-03-28,859000,313218,2905,107.82030981067126
"99 JOHN STREET, 1008",2011-05-16,613500,2018-08-06,898000,284500,2639,107.80598711633195
"195 BOWERY, 7W",2006-07-31,885877,2010-03-29,1030000,144123,1337,107.79581151832461
"350 WEST 50TH STREET, 29F",2006-07-28,1105100,2017-02-10,1520000,414900,3850,107.76623376623377
"258 ST NICHOLAS AVENUE, 8F",2008-06-12,467296,2017-08-07,827500,360204,3343,107.74872868680825
"1601 3 AVENUE, 11C",2003-02-20,260144,2013-01-18,650000,389856,3620,107.69502762430939
"10 WEST END AVENUE, 29B",2007-09-19,1634647,2012-09-06,1830000,195353,1814,107.69184123484013
"200 EAST 69TH   STREET, 20B",2010-03-12,2150000,2017-03-09,2425000,275000,2554,107.6742364917776
"275 WEST 96TH STREET, 9H",2011-05-16,600000,2018-06-20,879000,279000,2592,107.63888888888889
"225 EAST 46TH STREET, 10K",2012-06-27,395000,2016-12-09,570000,175000,1626,107.6260762607626
"25 CENTRAL PARK WEST, 6W",2003-02-24,620000,2012-09-10,995000,375000,3486,107.57314974182444
"372 CENTRAL PARK WEST, 17G",2004-07-08,435000,2007-01-24,535000,100000,930,107.52688172043011
"343 EAST 30TH   STREET, 6-F",2010-07-30,425000,2015-09-02,625000,200000,1860,107.52688172043011
"26 EAST 63RD STREET, 10E",2007-08-06,395000,2015-03-27,695000,300000,2790,107.52688172043011
"166 EAST 63RD   STREET, 10L",2011-09-21,455000,2016-01-19,625000,170000,1581,107.52688172043011
"516 WEST 47TH STREET, S7M",2013-03-28,630000,2018-07-11,837500,207500,1931,107.45727602278612
"310 EAST 53RD STREET, 4/5D",2007-01-08,1531753,2016-05-27,1900000,368247,3427,107.45462503647505
"305 SECOND AVENUE, 522",2005-10-05,1100000,2012-05-22,1360000,260000,2421,107.393638992152
"220 WEST 148 STREET, 5M",2011-05-31,428589,2017-08-14,672000,243411,2267,107.37141596823996
"150 WEST 51ST STREET, 21-4",2005-05-09,985000,2018-06-27,1500000,515000,4797,107.35876589535125
"100 WEST 58TH   STREET, 12H",2009-02-13,775000,2014-09-26,995000,220000,2051,107.26474890297416
"119 EAST 101 STREET, 3B",2012-06-14,417768,2015-06-12,535000,117232,1093,107.25709057639524
"154 ATTORNEY STREET, 402",2006-12-08,1247356,2014-12-01,1560000,312644,2915,107.25351629502573
"220 WEST 93RD STREET, 12C",2007-08-06,997885,2017-03-23,1375000,377115,3517,107.22632925789024
"25 CENTRAL PARK WEST, 9W",2004-04-26,760000,2010-06-03,999000,239000,2229,107.22296994167789
"1 MORTON SQUARE, 5E W",2004-10-28,1934675,2009-09-08,2125000,190325,1776,107.16497747747748
"181 EAST 90TH STREET, 14B",2008-07-17,2232500,2015-05-11,2499000,266500,2489,107.07111289674567
"225 LAFAYETTE STREET, 6A",2005-02-08,1206626,2009-09-01,1385000,178374,1666,107.0672268907563
"1760 2 AVENUE, 15A",2003-03-26,334540,2013-08-07,740000,405460,3787,107.06627937681542
"510 EAST 80TH   STREET, 12B",2009-10-06,725000,2014-07-29,913000,188000,1757,107.00056915196357
"200 CHAMBERS STREET, 3R",2007-03-12,575311,2013-08-01,825000,249689,2334,106.9790059982862
"116 CENTRAL PARK SOUTH, 9G",2010-02-03,555000,2018-01-10,865000,310000,2898,106.97032436162871
"2628 BROADWAY, 6B",2007-10-18,1807393,2018-06-26,2225000,417607,3904,106.96900614754098
"314 WEST 94TH STREET, 4B",2006-02-21,970000,2015-03-25,1325000,355000,3319,106.95992768906297
"100 RIVERSIDE BOULEVARD, 11H",2008-04-23,1486645,2014-02-27,1715000,228355,2136,106.90777153558052
"121 WEST 19TH   STREET, 8E",2013-01-15,2050000,2018-03-01,2250000,200000,1871,106.89470871191877
"408 EAST 79TH STREET, 10B",2005-12-12,2163525,2008-10-20,2275000,111475,1043,106.87919463087249
"124 WEST 24TH   STREET, PHD",2008-02-21,1906164,2016-12-13,2250000,343836,3218,106.84773151025482
"464 WEST 44TH   STREET, 7D",2008-01-29,1248364,2017-05-08,1610000,361636,3387,106.77177443165043
"255 CABRINI BOULEVARD, 4E",2009-04-30,95593,2016-02-10,360000,264407,2477,106.74485264432782
"15 BROAD STREET, 2004",2006-06-16,793292,2018-04-23,1255000,461708,4329,106.65465465465465
"75 WALL STREET, 25M",2008-12-22,1507010,2015-03-20,1750000,242990,2279,106.62132514260641
"150 NASSAU STREET, 7H",2004-08-18,850000,2018-02-14,1375000,525000,4928,106.5340909090909
"160 WEST 66TH STREET, 30C",2009-12-10,685000,2017-05-25,975000,290000,2723,106.50018362100624
"120 EAST 87TH   STREET, R4-N",2007-08-28,800000,2012-10-09,999000,199000,1869,106.47405029427502
"88 GREENWICH STREET, 617",2013-06-17,650000,2015-05-04,723000,73000,686,106.41399416909621
"200 RIVERSIDE BOULEVARD, 8E",2004-12-15,685000,2007-04-10,775000,90000,846,106.38297872340425
"1641 3 AVENUE, 15C",2003-02-20,266886,2018-07-16,865000,598114,5625,106.33137777777777
"30 EAST 37TH   STREET, 10C",2007-02-21,324480,2012-12-12,550000,225520,2121,106.32720414898633
"230 RIVERSIDE DRIVE, PHAD",2007-09-17,3879532,2018-07-16,4300000,420468,3955,106.31302149178255
"120 RIVERSIDE BOULEVARD, PH1F",2006-03-31,1050834,2012-08-30,1300000,249166,2344,106.29948805460751
"16 WEST 48TH   STREET, 7E",2009-09-25,565128,2015-10-14,800000,234872,2210,106.27692307692308
"455 MAIN STREET, 16D",2006-09-08,1298268,2014-06-19,1600000,301732,2841,106.20626539950722
"555 WEST 59TH STREET, 16H",2008-03-24,946972,2014-04-15,1182000,235028,2213,106.20334387708992
"245 EAST 93RD   STREET, 28J",2007-06-22,930000,2016-10-05,1290000,360000,3393,106.10079575596816
"225 EAST 46 STREET, 8B",2003-01-08,245000,2004-01-20,285000,40000,377,106.10079575596816
"382 CENTRAL PARK WEST, 12N",2006-07-11,725000,2016-03-15,1100000,375000,3535,106.08203677510608
"450 EAST 83RD STREET, 14C",2007-06-06,1936711,2016-10-21,2300000,363289,3425,106.06978102189781
"249 EAST 118 STREET, 5A",2010-04-26,491481,2015-06-11,690000,198519,1872,106.04647435897436
"308 EAST 72ND STREET, 5D",2005-05-27,1750000,2018-04-24,2250000,500000,4715,106.04453870625663
"450 WEST 17TH   STREET, 1116",2009-05-20,725000,2015-04-28,955000,230000,2169,106.03964960811435
"425 FIFTH AVENUE, 46D",2005-05-03,1109892,2017-06-23,1580000,470108,4434,106.0234551195309
"8 UNION SQUARE SOUTH, 10B",2007-10-31,2392887,2010-11-09,2510000,117113,1105,105.98461538461538
"250 EAST 53RD STREET, 3203",2008-06-25,1428169,2017-07-28,1780000,351831,3320,105.97319277108434
"157 LUDLOW STREET, 2R",2005-10-12,400530,2016-09-30,825000,424470,4006,105.95856215676486
"225 WEST 83 STREET, 20Z",2004-04-21,690000,2013-08-13,1050000,360000,3401,105.8512202293443
"205 EAST 85TH   STREET, 7K",2009-05-19,1381353,2016-12-23,1675000,293647,2775,105.81873873873874
"163 ST NICHOLAS AVENUE, 3C",2004-06-01,395460,2014-03-28,775000,379540,3587,105.8098689712852
"220 EAST 65TH STREET, 11J",2005-03-30,507000,2010-07-01,710000,203000,1919,105.78426263678999
"450 WEST 17TH   STREET, 1003",2008-09-19,1451006,2011-04-13,1550000,98994,936,105.76282051282051
"145 EAST 48 STREET, 6B",2004-04-07,325000,2005-03-04,360000,35000,331,105.74018126888218
"303 GREENWICH STREET, 2K",2008-03-13,1755000,2017-02-17,2100000,345000,3263,105.7309224639902
"150 NASSAU STREET, 7C",2003-09-25,393432,2015-09-08,855000,461568,4366,105.71873568483738
"211 EAST 46TH   STREET, 29D",2008-09-29,709374,2013-08-28,899000,189626,1794,105.70011148272017
"255 CABRINI BOULEVARD, 6E",2009-04-30,102560,2017-01-12,400000,297440,2814,105.70007107320541
"350 WEST 42 STREET, 26E",2006-08-02,688337,2013-07-18,957000,268663,2542,105.68961447678993
"425 5 AVENUE, 22F",2004-07-13,626223,2012-07-13,935000,308777,2922,105.6731690622861
"127 WEST 82 STREET, 3A",2003-08-08,703000,2017-02-15,1225000,522000,4940,105.66801619433198
"500 WEST END AVENUE, 2C",2004-05-07,1900000,2010-10-29,2150000,250000,2366,105.66356720202874
"225 EAST 86TH STREET, 903",2014-05-06,675000,2017-04-19,789000,114000,1079,105.6533827618165
"505 WEST 47TH   STREET, 5C-S",2009-11-17,699000,2018-04-30,1025000,326000,3086,105.63836681788723
"140 EAST 63RD   STREET, 7G",2007-12-12,1196443,2011-12-05,1350000,153557,1454,105.61004126547455
"21 SOUTH END AVENUE, PH1L",2003-10-24,470000,2014-04-24,875000,405000,3835,105.60625814863103
"425 5 AVENUE, 62A",2004-04-15,1318634,2017-02-28,1815000,496366,4702,105.56486601446193
"630 1 AVENUE, 24G",2003-07-31,435000,2010-06-15,700000,265000,2511,105.53564317005177
"184 THOMPSON STREET, 6O",2007-05-24,799326,2015-09-18,1120000,320674,3039,105.5195788088187
"40 BROAD STREET, 26B",2012-03-01,988975,2013-10-01,1050000,61025,579,105.3972366148532
"150 NASSAU STREET, 4F",2003-05-28,336023,2014-06-06,760000,423977,4027,105.28358579587783
"106 WEST 116 STREET, 2B",2009-02-25,605858,2016-10-20,900000,294142,2794,105.27630637079456
"250 EAST 54TH STREET, 38B",2012-04-04,1830000,2014-08-07,1920000,90000,855,105.26315789473684
"2628 BROADWAY, 16A",2008-06-03,2800187,2013-06-28,2995000,194813,1851,105.247433819557
"11 EAST 29TH   STREET, 19B",2008-02-01,956136,2013-04-05,1155000,198864,1890,105.21904761904761
"227 WEST 116 STREET, 2C",2007-07-19,458328,2014-08-13,730000,271672,2582,105.21766072811774
"424 WEST 49TH STREET, 6B",2005-03-14,655753,2012-01-30,920000,264247,2513,105.15200955033824
"448 WEST 37TH STREET, 11F",2008-01-31,1200000,2014-08-05,1450000,250000,2378,105.13036164844407
"14 PRINCE STREET, 3G",2004-11-12,668000,2011-06-30,922500,254500,2421,105.12185047501032
"68 BRADHURST AVENUE, 4-L",2007-09-14,455034,2016-03-02,780000,324966,3092,105.09896507115135
"230 WEST 56TH STREET, 48D",2005-01-31,1080000,2010-10-26,1300000,220000,2094,105.06208213944603
"235 EAST 40TH STREET, 17A",2005-05-26,1050000,2014-07-10,1400000,350000,3332,105.04201680672269
"350 EAST 82ND   STREET, 4M",2009-05-15,540000,2013-05-30,695000,155000,1476,105.01355013550136
"132 WEST 123RD ST, G",2006-05-16,544763,2018-03-20,999000,454237,4326,105.00161812297735
"225 FIFTH AVENUE, 5F",2009-01-30,1625000,2012-08-08,1760000,135000,1286,104.97667185069984
"15 BROAD STREET, 3700",2007-04-23,2306336,2008-06-12,2350000,43664,416,104.96153846153847
"147 WEST 142ND STREET, 3B",2012-02-28,300000,2018-03-19,532000,232000,2211,104.92989597467209
"415 MAIN STREET, 6-E",2009-12-15,430950,2015-02-24,630000,199050,1897,104.92883500263574
"317 EAST 111 STREET, 1C",2012-12-19,492500,2018-08-23,710000,217500,2073,104.92040520984081
"120 RIVERSIDE BOULEVARD, 7V",2006-02-14,610950,2014-09-17,940000,329050,3137,104.89321007331846
"408 EAST 79TH STREET, 15B",2005-12-12,2573324,2018-05-25,3050000,476676,4547,104.83307675390367
"16 WEST 19TH   STREET, 8-E",2008-01-17,1033523,2013-03-06,1230000,196477,1875,104.78773333333334
"581 ACADEMY STREET, 1C",2005-01-20,165000,2008-02-01,281000,116000,1107,104.7877145438121
"325 FIFTH AVENUE, 40A",2007-02-01,2036500,2011-05-12,2200000,163500,1561,104.74055092889174
"380 LENOX AVENUE, 8J",2007-02-14,837724,2015-12-10,1175000,337276,3221,104.71158025457932
"845 UNITED NATIONS PLAZA, 18C",2005-11-01,1175000,2015-02-13,1530000,355000,3391,104.68888233559422
"382 CENTRAL PARK WEST, 12C",2004-12-22,860000,2009-12-11,1050000,190000,1815,104.6831955922865
"203 WEST 81ST STREET, 7E",2004-10-08,700000,2014-07-31,1075000,375000,3583,104.66089868825007
"16 WEST 19TH   STREET, 4-E",2007-11-29,1680112,2013-08-30,1900000,219888,2101,104.65873393622084
"1235 PARK AVENUE, 11A",2004-01-15,1050000,2011-07-26,1337500,287500,2749,104.5834849036013
"171 EAST 84TH STREET, 12H",2012-09-28,737000,2018-08-10,961000,224000,2142,104.57516339869281
"100 RIVERSIDE BOULEVARD, 14A",2008-05-19,1099710,2014-12-08,1350000,250290,2394,104.54887218045113
"2250 BROADWAY, 4F",2003-06-12,490000,2014-12-02,928000,438000,4191,104.50966356478168
"421 EAST 13TH   STREET, 1L",2008-03-13,789143,2013-09-16,999500,210357,2013,104.49925484351714
"327 CENTRAL PARK WEST, 11D",2008-08-22,1400000,2013-02-04,1570000,170000,1627,104.48678549477566
"45 PARK AVENUE, 1102",2007-11-29,1435732,2015-06-29,1725000,289268,2769,104.46659443842542
"1438 THIRD AVENUE, 20E",2007-08-10,2199420,2014-10-31,2475000,275580,2639,104.42591890867753
"275 GREENWICH STREET, 7KS",2003-12-17,636000,2012-09-14,969500,333500,3194,104.41452723857232
"222 WEST 14TH   STREET, 5N",2007-06-15,935000,2016-10-05,1290000,355000,3400,104.41176470588235
"404 EAST 76TH STREET, 20C",2009-10-26,1062500,2016-09-14,1325000,262500,2515,104.37375745526839
"115 FOURTH AVENUE, 6B",2004-11-05,1100000,2018-06-29,1620000,520000,4984,104.3338683788122
"181 EAST 90TH STREET, 10B",2007-10-11,3850000,2015-08-26,4150000,300000,2876,104.3115438108484
"172 WEST 79TH   STREET, 6F",2013-08-15,895000,2017-01-13,1025000,130000,1247,104.25020048115478
"200 WEST END AVENUE, 9J",2008-02-15,1051852,2017-08-30,1415000,363148,3484,104.23306544202066
"225 EAST 34TH   STREET, 14F",2013-07-05,951000,2017-05-25,1099000,148000,1420,104.22535211267606
"220 MANHATTAN AVENUE, 5V",2003-09-18,380000,2017-04-28,898000,518000,4971,104.20438543552605
"68 BRADHURST AVENUE, 6-N",2007-06-06,453222,2016-11-09,812000,358778,3444,104.17479674796748
"420 EAST 58TH   STREET, 25C",2010-03-01,550000,2016-01-29,775000,225000,2160,104.16666666666667
"400 EAST 90TH   STREET, PH-C",2010-01-13,735000,2016-09-07,988000,253000,2429,104.15808974886785
"15 BROAD STREET, 2812",2006-08-02,1290128,2013-07-19,1555000,264872,2543,104.15729453401494
"1474 3 AVENUE, 1S",2011-07-18,519307,2013-02-20,580000,60693,583,104.10463121783876
"48 MARKET STREET, 2A",2006-08-09,492500,2015-08-12,835000,342500,3290,104.1033434650456
"266 WEST 115 STREET, 5B",2008-06-04,677136,2017-09-15,1030000,352864,3390,104.08967551622419
"240 RIVERSIDE BOULEVARD, 12 OT",2006-06-23,1081500,2017-11-17,1515000,433500,4165,104.08163265306122
"400 CENTRAL PARK WEST, 12X",2003-07-23,540000,2012-07-31,883000,343000,3296,104.06553398058253
"100 RIVERSIDE BOULEVARD, 24D",2008-07-16,2474347,2013-02-28,2650000,175653,1688,104.05983412322274
"70 BATTERY PLACE, 19A",2009-07-07,997885,2014-12-19,1205000,207115,1991,104.02561526870919
"200 WEST END AVENUE, 17B",2008-08-18,998903,2018-08-30,1380000,381097,3664,104.01118995633188
"253 WEST 73RD   STREET, 5J",2011-05-11,1975000,2014-08-25,2100000,125000,1202,103.99334442595674
"112 WEST 72ND   STREET, 10C",2012-01-18,332310,2015-07-17,465000,132690,1276,103.98902821316615
"18 WEST 48TH STREET, 30A",2007-06-26,1798637,2010-02-25,1900000,101363,975,103.96205128205128
"215 WEST 88TH STREET, 10A",2008-01-10,860421,2016-06-10,1180000,319579,3074,103.96193884189981
"376 BROADWAY, 2G",2010-11-30,500000,2013-09-05,605000,105000,1010,103.96039603960396
"635 WEST 42ND STREET, 7N",2011-04-01,800000,2016-04-21,992000,192000,1847,103.95235517054684
"1420 YORK AVENUE, 5P",2003-03-18,230000,2006-01-20,338000,108000,1039,103.94610202117421
"2322-28 7 AVENUE, 5F",2003-12-16,166094,2004-06-15,185000,18906,182,103.87912087912088
"865 1 AVENUE, 15C",2012-12-14,815242,2013-09-27,845046,29804,287,103.84668989547038
"100 UNITED NATIONS PLAZA, 10F",2004-09-27,505000,2014-08-08,879000,374000,3602,103.83120488617435
"1601 3 AVENUE, 25J",2003-02-20,287825,2013-08-14,685000,397175,3828,103.75522466039708
"393 WEST 49 STREET, 3B",2003-04-28,280000,2018-03-28,845000,565000,5448,103.70778267254038
"158 HESTER STREET, 6G",2006-08-30,1476462,2015-03-17,1800000,323538,3121,103.6648510092919
"106 CENTRAL PARK SOUTH, 9J",2012-10-22,485000,2017-09-11,670000,185000,1785,103.64145658263305
"150 NASSAU STREET, 5C",2003-05-14,328993,2012-05-02,668500,339507,3276,103.63461538461539
"310 EAST 53RD STREET, 16A",2006-11-08,2367660,2012-12-28,2600000,232340,2242,103.63068688670829
"254 PARK AVENUE SOUTH, 5K",2010-09-15,540000,2016-10-13,770000,230000,2220,103.6036036036036
"250 EAST 53RD STREET, 3303",2008-06-11,1430725,2013-04-25,1615000,184275,1779,103.58347386172007
"655 SIXTH AVENUE, 5J",2008-10-21,1500000,2013-12-17,1695000,195000,1883,103.55815188528943
"635 WEST 42ND   STREET, 12J",2009-07-02,540000,2012-02-23,640000,100000,966,103.51966873706004
"150 WEST 56TH STREET, 3308",2005-05-09,1750000,2010-08-23,1950000,200000,1932,103.51966873706004
"15 BROAD STREET, 2316",2006-07-19,897078,2018-07-12,1350000,452922,4376,103.50137111517367
"48 WEST 138 STREET, 5D",2014-04-23,212940,2016-06-24,295000,82060,793,103.48045397225725
"111 FULTON STREET, 318",2008-12-30,1196443,2017-01-12,1500000,303557,2935,103.42657580919932
"20 PINE STREET, 2303",2012-06-08,750000,2017-08-07,945000,195000,1886,103.39342523860022
"20 CLINTON STREET, 1E",2005-03-15,845000,2008-05-20,965000,120000,1162,103.27022375215147
"120 RIVERSIDE BOULEVARD, 14R",2006-03-17,941881,2015-04-22,1285000,343119,3323,103.25579295817033
"52 EAST 4TH STREET, 4N",2012-09-04,1250000,2017-04-26,1425000,175000,1695,103.2448377581121
"516 WEST 47TH   STREET, S7F",2010-05-18,570000,2016-05-06,795000,225000,2180,103.21100917431193
"310 WEST 52ND   STREET, 8D",2007-03-07,707683,2015-08-07,1025000,317317,3075,103.19252032520325
"225 EAST 34TH   STREET, 8F",2010-07-23,795000,2014-12-10,960000,165000,1601,103.06058713304185
"1619 3 AVENUE, 20B",2003-02-20,155447,2010-11-01,445000,289553,2811,103.0071149057275
"154 ATTORNEY STREET, 606",2006-11-29,845147,2017-01-03,1225000,379853,3688,102.99701735357918
"41 WEST 72ND   STREET, 11B",2013-07-19,845000,2016-08-09,960000,115000,1117,102.95434198746642
"2082 FREDRICK DOUGLASS BL, 5B",2014-05-01,322000,2018-07-24,481000,159000,1545,102.9126213592233
"1 SHERIDAN SQUARE, 3D",2003-12-02,279000,2012-12-28,620000,341000,3314,102.89680144840072
"217 WEST 19TH STREET, 5N",2007-08-30,2999000,2013-07-17,3220000,221000,2148,102.88640595903166
"421 EAST 13TH   STREET, 7G",2008-02-12,794235,2017-08-01,1150000,355765,3458,102.88172353961828
"15 WEST 20TH STREET, 9A",2007-07-31,2774731,2017-03-02,3135000,360269,3502,102.87521416333524
"120 RIVERSIDE BOULEVARD, 9J",2005-12-30,592865,2013-11-27,890000,297135,2889,102.85046728971963
"555 WEST 59TH STREET, 23E",2008-04-29,1078326,2018-08-15,1465000,386674,3760,102.83882978723405
"67 WEST 107 STREET, 19",2009-03-25,290004,2018-07-10,639000,348996,3394,102.82734236888626
"36 HUDSON STREET, 5A",2007-04-10,3080206,2013-02-15,3300000,219794,2138,102.80355472404116
"321 GREENWICH STREET, C",2006-01-13,2275000,2009-02-05,2390000,115000,1119,102.77033065236819
"157 EAST 32ND   STREET, 11A",2013-07-12,738000,2017-11-27,902250,164250,1599,102.7204502814259
"275 GREENWICH STREET, 5JS",2007-08-16,770000,2016-12-14,1120000,350000,3408,102.69953051643192
"1623 3 AVENUE, 38J",2003-02-20,333962,2013-10-30,735000,401038,3905,102.69859154929577
"29 WEST 65TH   STREET, 1A",2009-06-16,623169,2016-06-09,885000,261831,2550,102.67882352941176
"340 EAST 64TH STREET, 21A",2009-06-23,755000,2017-11-16,1070000,315000,3068,102.67275097783572
"57 WEST 58TH STREET, 9H",2006-08-09,729000,2011-01-12,895000,166000,1617,102.65924551638837
"220 EAST 65TH   STREET, 24K",2006-12-19,985000,2009-10-07,1090000,105000,1023,102.63929618768329
"200 CHAMBERS STREET, 5T",2007-03-16,529490,2018-04-17,945000,415510,4050,102.59506172839507
"1623 3 AVENUE, 34D",2003-02-20,282247,2010-12-14,575000,292753,2854,102.57638402242466
"393 WEST 49 STREET, 3J",2003-01-03,270000,2003-09-04,295000,25000,244,102.45901639344262
"420 EAST 58TH   STREET, 14A",2008-09-12,675000,2016-07-22,969000,294000,2870,102.4390243902439
"215 EAST 80TH STREET, 3B",2006-09-13,1180000,2012-04-24,1390000,210000,2050,102.4390243902439
"1965 BROADWAY, 25F",2005-07-27,1150000,2011-03-08,1360000,210000,2050,102.4390243902439
"1400 5 AVENUE, 2R",2004-10-19,268430,2009-12-04,460000,191570,1872,102.3344017094017
"80 JOHN STREET, 19C",2007-08-07,1044011,2015-02-13,1325000,280989,2747,102.28940662540954
"455 CENTRAL PARK WEST, 16C",2005-07-07,3782798,2007-04-25,3850000,67202,657,102.28614916286149
"60 RIVERSIDE BOULEVARD, 2001",2013-01-30,3312312,2018-02-09,3500000,187688,1836,102.22657952069717
"120 EAST 87TH   STREET, R6-L",2012-12-20,499000,2015-12-11,610000,111000,1086,102.20994475138122
"275 GREENWICH STREET, 9DS",2004-09-13,549000,2017-04-27,1020000,471000,4609,102.19136472119766
"120 RIVERSIDE BOULEVARD, 5W",2006-10-06,621213,2012-05-11,830000,208787,2044,102.14628180039139
"1623 3 AVENUE, 29J",2003-02-20,299183,2014-11-25,738000,438817,4296,102.14548417132217
"433 EAST 74TH   STREET, 1A",2009-06-29,997885,2017-01-20,1280000,282115,2762,102.14156408399711
"1641 3 AVENUE, 14J",2003-02-20,247721,2012-02-27,584100,336379,3294,102.118700667881
"380 RECTOR PLACE, 3R",2003-05-23,740000,2018-06-01,1300000,560000,5488,102.04081632653062
"150 EAST 86TH   STREET, 12H",2010-06-11,2647450,2017-11-21,2925000,277550,2720,102.0404411764706
"123 BAXTER STREET, 5A",2007-11-02,1680112,2014-05-29,1925000,244888,2400,102.03666666666666
"59 WEST 12TH STREET, 5B",2006-06-19,617500,2016-07-12,992500,375000,3676,102.01305767138194
"230 RIVERSIDE DRIVE, 6C",2007-02-26,890968,2015-10-14,1212500,321532,3152,102.00888324873097
"220 MANHATTAN AVENUE, 6L",2006-04-19,500000,2016-05-13,875000,375000,3677,101.98531411476748
"505 WEST 47TH   STREET, 3F-N",2011-08-26,659000,2017-04-25,870000,211000,2069,101.98163363943934
"123 WASHINGTON STREET, 36E",2014-01-10,1262630,2017-04-24,1385000,122370,1200,101.975
"15 BROAD STREET, 1801",2006-05-01,529490,2013-08-15,801000,271510,2663,101.95644010514458
"150 NASSAU STREET, 5D",2003-04-09,328036,2012-08-03,675000,346964,3404,101.9283196239718
"154 ATTORNEY STREET, 403",2006-11-28,789143,2016-01-29,1130000,340857,3349,101.77873992236489
"88 GREENWICH STREET, 429",2011-07-29,490000,2016-10-26,685000,195000,1916,101.77453027139875
"400 CENTRAL PARK WEST, 17K",2006-01-11,731103,2010-11-04,910000,178897,1758,101.76166097838453
"71 NASSAU STREET, 5B",2010-02-24,564800,2013-08-07,693000,128200,1260,101.74603174603175
"1965 BROADWAY, 17G",2006-03-03,1250000,2017-03-15,1660000,410000,4030,101.73697270471465
"101 WARREN STREET, 930",2008-07-28,1293177,2011-06-13,1400000,106823,1050,101.73619047619047
"77 PARK AVENUE, 12G",2005-11-30,840000,2016-12-13,1250000,410000,4031,101.71173406102704
"11 EAST 29TH   STREET, 44B",2008-06-24,1517192,2011-05-20,1625000,107808,1060,101.70566037735848
"150 WEST 51 STREET, 14-25",2005-12-20,570000,2006-10-11,600000,30000,295,101.69491525423729
"10 WEST END AVENUE, 4D",2007-07-10,784052,2015-05-11,1075000,290948,2862,101.65897973445144
"517 WEST 46TH STREET, PH702",2007-12-03,1225000,2015-05-01,1500000,275000,2706,101.6260162601626
"56 PINE STREET, 15G",2005-11-08,344760,2008-04-14,435000,90240,888,101.62162162162163
"57 WEST 58 STREET, 8H",2004-06-16,605000,2013-01-31,925000,320000,3151,101.55506188511583
"54 WEST 74 STREET, 312A",2003-02-13,495000,2011-12-13,822500,327500,3225,101.55038759689923
"102 FULTON STREET, 2W",2004-09-01,1050000,2012-10-04,1350000,300000,2955,101.5228426395939
"469 WEST 152 STREET, 2A",2015-02-13,916425,2017-12-14,1021500,105075,1035,101.52173913043478
"425 FIFTH AVENUE, 58A",2005-12-21,1985587,2016-06-23,2375000,389413,3837,101.48892363825905
"77 PARK AVENUE, 12F",2006-03-17,1515000,2018-08-14,1975000,460000,4533,101.4780498566071
"382 CENTRAL PARK WEST, 9Y",2005-02-03,471000,2016-08-22,899000,428000,4218,101.46989094357515
"10 WEST STREET, 19C",2004-01-15,1221900,2009-08-27,1430000,208100,2051,101.4627011214042
"445 FIFTH AVENUE, 15C",2005-01-28,850000,2013-12-26,1180000,330000,3254,101.41364474492931
"252 7 AVENUE, 5C",2006-08-25,1350000,2012-11-09,1580000,230000,2268,101.41093474426808
"8 UNION SQUARE SOUTH, 6B",2007-12-11,2255423,2018-08-08,2650000,394577,3893,101.35550988954533
"56 PINE STREET, 5G",2006-01-20,507000,2017-03-20,920000,413000,4077,101.29997547216091
"1623 3 AVENUE, 5G",2003-02-20,247366,2013-10-01,640000,392634,3876,101.29876160990712
"1437 3 AVENUE, 6A",2006-09-13,1175000,2016-08-19,1542500,367500,3628,101.2954796030871
"201 EAST 36TH   STREET, 15E",2010-10-22,700000,2018-03-29,975000,275000,2715,101.28913443830571
"1049 FIFTH AVENUE, 6E",2005-11-22,2300000,2013-04-29,2575000,275000,2715,101.28913443830571
"20 EAST 17TH   STREET, U7",2008-05-16,2310000,2011-11-11,2439000,129000,1274,101.25588697017268
"635 WEST 42ND STREET, PHD",2007-08-09,1502022,2015-09-01,1800000,297978,2945,101.18098471986417
"300 ALBANY STREET, 8G",2011-07-11,333000,2016-08-02,520000,187000,1849,101.13574905354245
"450 EAST 83RD STREET, 9D",2006-05-23,1608835,2015-08-18,1950000,341165,3374,101.1158861885003
"780 WEST END AVENUE, 10E",2003-08-01,600000,2012-08-02,932500,332500,3289,101.09455761629674
"372 CENTRAL PARK WEST, 4B",2006-07-21,745000,2015-06-29,1075000,330000,3265,101.07197549770291
"163 ST NICHOLAS AVENUE, 3I",2004-05-20,223080,2017-08-08,711000,487920,4828,101.06048053024027
"220 MANHATTAN AVENUE, 2U",2004-09-21,425000,2016-03-04,847500,422500,4182,101.02821616451459
"350 WEST 42ND STREET, 7D",2009-08-19,675000,2018-05-30,998888,323888,3206,101.0255770430443
"210 WEST 19TH   STREET, 6D",2007-04-11,790000,2015-08-27,1099000,309000,3060,100.98039215686275
"261 WEST 28TH STREET, 3A",2007-11-20,1323725,2016-05-24,1637500,313775,3108,100.9572072072072
"677 WASHINGTON STREET, 14E",2005-06-02,605000,2015-08-04,980000,375000,3715,100.9421265141319
"260 PARK AVENUE SOUTH, 6E",2006-04-27,916425,2012-07-09,1145000,228575,2265,100.91611479028697
"15 BROAD STREET, 928",2009-06-24,692000,2017-09-13,995000,303000,3003,100.8991008991009
"250 EAST 53RD STREET, 1004",2008-01-28,2351754,2017-10-18,2710000,358246,3551,100.88594762038862
"68 BRADHURST AVENUE, 5-L",2007-06-05,453222,2016-06-08,785000,331778,3291,100.81373442722577
"334 WEST 89TH STREET, 4F",2011-09-08,1175000,2018-01-26,1410000,235000,2332,100.77186963979416
"845 UNITED NATIONS PLAZA, 17B/C",2005-07-11,1940000,2018-01-10,2400000,460000,4566,100.74463425317565
"845 UNITED NATIONS PLAZA, 15B",2006-08-04,870000,2016-12-02,1250000,380000,3773,100.71561091969255
"120 RIVERSIDE BOULEVARD, 7D",2006-01-13,543900,2012-06-15,780000,236100,2345,100.682302771855
"630 1 AVENUE, 8S",2004-03-31,449000,2013-08-29,795000,346000,3438,100.63990692262944
"300 WEST 135TH STREET, 4W",2005-06-03,209120,2015-07-10,580000,370880,3689,100.5367308213608
"525 EAST 80TH   STREET, 7D",2007-10-03,1375000,2016-06-21,1695000,320000,3184,100.50251256281408
"200 CHAMBERS STREET, 7M",2007-04-02,855330,2013-05-17,1080000,224670,2237,100.43361645060348
"68 BRADHURST AVENUE, 6-B",2007-08-23,455034,2017-08-29,822500,367466,3659,100.4279857884668
"255 EAST 49 STREET, 20C",2003-02-07,425880,2009-07-17,662078,236198,2352,100.42431972789116
"126 WAVERLY PLACE, 3F",2005-04-29,1550000,2009-11-17,1717000,167000,1663,100.42092603728202
"255 HUDSON STREET, 5C",2006-10-03,1109892,2016-01-11,1450000,340108,3387,100.41570711544139
"225 5 AVENUE, 4H",2007-04-25,1081890,2010-07-15,1200000,118110,1177,100.34834324553951
"77 PARK AVENUE, 2B",2005-02-25,690000,2016-05-04,1100000,410000,4086,100.34263338228097
"101 WARREN STREET, 1090",2008-08-05,1491736,2013-12-13,1688000,196264,1956,100.33946830265849
"845 WEST END AVENUE, 16D",2012-12-14,2750000,2017-01-17,2900000,150000,1495,100.33444816053512
"400 EAST 51ST   STREET, 4F",2007-05-03,1500000,2014-02-27,1750000,250000,2492,100.32102728731942
"643 EAST 11TH STREET, 10",2008-10-02,2670360,2015-01-09,2900000,229640,2290,100.27947598253274
"301 EAST 79TH   STREET, 21 B",2007-05-14,1138000,2015-11-20,1450000,312000,3112,100.25706940874036
"200 WEST END AVENUE, 24B",2008-06-11,3080206,2013-01-30,3250000,169794,1694,100.23258559622197
"188 EAST 64TH STREET, 1103",2009-10-08,732500,2018-06-11,1050000,317500,3168,100.2209595959596
"158 HESTER STREET, 3I",2006-08-23,661862,2007-02-20,680000,18138,181,100.20994475138122
"15 BROAD STREET, 2006",2006-06-16,726326,2013-04-02,975000,248674,2482,100.19097502014505
"400 CENTRAL PARK WEST, 18G",2004-08-28,323000,2017-10-30,805000,482000,4811,100.18707129494908
"650 SIXTH AVENUE, 2J",2008-04-25,1206626,2011-07-21,1325000,118374,1182,100.1472081218274
"300 EAST 55TH STREET, 3D",2008-07-11,1500000,2016-09-23,1800000,300000,2996,100.13351134846462
"150 EAST 56TH STREET, 3C",2005-09-01,615000,2016-06-20,1010000,395000,3945,100.12674271229405
"200 WEST 78TH STREET, 5D",2007-06-27,1310000,2016-05-16,1635000,325000,3246,100.12322858903265
"105 WEST 77TH   STREET, 2B",2009-12-22,251750,2014-09-18,425000,173250,1731,100.08665511265164
"100 RIVERSIDE BOULEVARD, 10G",2008-05-16,1899036,2013-11-14,2100000,200964,2008,100.08167330677291
"300 WEST 135TH STREET, 8A",2005-07-19,225535,2018-02-15,685000,459465,4594,100.01414888985633
"200 RIVERSIDE BOULEVARD, 3H",2004-07-28,1062500,2013-02-26,1376000,313500,3135,100.0
"165 CHARLES STREET, RU20",2006-06-19,6048609,2013-05-10,6300000,251391,2517,99.8772348033373
"1400 5 AVENUE, 2F",2004-10-07,324995,2012-12-28,625000,300005,3004,99.8685086551265
"303 EAST 33RD   STREET, 2J",2011-01-21,565128,2013-07-09,655000,89872,900,99.85777777777778
"721 5 AVENUE, 40H",2006-02-23,1367500,2017-09-26,1790000,422500,4233,99.81100874084574
"27 WEST 72ND   STREET, 1008",2007-06-28,992793,2016-08-10,1325000,332207,3331,99.73191233863704
"200 WEST END AVENUE, 12M",2008-03-28,972428,2017-08-23,1315000,342572,3435,99.72983988355168
"230 RIVERSIDE DRIVE, 1O",2008-06-30,495000,2012-05-04,635000,140000,1404,99.71509971509971
"200 EAST 58 STREET, 7G",2003-09-09,380000,2004-08-25,415000,35000,351,99.71509971509971
"120 RIVERSIDE BOULEVARD, 6G",2005-12-12,527862,2014-10-17,850000,322138,3231,99.70225936242649
"400 EAST 90TH STREET, 9C",2014-09-16,450000,2017-11-14,565000,115000,1155,99.56709956709956
"199 BOWERY, 12A",2006-09-21,916425,2017-09-07,1315000,398575,4004,99.5442057942058
"80 JOHN STREET, 6I",2007-05-04,720106,2015-01-05,999000,278894,2803,99.49839457723867
"1438 THIRD AVENUE, 21B",2007-08-17,909297,2016-06-14,1230000,320703,3224,99.473635235732
"530 EAST 76TH   STREET, 34COS",2009-03-27,2925000,2018-03-08,3250000,325000,3268,99.44920440636474
"164 PEARL STREET, 7A",2010-11-03,480000,2016-03-17,675000,195000,1961,99.43906170321264
"372 CENTRAL PARK WEST, 17V",2006-11-29,675000,2016-10-28,1035000,360000,3621,99.42004971002486
"333 EAST 109 STREET, 4E",2011-11-16,578366,2014-07-15,675000,96634,972,99.41769547325103
"200 RIVERSIDE BOULEVARD, 4B",2009-09-30,905000,2018-07-24,1225000,320000,3219,99.40975458216838
"250 EAST 30TH   STREET, 10E",2014-04-16,510000,2016-06-29,590000,80000,805,99.37888198757764
"261 WEST 28TH   STREET, 9B",2008-02-08,1451006,2014-12-19,1700000,248994,2506,99.35913806863527
"31 EAST 28TH STREET, 2E",2013-12-19,2695000,2018-03-28,2850000,155000,1560,99.35897435897436
"108 WEST 138 STREET, 3B",2013-12-09,385000,2017-02-09,500000,115000,1158,99.3091537132988
"157 EAST 74TH   STREET, 3C",2015-09-25,2480000,2017-08-30,2550000,70000,705,99.29078014184397
"184 THOMPSON STREET, 4A",2007-12-21,857756,2018-07-27,1242000,384244,3871,99.2622061482821
"256 WEST 123 STREET, 2",2008-05-09,670008,2015-09-16,936575,266567,2686,99.24311243484736
"55 EAST 86 STREET, 4-C",2004-03-15,820000,2013-04-23,1150000,330000,3326,99.21828021647624
"302 BROOME STREET, 6A",2003-01-14,180000,2012-02-22,510000,330000,3326,99.21828021647624
"301 CATHEDRAL PARKWAY, 1P",2004-09-24,103149,2011-02-17,335000,231851,2337,99.20881471972615
"635 WEST 42ND STREET, 27G",2009-12-18,690000,2011-05-06,740000,50000,504,99.2063492063492
"392 CENTRAL PARK WEST, 19X",2004-10-07,640000,2013-01-17,940000,300000,3024,99.2063492063492
"421 EAST 13TH   STREET, 4C",2008-03-19,1293177,2018-01-24,1650000,356823,3598,99.17259588660367
"225 EAST 34TH   STREET, PHE",2008-03-31,2016135,2013-08-07,2210000,193865,1955,99.16368286445012
"184 THOMPSON, 4F",2008-02-05,636406,2013-07-31,835000,198594,2003,99.14827758362456
"333 WEST 56TH STREET, 3H",2011-11-28,499000,2015-05-27,625500,126500,1276,99.13793103448276
"40 BROAD STREET, 11F",2011-05-05,493659,2017-11-13,730000,236341,2384,99.1363255033557
"157 EAST 72ND STREET, 2D",2005-03-30,905000,2017-07-14,1350000,445000,4489,99.13120962352417
"330 EAST 75TH   STREET, 3L",2010-05-18,560000,2016-04-25,775000,215000,2169,99.12402028584602
"500 WEST 43RD STREET, 25A",2005-06-29,395000,2007-01-05,450000,55000,555,99.09909909909909
"200 CHAMBERS STREET, 28B",2007-07-19,1944857,2011-11-01,2100000,155143,1566,99.06960408684547
"150 NASSAU STREET, 3D",2003-04-07,351296,2011-12-08,665000,313704,3167,99.05399431638774
"263 9 AVENUE, 1E",2006-06-13,1476462,2012-08-17,1700000,223538,2257,99.04209127159947
"75 WALL STREET, 28B",2009-01-06,967337,2017-02-08,1260000,292663,2955,99.0399323181049
"1641 3 AVENUE, 32D",2003-02-20,305925,2012-02-06,630008,324083,3273,99.017109685304
"200 RIVERSIDE BOULEVARD, 403",2010-09-02,825000,2013-09-17,935000,110000,1111,99.00990099009901
"1600 BROADWAY, PH3D",2006-07-14,2571081,2017-01-06,2950000,378919,3829,98.96030295116218
"415 EAST 37TH   STREET, 35H",2009-08-14,610000,2016-05-25,855000,245000,2476,98.94991922455573
"900 PARK AVENUE, 6D",2006-07-10,1200000,2016-03-17,1550000,350000,3538,98.92594686263426
"421 EAST 13TH   STREET, 6K",2008-03-31,1074253,2013-12-11,1280000,205747,2081,98.8692936088419
"70 BATTERY PLACE, 10B",2009-03-17,1471371,2013-06-18,1625000,153629,1554,98.86036036036036
"300 WEST 137 STREET, 2547B",2004-04-13,252000,2013-12-03,600000,348000,3521,98.83555808009088
"230 RIVERSIDE DRIVE, 4L",2007-06-01,997885,2015-10-14,1300000,302115,3057,98.82728164867517
"141 EAST 55TH STREET, 2B",2006-04-04,305000,2012-03-19,520000,215000,2176,98.80514705882354
"333 EAST 109TH STREET, 4B",2012-06-04,420000,2018-01-24,623500,203500,2060,98.7864077669903
"62 WEST 62ND STREET, 12A",2005-04-08,690000,2015-10-21,1070000,380000,3848,98.75259875259876
"392 CENTRAL PARK WEST, 15U",2003-08-14,305000,2016-03-29,760000,455000,4611,98.67707655606159
"1438 3 AVENUE, 2A",2009-03-10,650000,2012-10-18,780000,130000,1318,98.63429438543247
"350 WEST 53RD STREET, 6B",2010-10-07,475000,2013-12-16,590000,115000,1166,98.62778730703259
"155 EAST 38 STREET, 17D",2006-05-05,754000,2017-03-13,1145000,391000,3965,98.61286254728877
"90 WILLIAM STREET, 11G",2008-06-25,904206,2015-04-24,1150000,245794,2494,98.5541299117883
"120 RIVERSIDE BOULEVARD, 8G",2006-03-01,630500,2016-02-25,990000,359500,3648,98.54714912280701
"99 JOHN STREET, 1113",2009-01-16,598221,2016-01-15,850000,251779,2555,98.54363992172212
"239 WEST 135 STREET, 1A",2013-10-01,380000,2014-04-22,400000,20000,203,98.52216748768473
"295 GREENWICH STREET, 3JN",2004-02-06,306000,2008-08-28,470000,164000,1665,98.49849849849849
"500 WEST 43RD STREET, 23B",2005-03-18,810000,2017-04-05,1243206,433206,4401,98.43353783231083
"1601 3 AVENUE, 31D",2003-02-20,301665,2013-07-10,675000,373335,3793,98.42736620089639
"188 EAST 64TH STREET, 905",2010-06-07,600000,2018-07-02,890000,290000,2947,98.40515778758059
"88 GREENWICH STREET, 1510",2010-06-23,725000,2017-09-18,985000,260000,2644,98.33585476550681
"15 BROAD STREET, 2722",2006-07-28,1323725,2015-08-28,1650000,326275,3318,98.33484026522001
"15 EAST 26TH   STREET, 12G",2008-11-14,285110,2013-06-19,450000,164890,1678,98.2657926102503
"635 WEST 42ND STREET, 17A",2007-06-05,868567,2010-02-11,965000,96433,982,98.20061099796334
"250 SOUTH END AVENUE, 12F",2003-05-21,245000,2007-09-06,399000,154000,1569,98.1516889738687
"200 EAST 89TH STREET, 20F",2009-09-23,620000,2014-08-11,795000,175000,1783,98.1491867638811
"300 WEST 135TH STREET, 3G",2005-08-19,331728,2016-09-28,730000,398272,4058,98.1448989650074
"200 EAST 28TH   STREET, 2E",2008-07-31,375000,2017-02-02,680000,305000,3108,98.13384813384813
"15 BROAD STREET, 3424",2007-05-09,1383957,2015-06-22,1675000,291043,2966,98.12643290627108
"25 CENTRAL PARK WEST, 3S",2004-06-15,901151,2018-05-17,1400000,498849,5084,98.12136113296617
"232 EAST 47TH   STREET, 23C",2009-04-23,520000,2017-12-18,830000,310000,3161,98.07023093957608
"99 JOHN STREET, 917",2013-01-29,535000,2016-12-27,675000,140000,1428,98.03921568627452
"455 MAIN STREET, PH2G",2006-05-17,1013158,2014-05-21,1300000,286842,2926,98.03212576896787
"99 JOHN STREET, 612",2013-08-01,570220,2014-12-22,620000,49780,508,97.99212598425197
"212 EAST 95TH STREET, 2C",2009-06-19,730000,2014-06-30,910000,180000,1837,97.9858464888405
"40 BROAD STREET, 24F",2010-03-10,476907,2015-11-12,680000,203093,2073,97.97057404727448
"2000 BROADWAY, 21A",2003-10-16,745000,2012-04-25,1050000,305000,3114,97.94476557482338
"725 RIVERSIDE DRIVE, 7C",2008-12-03,625000,2018-04-16,960000,335000,3421,97.92458345513008
"120 RIVERSIDE BOULEVARD, 6A",2005-12-13,703814,2013-07-15,975000,271186,2771,97.8657524359437
"247 WEST 46TH   STREET, 3701",2008-10-20,4582125,2015-04-27,4815000,232875,2380,97.84663865546219
"10 WEST END AVENUE, 21C",2007-09-14,1679476,2013-11-15,1900000,220524,2254,97.83673469387755
"1601 3 AVENUE, 21C",2003-02-20,283567,2014-07-09,690000,406433,4157,97.77074813567476
"206 EAST 95TH   STREET, 12B",2008-04-04,906242,2017-03-09,1225000,318758,3261,97.74854339159766
"8 UNION SQUARE SOUTH, 5B",2007-11-06,2168872,2017-02-15,2500000,331128,3389,97.70669814104455
"30 WEST 90TH STREET, 1B",2010-03-04,436000,2016-09-23,670000,234000,2395,97.7035490605428
"99 JOHN STREET, 422",2012-11-16,675000,2018-06-05,873000,198000,2027,97.68130241736557
"80 PARK AVENUE, 5L",2004-03-19,290000,2013-11-19,635000,345000,3532,97.67836919592298
"2101 BROADWAY, 9-102",2004-07-01,525000,2006-08-08,600000,75000,768,97.65625
"1 IRVING PLACE, V26A",2006-08-15,977500,2018-06-20,1400000,422500,4327,97.6427085740698
"155 WEST 123 STREET, 5",2003-06-17,247730,2013-05-10,600700,352970,3615,97.64038727524205
"505 GREENWICH STREET, 11F",2005-04-12,972428,2017-01-06,1390500,418072,4287,97.52087707021226
"99 JOHN STREET, 1613",2012-04-20,480000,2016-02-04,615000,135000,1385,97.47292418772564
"170 WEST 23RD   STREET, 4Q",2012-07-26,465000,2017-01-23,625000,160000,1642,97.44214372716199
"500 WEST 43RD STREET, 25G",2005-08-31,427000,2008-05-02,522000,95000,975,97.43589743589743
"555 WEST 23RD STREET, N9B",2015-04-17,920000,2018-03-30,1025000,105000,1078,97.40259740259741
"20 WEST STREET, 27D",2006-11-02,722957,2009-04-14,810000,87043,894,97.36353467561521
"68 BRADHURST AVENUE, 4-O",2007-07-26,455034,2016-06-29,772500,317466,3261,97.35234590616375
"100 RIVERSIDE BOULEVARD, 8A",2008-04-04,977520,2014-03-27,1190000,212480,2183,97.33394411360513
"205 EAST 85TH   STREET, 3F",2009-12-16,628448,2015-06-29,825000,196552,2021,97.25482434438396
"120 RIVERSIDE BOULEVARD, 10L",2006-02-16,1300101,2012-08-07,1530000,229899,2364,97.25
"112 HUDSON STREET, 4",2006-01-03,1275000,2013-04-30,1535000,260000,2674,97.23261032161555
"72 MERCER STREET, 3E",2008-06-03,3054750,2018-02-22,3400000,345250,3551,97.22613348352577
"45 PARK AVENUE, 903",2008-02-04,2199420,2013-09-30,2400000,200580,2065,97.13317191283294
"300 WEST 135TH STREET, 4M",2005-05-11,163088,2010-06-07,343000,179912,1853,97.0922827846735
"50 BAYARD STREET, 2G",2004-04-26,120000,2012-10-11,420000,300000,3090,97.0873786407767
"1619 3 AVENUE, 10B",2003-02-20,143736,2015-09-22,590000,446264,4597,97.0772242767022
"20 CLINTON STREET, 3D",2007-05-03,950000,2017-12-12,1326250,376250,3876,97.07172342621259
"199 BOWERY, 8B",2006-11-17,621132,2017-12-28,1015000,393868,4059,97.03572308450357
"52 EAST END AVENUE, 15B",2004-08-04,475000,2009-07-13,650000,175000,1804,97.00665188470066
"330 EAST 49TH STREET, 9E",2007-05-18,172050,2014-07-08,425000,252950,2608,96.99003067484662
"27 WEST 72ND   STREET, 901",2008-06-27,999921,2017-04-24,1312500,312579,3223,96.98386596338814
"1641 3 AVENUE, 11C",2003-02-20,258368,2013-06-18,624000,365632,3771,96.95889684433837
"164 PEARL STREET, 4M",2007-09-18,512500,2014-06-03,750000,237500,2450,96.93877551020408
"106 CENTRAL PARK SOUTH, 3C",2006-11-20,900000,2017-01-20,1260000,360000,3714,96.93053311793214
"221 WEST 148 STREET, 4B",2010-05-14,344760,2015-04-27,520000,175240,1809,96.87119955776672
"1965 BROADWAY, 19F",2005-04-28,1125000,2010-04-09,1300000,175000,1807,96.84560044272274
"144 COLUMBUS AVENUE, 17F",2006-07-21,2175000,2007-05-01,2202500,27500,284,96.83098591549296
"21 SOUTH END AVENUE, 426",2003-01-23,445000,2013-02-08,800000,355000,3669,96.7566094303625
"350 EAST 82ND STREET, 5A",2006-09-28,987702,2014-06-13,1260000,272298,2815,96.73108348134991
"11 EAST 29TH   STREET, 42C",2008-06-05,1415367,2013-05-16,1590000,174633,1806,96.69601328903654
"350 WEST 50TH   STREET, 3AA",2010-12-17,404000,2017-08-02,638000,234000,2420,96.69421487603306
"88 GREENWICH STREET, 2605",2012-10-26,769800,2018-05-07,965000,195200,2019,96.68152550767707
"555 WEST 59TH STREET, 8A",2008-07-17,962246,2014-04-15,1165000,202754,2098,96.6415633937083
"16 WEST 19TH   STREET, 10-B",2007-11-21,911333,2015-08-24,1185000,273667,2833,96.59971761383692
"310 WEST 52ND   STREET, 4D",2007-08-23,1191352,2015-02-12,1455000,263648,2730,96.57435897435897
"120 RIVERSIDE BOULEVARD, 12P",2006-03-07,759105,2014-12-30,1070000,310895,3220,96.55124223602485
"10 WEST END AVENUE, 5E",2007-07-18,753505,2018-01-30,1125000,371495,3849,96.517277214861
"304 EAST 65TH STREET, 32D",2004-11-01,685000,2015-03-11,1050000,365000,3782,96.50978318350079
"130 BARROW STREET, 406",2008-02-14,1050000,2016-06-02,1342500,292500,3031,96.50280435499835
"1619 3 AVENUE, 16E",2003-02-20,132733,2015-12-21,585000,452267,4687,96.49391935139748
"99 JOHN STREET, 1101",2012-12-20,539000,2017-12-18,715000,176000,1824,96.49122807017544
"300 WEST 135 STREET, 7A",2005-07-25,214888,2018-05-03,665000,450112,4665,96.48703108252947
"211 EAST 46TH   STREET, 26D",2008-09-03,692756,2015-05-29,930000,237244,2459,96.4798698657991
"100 UNITED NATIONS PLAZA, 33C",2003-07-31,955000,2011-12-15,1250000,295000,3059,96.43674403399804
"247 WEST 46TH   STREET, 2502",2008-11-25,1308451,2014-05-05,1500000,191549,1987,96.40110719677907
"250 SOUTH END AVENUE, 16D",2005-07-15,750000,2014-08-18,1070000,320000,3321,96.35651912074677
"50 PINE STREET, 3S",2006-04-20,789143,2017-12-22,1200000,410857,4264,96.3548311444653
"10 WEST END AVENUE, 9F",2007-08-10,789143,2015-08-03,1070000,280857,2915,96.34888507718696
"635 WEST 42ND STREET, 10M",2009-11-02,655000,2013-12-16,800000,145000,1505,96.34551495016612
"330 EAST 38TH   STREET, 46C",2007-06-27,945000,2013-09-27,1165000,220000,2284,96.32224168126095
"347 WEST 57TH   STREET, 9-BB",2010-03-04,375000,2013-09-12,499000,124000,1288,96.27329192546584
"3 WEST 122 STREET, 5C",2005-08-11,525000,2015-12-29,890000,365000,3792,96.25527426160338
"252 7 AVENUE, 10S",2003-09-18,775000,2009-09-08,985000,210000,2182,96.24197983501375
"595 WEST END AVENUE, 15B",2007-09-19,1333907,2008-11-19,1375000,41093,427,96.23653395784544
"350 WEST 57TH STREET, 16H",2010-05-17,544500,2014-03-25,680000,135500,1408,96.23579545454545
"235 WEST END AVENUE, 15C",2003-04-14,475000,2015-10-21,915000,440000,4573,96.21692543188279
"243 WEST 60TH STREET, 7C",2010-04-21,1375000,2018-06-01,1660000,285000,2963,96.1862976712791
"318 WEST 100TH STREET, 6D",2006-03-13,950000,2018-02-26,1370000,420000,4368,96.15384615384616
"106 CENTRAL PARK SOUTH, 8M",2004-08-20,440000,2015-03-04,810000,370000,3848,96.15384615384616
"200 RECTOR PLACE, 6X",2004-07-12,305000,2017-12-01,775000,470000,4890,96.11451942740287
"236 EAST 47TH STREET, 14B",2004-08-17,555000,2015-03-03,925000,370000,3850,96.1038961038961
"275 GREENWICH STREET, 10KS",2003-10-30,625000,2012-08-30,935000,310000,3227,96.06445615122405
"70 BATTERY PLACE, 7J",2008-12-10,916425,2014-06-19,1110000,193575,2017,95.97174020823005
"200 EAST 32ND STREET, 16B",2004-10-01,1330000,2012-09-28,1610000,280000,2919,95.92326139088729
"1600 BROADWAY, 10D",2006-09-26,763687,2016-05-05,1100000,336313,3509,95.84297520661157
"60 EAST 55TH STREET, 41A",2006-08-24,5000000,2011-08-24,5175000,175000,1826,95.83789704271632
"260 PARK AVENUE SOUTH, 4B",2007-05-29,2900000,2013-02-13,3100000,200000,2087,95.83133684714902
"350 WEST 50TH   STREET, 3ZZ",2009-11-18,433000,2017-10-19,710000,277000,2892,95.78146611341631
"170 JOHN STREET, 3/4D",2006-11-30,1200000,2017-09-01,1576000,376000,3928,95.72301425661914
"80 JOHN STREET, 21A",2007-04-12,793216,2017-06-27,1150000,356784,3729,95.6781979082864
"350 WEST 42ND STREET, 12I",2006-05-26,482664,2015-06-25,800000,317336,3317,95.66958094663853
"18 PINE STREET, 1211",2009-07-22,872014,2012-10-16,985000,112986,1182,95.58883248730965
"15 BROAD STREET, 1408",2006-05-10,534581,2017-09-06,930000,395419,4137,95.58109741358473
"141 EAST 55TH   STREET, 3E",2015-06-01,698000,2017-10-06,780000,82000,858,95.57109557109557
"650 SIXTH AVENUE, 5J",2008-04-29,1237173,2013-12-30,1435000,197827,2071,95.52245292129406
"300 ALBANY STREET, 8H",2004-10-29,320000,2008-03-28,439000,119000,1246,95.50561797752809
"15 BROAD STREET, 1708",2006-06-20,580402,2015-08-19,900000,319598,3347,95.48789961159247
"392 CENTRAL PARK WEST, 11V",2003-01-15,372500,2013-07-31,740000,367500,3850,95.45454545454545
"1641 3 AVENUE, 23C",2003-02-20,289245,2012-12-21,632000,342755,3592,95.4217706013363
"555 WEST 149 STREET, 2",2003-06-30,221405,2016-08-26,680000,458595,4806,95.42134831460675
"220 RIVERSIDE BOULEVARD, 5H",2005-10-07,1750000,2012-07-06,1985000,235000,2464,95.37337662337663
"5 EAST 22ND STREET, 17A",2007-05-29,777500,2013-07-05,990000,212500,2229,95.33423059668013
"99 JOHN STREET, 2104",2009-04-17,665000,2015-04-29,875000,210000,2203,95.32455742169769
"310 WEST 52ND   STREET, 3H",2007-09-10,768778,2014-10-06,1015000,246222,2583,95.32404181184668
"555 WEST 23RD   STREET, S5B",2009-04-06,620000,2013-08-06,770888,150888,1583,95.31775110549589
"400 CENTRAL PARK WEST, 4M",2004-06-03,560000,2015-08-18,950000,390000,4093,95.28463229904716
"350 WEST 42ND STREET, 9K",2006-05-17,586512,2013-12-12,850000,263488,2766,95.25958062183659
"56 PINE STREET, 5B",2005-12-08,380250,2014-03-28,669000,288750,3032,95.23416886543535
"468 WEST 23RD STREET, 3B",2005-07-13,626223,2016-03-03,996000,369777,3886,95.15620174987133
"80 PARK AVENUE, 2P",2003-05-15,466465,2017-04-14,950000,483535,5083,95.12787723785166
"261 WEST 28TH STREET, 4D",2007-11-14,921516,2014-09-25,1160000,238484,2507,95.12724371759074
"175 EAST 2ND STREET, 4D",2006-01-06,749000,2017-07-24,1150000,401000,4217,95.0912971306616
"200 WEST END AVENUE, 14D",2008-08-01,997885,2015-04-08,1230000,232115,2441,95.09012699713232
"280 PARK AVENUE SOUTH, 20F",2004-09-07,790000,2009-07-31,960000,170000,1788,95.07829977628636
"146 WEST 57 STREET, 32N",2003-06-11,260000,2005-08-08,335000,75000,789,95.05703422053232
"515 EAST 72ND STREET, 10C",2013-09-03,928644,2017-04-25,1055000,126356,1330,95.0045112781955
"250 SOUTH END AVENUE, 11E",2005-04-19,440000,2017-11-01,875000,435000,4579,94.99890805852806
"422 EAST 72ND STREET, 30E",2007-11-29,2500000,2012-03-26,2650000,150000,1579,94.99683343888537
"421 EAST 50 STREET, 3R",2004-01-20,317333,2006-07-31,405000,87667,923,94.98049837486457
"150 NASSAU STREET, 5B",2003-05-27,339438,2010-02-12,572300,232862,2453,94.92947411333061
"175 WEST 12TH STREET, 3C",2010-04-30,560037,2014-12-11,720000,159963,1686,94.87722419928825
"219 WEST 80TH STREET, 3D",2011-07-29,760000,2018-06-22,999000,239000,2520,94.84126984126983
"299 WEST 12TH STREET, 14H",2005-09-20,682000,2011-11-14,895000,213000,2246,94.83526268922529
"100 RIVERSIDE BOULEVARD, 25B",2008-07-03,1980496,2014-11-05,2200000,219504,2316,94.77720207253886
"134 EAST 93RD   STREET, 8B",2010-08-16,2200000,2017-02-14,2425000,225000,2374,94.77674810446504
"200 RECTOR PLACE, 21A",2011-08-12,607500,2014-03-24,698000,90500,955,94.76439790575917
"99 JOHN STREET, 1117",2010-06-07,450000,2016-03-18,650000,200000,2111,94.74182851729039
"160 EAST 22ND   STREET, 16D",2015-01-16,1680102,2017-01-23,1750000,69898,738,94.71273712737127
"350 WEST 42ND STREET, 35D",2006-10-10,1664838,2012-11-06,1875000,210162,2219,94.71022983325823
"635 WEST 42ND STREET, 22A",2007-06-15,911333,2016-11-18,1237500,326167,3444,94.70586527293844
"386 COLUMBUS AVENUE, 15A",2005-05-24,1750000,2015-07-09,2100000,350000,3698,94.64575446187128
"324 PEARL STREET, 1A",2004-01-12,353886,2013-06-21,680000,326114,3448,94.58062645011601
"120 RIVERSIDE BOULEVARD, 9M",2006-01-18,613393,2012-11-14,849000,235607,2492,94.54534510433386
"400 EAST 67TH STREET, 8F",2012-10-04,2050000,2017-02-08,2200000,150000,1588,94.45843828715365
"445 5 AVENUE, 27B",2007-02-20,855000,2016-11-09,1190000,335000,3550,94.36619718309859
"235 EAST 40TH   STREET, 21I",2009-09-24,400000,2014-01-31,550000,150000,1590,94.33962264150944
"211 EAST 46TH   STREET, 28E",2009-11-04,647664,2012-07-10,740000,92336,979,94.31664964249234
"400 CENTRAL PARK WEST, 12F",2004-07-19,360000,2018-05-04,835000,475000,5037,94.3021639864999
"114 BENNETT AVENUE, PH-A",2004-05-28,840056,2015-06-12,1220000,379944,4032,94.23214285714286
"175 WEST 12TH STREET, 11F",2007-05-19,910000,2014-05-09,1150000,240000,2547,94.22850412249706
"220 MANHATTAN AVENUE, 2A",2005-10-14,425000,2008-04-30,512500,87500,929,94.18729817007535
"20 PINE STREET, 2413",2010-06-13,687318,2014-04-22,820000,132682,1409,94.16749467707594
"275 GREENWICH STREET, 7CS",2007-08-10,945000,2013-06-03,1145000,200000,2124,94.16195856873823
"415 EAST 37TH   STREET, 30N",2011-05-13,857000,2015-05-18,995000,138000,1466,94.1336971350614
"68 BRADHURST AVENUE, 3-C",2007-06-13,692760,2016-02-04,990000,297240,3158,94.12286257124762
"630 1 AVENUE, 29L",2010-03-31,1178000,2015-01-29,1344090,166090,1765,94.10198300283287
"515 EAST 72ND STREET, 20K",2010-04-26,782525,2016-05-09,990000,207475,2205,94.09297052154194
"211 EAST 46TH   STREET, 20H",2009-06-03,620000,2011-06-17,690000,70000,744,94.08602150537635
"311 EAST 38TH STREET, 4B",2011-11-01,558000,2016-05-27,715000,157000,1669,94.06830437387657
"1630 MADISON AVENUE, 4A",2003-01-30,216996,2007-09-28,377000,160004,1702,94.00940070505288
"247 WEST 46TH   STREET, 4003",2008-12-12,2347066,2014-11-11,2550000,202934,2160,93.95092592592593
"2 SOUTH END AVENUE, 3R",2003-05-09,297000,2007-07-31,442000,145000,1544,93.9119170984456
"392 CENTRAL PARK WEST, 5F",2008-09-18,494000,2016-03-09,750000,256000,2729,93.80725540491022
"163 ST NICHOLAS AVENUE, 6E",2004-05-13,268710,2015-12-09,665000,396290,4227,93.75207002602319
"99 JOHN STREET, 204",2013-08-29,786598,2016-12-22,900000,113402,1211,93.64327002477292
"120 RIVERSIDE BOULEVARD, 11F",2006-02-15,1057961,2017-09-29,1455000,397039,4244,93.55301602262017
"303 EAST 43RD   STREET, 22C",2010-01-05,730000,2016-06-14,950000,220000,2352,93.5374149659864
"181 EAST 90TH STREET, 7A",2008-08-12,1220000,2014-08-13,1425000,205000,2192,93.52189781021897
"25 CENTRAL PARK WEST, 5U",2003-04-08,530000,2018-06-29,1050000,520000,5561,93.50836180543068
"1641 3 AVENUE, 23E",2003-02-20,139831,2014-09-17,535000,395169,4227,93.48687012065295
"15 BROAD STREET, 2600",2006-07-17,1537557,2013-07-01,1775000,237443,2541,93.44470680834317
"200 RECTOR PLACE, 15E",2004-05-12,950000,2010-08-30,1165000,215000,2301,93.43763581051716
"275 GREENWICH STREET, 9MS",2006-10-16,680100,2013-05-20,905000,224900,2408,93.3970099667774
"225 RECTOR PLACE, 15H",2008-07-10,1445915,2017-06-09,1750000,304085,3256,93.39219901719902
"330 EAST 30TH   STREET, 10-B",2010-04-15,570000,2017-11-28,830000,260000,2784,93.39080459770115
"240 EAST 47TH STREET, 25B",2005-01-21,930000,2013-05-31,1215000,285000,3052,93.38138925294889
"845 UNITED NATIONS PLAZA, 5G",2004-07-14,967335,2014-02-21,1295000,327665,3509,93.37845540039898
"150 NASSAU STREET, 3B",2003-03-24,333455,2014-04-08,710000,376545,4033,93.36598065955864
"10 WEST END AVENUE, 9A",2007-08-15,1303360,2013-05-23,1500000,196640,2108,93.28273244781784
"425 CENTRAL PARK WEST, 6B",2008-01-31,335220,2018-05-08,685000,349780,3750,93.27466666666666
"88 GREENWICH STREET, 512",2011-04-07,424866,2015-09-03,575000,150134,1610,93.25093167701863
"225 5 AVENUE, 9C",2007-08-31,1578287,2012-03-12,1732500,154213,1655,93.18006042296072
"148 MADISON STREET, 6G",2003-09-17,361998,2007-08-15,495000,133002,1428,93.13865546218487
"119 FULTON STREET, 4A",2007-01-10,1079345,2016-06-14,1400000,320655,3443,93.13244263723497
"227 EAST 111 STREET, 1D",2005-03-16,377816,2016-02-25,750000,372184,3998,93.09254627313656
"455 EAST 86 STREET, 12F",2003-04-28,260000,2008-06-20,435000,175000,1880,93.08510638297872
"155 WEST 68TH   STREET, 14-23",2013-12-17,1300000,2016-01-08,1370000,70000,752,93.08510638297872
"845 UNITED NATIONS PLAZA, 19F",2011-12-19,645000,2014-01-10,715000,70000,753,92.96148738379814
"505 GREENWICH STREET, 4G",2005-04-12,707683,2010-10-18,895000,187317,2015,92.96129032258065
"41 WEST 72 STREET, 17F",2003-07-08,560038,2003-12-16,575000,14962,161,92.93167701863354
"15 BROAD STREET, 2412",2006-08-02,1337042,2018-08-10,1745000,407958,4391,92.90776588476429
"59 WEST 12TH STREET, 3D",2005-05-23,939750,2010-02-11,1100000,160250,1725,92.89855072463769
"157 LUDLOW STREET, 4F",2005-10-14,565128,2013-11-21,840000,274872,2960,92.86216216216216
"112 WEST 56TH STREET, 8S",2010-07-20,720000,2018-08-29,995000,275000,2962,92.84267386900743
"90 WILLIAM STREET, 7F",2008-07-17,670008,2014-09-26,880000,209992,2262,92.83465959328028
"120 RIVERSIDE BOULEVARD, 10R",2006-02-06,987702,2013-07-17,1240000,252298,2718,92.82487122884474
"230 RIVERSIDE DRIVE, 8C",2007-03-02,921516,2013-07-31,1139000,217484,2343,92.82287665386256
"159 WEST 53RD   STREET, 23C",2012-07-24,605000,2016-03-21,729000,124000,1336,92.81437125748504
"2112 BROADWAY, 7/8GT",2007-06-28,3136210,2016-09-30,3450000,313790,3382,92.78237729154347
"215 WEST 95 STREET, 3B",2003-12-05,390000,2009-06-12,577000,187000,2016,92.7579365079365
"300 WEST 110 STREET, 8J",2003-02-13,257729,2004-05-03,299000,41271,445,92.7438202247191
"322 WEST 57TH   STREET, 21J",2008-03-04,775906,2014-09-03,996000,220094,2374,92.71019376579612
"2250 BROADWAY, 16D",2006-03-14,1355000,2013-02-20,1590000,235000,2535,92.70216962524655
"401 EAST 60TH STREET, 22A",2004-09-27,1595000,2009-10-05,1765000,170000,1834,92.69356597600873
"211 EAST 46TH   STREET, 19H",2008-07-14,736378,2014-11-06,950000,213622,2306,92.63746747614917
"21 SOUTH END AVENUE, 226",2003-12-05,545000,2014-06-03,900000,355000,3833,92.61674928254631
"1623 THIRD AVENUE, 11H",2006-12-11,999000,2015-02-09,1275000,276000,2982,92.5553319919517
"261 WEST 28TH STREET, 5F",2007-11-19,728048,2018-06-12,1085000,356952,3858,92.52255054432348
"300 EAST 23RD   STREET, 12F",2012-04-06,916425,2013-05-28,955000,38575,417,92.50599520383693
"372 CENTRAL PARK WEST, 2P",2003-09-12,690000,2009-03-04,875000,185000,2000,92.5
"90 WILLIAM STREET, 14B",2008-06-25,1306414,2014-10-22,1520000,213586,2310,92.46147186147186
"99 JOHN STREET, 925",2011-06-02,555000,2016-09-30,735000,180000,1947,92.44992295839754
"505 WEST 47TH   STREET, 2F-S",2010-06-23,860421,2017-09-20,1105000,244579,2646,92.43348450491308
"80 PARK AVENUE, 8L",2011-03-21,545000,2015-10-23,700000,155000,1677,92.42695289206917
"99 JOHN STREET, 603",2010-10-15,441090,2016-10-31,645000,203910,2208,92.35054347826087
"211 EAST 46TH   STREET, 28B",2009-05-12,659168,2013-07-15,800000,140832,1525,92.3488524590164
"230 RIVERSIDE DRIVE, 3A",2007-07-03,1328816,2017-01-11,1650000,321184,3480,92.29425287356322
"225 EAST 34TH STREET, 2G",2007-11-27,1043706,2012-07-18,1200000,156294,1695,92.20884955752213
"257 WEST 117TH STREET, 5B",2008-07-31,605858,2015-10-21,849000,243142,2638,92.16906747536012
"2109 BROADWAY, 15137",2013-03-20,1750000,2018-06-01,1925000,175000,1899,92.15376513954713
"111 WEST 67TH   STREET, 21-A",2007-09-11,935000,2017-07-12,1266000,331000,3592,92.14922048997772
"99 JOHN STREET, 911",2013-03-21,498000,2016-04-01,600000,102000,1107,92.14092140921409
"660 RIVERSIDE DRIVE, 5C",2012-01-10,290000,2017-12-20,490000,200000,2171,92.12344541685859
"5 EAST 22ND   STREET, 16B",2008-05-09,850000,2015-01-16,1075000,225000,2443,92.09987720016373
"112 WEST 72ND   STREET, 8F",2012-07-26,440000,2018-02-05,626000,186000,2020,92.07920792079207
"2 SOUTH END AVENUE, 5J",2011-04-06,290000,2015-07-29,435000,145000,1575,92.06349206349206
"15 BROAD STREET, 1508",2006-05-17,470000,2013-12-16,725000,255000,2770,92.05776173285199
"350 WEST 42ND STREET, 8M",2006-05-09,559019,2013-12-19,815000,255981,2781,92.04638619201727
"382 CENTRAL PARK WEST, 8G",2003-12-04,285948,2018-05-01,770000,484052,5262,91.9901178259217
"350 WEST 42ND STREET, 20D",2006-10-05,835000,2014-08-26,1100000,265000,2882,91.9500346981263
"120 EAST 87TH   STREET, P12-B",2007-05-29,990000,2013-08-29,1200000,210000,2284,91.94395796847635
"515 EAST 72ND   STREET, 29C",2008-04-02,1858306,2017-09-08,2175000,316694,3446,91.90191526407429
"80 RIVERSIDE BOULEVARD, 12E",2009-06-04,2260515,2013-07-31,2400000,139485,1518,91.88735177865613
"30 LITTLE WEST STREET, 33C",2015-05-05,1615000,2018-06-21,1720000,105000,1143,91.86351706036746
"350 WEST 42ND STREET, 12K",2006-05-25,618077,2009-09-25,730000,111923,1219,91.81542247744052
"88 GREENWICH STREET, 428",2010-07-30,456000,2014-04-11,580000,124000,1351,91.78386380458919
"77 PARK AVENUE, 9H",2008-08-18,900000,2018-01-10,1215000,315000,3432,91.78321678321679
"120 RIVERSIDE BOULEVARD, 5M",2005-12-20,584068,2013-07-29,839000,254932,2778,91.76817854571634
"1431 6 AVENUE, 4F",2003-02-13,288990,2003-09-30,310000,21010,229,91.7467248908297
"350 WEST 14TH STREET, 3G",2005-09-29,390000,2014-04-03,675000,285000,3108,91.6988416988417
"106 CENTRAL PARK SOUTH, 14H",2007-04-11,845000,2017-11-16,1200000,355000,3872,91.68388429752066
"2250 BROADWAY, 3G",2003-08-01,499000,2017-12-12,980000,481000,5247,91.6714312940728
"15 BROAD STREET, 2610",2006-07-06,1517192,2010-06-24,1650000,132808,1449,91.65493443754313
"101 WEST 24TH   STREET, 11D",2008-09-04,1685203,2010-08-12,1750000,64797,707,91.65063649222066
"220 RIVERSIDE BOULEVARD, 28F",2011-09-09,1250000,2015-06-04,1375000,125000,1364,91.64222873900293
"460 EAST 79TH   STREET, 10C",2009-03-04,700000,2015-06-29,911333,211333,2308,91.56542461005199
"106 CENTRAL PARK SOUTH, 4B",2005-02-07,395000,2013-09-19,683000,288000,3146,91.54481881754609
"1049 FIFTH AVENUE, 9A",2006-12-18,4995000,2012-04-18,5173267,178267,1948,91.51283367556468
"505 WEST 47TH   STREET, 4A-S",2010-05-28,575311,2015-08-19,750000,174689,1909,91.50811943425877
"635 WEST 42ND   STREET, 30F",2007-05-04,1344090,2017-05-22,1680000,335910,3671,91.50367747207845
"635 WEST 42ND   STREET, 45D",2007-11-09,1476462,2017-03-01,1787500,311038,3400,91.48176470588236
"88 GREENWICH STREET, 1019",2010-04-12,545000,2015-10-26,730000,185000,2023,91.44834404349976
"184 THOMPSON STREET, 5C",2007-08-22,773870,2017-06-01,1100000,326130,3571,91.32735928311398
"175 WEST 12TH STREET, 10N",2006-03-07,501930,2015-07-28,815000,313070,3430,91.27405247813411
"18 PINE STREET, 701",2009-10-01,916425,2014-12-16,1090000,173575,1902,91.25920084121977
"230 RIVERSIDE DRIVE, 19E",2007-09-21,763687,2017-10-24,1100000,336313,3686,91.24064026044492
"10 WEST END AVENUE, 11D",2007-11-29,933804,2015-02-24,1175000,241196,2644,91.22390317700454
"253 WEST 73RD STREET, 4E",2004-08-11,810000,2010-03-01,995000,185000,2028,91.22287968441815
"56 PINE STREET, 8B",2005-12-14,410670,2015-11-03,740000,329330,3611,91.20188313486568
"455 MAIN STREET, 11H",2006-04-17,448188,2010-05-27,585000,136812,1501,91.14723517654896
"200 BOWERY, 4C",2006-01-26,438880,2011-08-30,625000,186120,2042,91.14593535749266
"225 EAST 34TH   STREET, 2H",2008-01-24,809508,2009-09-24,865000,55492,609,91.11986863711002
"184 THOMPSON STREET, LB",2007-12-03,870000,2018-08-14,1226000,356000,3907,91.11850524699258
"90 WILLIAM STREET, 8G",2008-08-15,858384,2016-10-13,1130000,271616,2981,91.11573297551158
"422 EAST 72ND STREET, 20B",2013-04-16,791000,2017-06-09,929000,138000,1515,91.08910891089108
"257 WEST 117TH STREET, 3H",2008-07-28,687318,2016-12-02,965000,277682,3049,91.07313873401115
"2250 BROADWAY, 4G",2004-01-16,525000,2018-05-02,999999,474999,5220,90.99597701149425
"100 RIVERSIDE BOULEVARD, 12J",2008-05-12,985000,2014-10-31,1200000,215000,2363,90.98603470165044
"392 CENTRAL PARK WEST, 19U",2003-08-18,280000,2013-09-17,615000,335000,3683,90.95845777898452
"380 RECTOR PLACE, 22B",2004-07-06,498000,2015-06-22,862000,364000,4003,90.93180114913815
"1601 3 AVENUE, 33B",2003-02-20,178870,2013-11-13,535000,356130,3919,90.87267159989793
"90 WILLIAM STREET, 2F",2008-09-08,619096,2015-06-30,845000,225904,2486,90.87047465808527
"220 RIVERSIDE BOULEVARD, 15D",2007-09-17,1399900,2013-04-15,1585000,185100,2037,90.86892488954345
"2 COLUMBUS AVENUE, 4A",2005-08-09,1025000,2016-11-15,1399000,374000,4116,90.86491739552964
"202 WEST 140 STREET, 2A",2007-11-20,361998,2018-01-16,699000,337002,3710,90.83611859838275
"111 FULTON STREET, 704",2010-02-04,450000,2013-04-05,555000,105000,1156,90.83044982698962
"350 EAST 82ND   STREET, 7X",2009-07-23,995000,2017-03-31,1250000,255000,2808,90.8119658119658
"120 RIVERSIDE BOULEVARD, 5F",2005-12-07,1017231,2007-03-23,1060000,42769,471,90.80467091295117
"15 BROAD STREET, 3730",2007-05-09,3039237,2017-06-23,3375000,335763,3698,90.79583558680368
"313 WEST 119 STREET, 5K",2007-08-01,1374620,2013-12-05,1585000,210380,2318,90.75927523727351
"1641 THIRD AVENUE, 11H",2005-09-13,985000,2014-10-29,1287500,302500,3333,90.75907590759076
"301 WEST 57TH   STREET, 40D",2007-11-20,920000,2017-11-06,1250000,330000,3639,90.68425391591096
"464 WEST 44TH   STREET, 7G",2008-02-15,943144,2015-11-18,1200000,256856,2833,90.6657253794564
"1595 LEXINGTON AVENUE, 6A",2013-10-03,436020,2015-12-28,510000,73980,816,90.66176470588235
"40 BROAD STREET, 28C",2011-05-05,555627,2015-04-02,685000,129373,1428,90.59733893557423
"15 WILLIAM STREET, 41J",2009-10-20,1150000,2011-04-25,1200000,50000,552,90.57971014492753
"100 WEST 93RD STREET, 7A",2015-05-15,787000,2018-05-01,885000,98000,1082,90.57301293900184
"303 GREENWICH STREET, 4C",2011-07-27,535000,2016-09-15,705000,170000,1877,90.57005860415556
"29 WEST 65TH   STREET, 4J",2010-05-20,425880,2016-03-28,619588,193708,2139,90.56007480130903
"1965 BROADWAY, 22J",2004-05-05,590000,2011-06-13,825000,235000,2595,90.5587668593449
"130 SUFFOLK STREET, 134-D",2005-07-18,765000,2018-07-19,1195000,430000,4749,90.54537797431038
"200 CHAMBERS STREET, 5U",2007-03-23,717866,2012-12-10,907000,189134,2089,90.5380564863571
"555 WEST 23RD   STREET, N6R",2009-06-29,572500,2013-08-26,710000,137500,1519,90.52007899934168
"150 NASSAU STREET, 9C",2003-03-26,355104,2012-09-14,668000,312896,3460,90.43236994219653
"100 RIVERSIDE BOULEVARD, 25E",2008-07-25,1206626,2013-08-30,1375000,168374,1862,90.42642320085929
"205 EAST 85TH STREET, 5A",2011-02-15,645500,2017-06-20,855000,209500,2317,90.41864479930945
"252 7 AVENUE, 11S",2003-01-16,755000,2012-05-09,1062500,307500,3401,90.41458394589827
"234 WEST 148 STREET, 2E",2014-03-10,469000,2018-07-20,613000,144000,1593,90.3954802259887
"1 MORTON SQUARE, 11D W",2004-12-14,2189237,2009-07-31,2341975,152738,1690,90.3775147928994
"310 WEST 52ND   STREET, 35C",2007-08-21,977520,2017-05-30,1300000,322480,3570,90.33053221288516
"120 RIVERSIDE BOULEVARD, 6V",2005-12-28,547411,2009-09-16,670000,122589,1358,90.27172312223858
"11 EAST 36TH   STREET, 301",2007-05-18,1050541,2017-07-10,1385000,334459,3706,90.24797625472208
"350 WEST 53RD   STREET, 4H",2007-03-15,895000,2017-12-22,1250000,355000,3935,90.21601016518424
"21 SOUTH END AVENUE, 227",2006-11-17,830000,2017-01-17,1165000,335000,3714,90.19924609585352
"400 CENTRAL PARK WEST, 15L",2010-03-23,564500,2013-06-27,672000,107500,1192,90.18456375838926
"635 WEST 42ND   STREET, 20L",2009-07-06,677136,2017-10-19,950000,272864,3027,90.14337628014536
"225 EAST 34TH STREET, 6H",2007-10-25,732121,2015-01-15,970000,237879,2639,90.13982569154983
"225 WEST 83 STREET, 5Z",2004-06-22,600000,2014-01-16,915000,315000,3495,90.12875536480686
"393 WEST 49TH STREET, 3D",2009-07-29,548000,2015-09-22,750000,202000,2246,89.93766696349066
"322 WEST 57TH   STREET, 25V",2008-02-28,799326,2016-07-21,1075000,275674,3066,89.91324200913242
"400 CENTRAL PARK WEST, 14K",2013-02-14,850000,2014-05-05,890000,40000,445,89.88764044943821
"163 ST NICHOLAS AVENUE, 4I",2004-06-09,233220,2018-07-19,696000,462780,5153,89.80787890549195
"122 GREENWICH AVENUE, 23",2012-05-15,3200000,2018-06-20,3400000,200000,2227,89.8069151324652
"630 1 AVENUE, 25R",2003-01-22,387000,2018-07-19,895000,508000,5657,89.800247480997
"301 EAST 45TH   STREET, 21F",2012-12-21,631000,2016-04-07,739000,108000,1203,89.77556109725685
"20 WEST STREET, 36C",2007-01-23,481650,2008-05-20,525000,43350,483,89.75155279503106
"1641 3 AVENUE, 21B",2003-02-20,164321,2014-06-13,535000,370679,4131,89.73105785524086
"3 WEEHAWKEN STREET, 2B",2010-09-07,529000,2012-09-12,595000,66000,736,89.67391304347827
"306 MOTT STREET, PH-A",2007-04-10,1710660,2016-07-26,2015000,304340,3395,89.64359351988217
"88 GREENWICH STREET, 523",2010-05-19,490000,2015-06-03,655000,165000,1841,89.62520369364476
"145 EAST 48 STREET, 26B",2005-03-22,690000,2008-02-15,785000,95000,1060,89.62264150943396
"200 RIVERSIDE BOULEVARD, 23B",2004-07-01,1160000,2018-04-03,1610000,450000,5024,89.57006369426752
"100 RIVERSIDE BOULEVARD, 20H",2008-07-25,1084436,2015-09-15,1318000,233564,2608,89.55674846625767
"225 WEST 83 STREET, 16K",2003-07-11,530000,2013-06-18,855000,325000,3630,89.53168044077135
"108 FIFTH AVENUE, 7C",2006-10-04,817000,2012-01-19,990000,173000,1933,89.49818934299017
"30 EAST 37TH   STREET, 4D",2011-11-30,437694,2017-10-18,630000,192306,2149,89.48627268496975
"177 EAST 77TH   STREET, 4B",2007-08-22,965000,2014-05-16,1185000,220000,2459,89.46726311508743
"240 RIVERSIDE BOULEVARD, 14N-T",2006-03-15,844750,2014-01-08,1100000,255250,2856,89.37324929971989
"310 WEST 52ND   STREET, 39C",2007-07-12,1002976,2011-04-08,1125000,122024,1366,89.3294289897511
"225 5 AVENUE, 3T",2007-05-21,789143,2010-10-13,900000,110857,1241,89.32876712328768
"222 WEST 14TH   STREET, 7C",2007-07-16,720000,2015-09-01,985000,265000,2969,89.25564163017852
"99 JOHN STREET, 804",2012-09-11,515000,2016-05-18,635000,120000,1345,89.21933085501858
"300 EAST 79TH STREET, 3B",2008-06-26,1284013,2018-03-08,1600000,315987,3542,89.21146245059289
"140 WEST 22ND STREET, 4E",2009-12-28,590585,2017-12-18,850000,259415,2912,89.08482142857143
"184 THOMPSON STREET, 2W",2011-06-17,530000,2017-11-30,740000,210000,2358,89.05852417302799
"211 EAST 46TH   STREET, 31J",2008-08-27,605252,2010-10-20,675000,69748,784,88.96428571428571
"309 EAST 49TH STREET, 5C",2006-03-21,615000,2016-11-29,962000,347000,3906,88.83768561187917
"40 BROAD STREET, 12A",2012-04-03,855228,2018-05-31,1055000,199772,2249,88.82703423743887
"300 EAST 77TH   STREET, 25B",2007-01-17,2138325,2012-06-29,2315000,176675,1990,88.78140703517587
"310 EAST 53RD STREET, 28A",2006-12-27,2881647,2015-04-08,3150000,268353,3024,88.74107142857143
"1600 BROADWAY, 7F",2006-05-31,549855,2015-05-14,840000,290145,3270,88.72935779816514
"247 WEST 46TH   STREET, 1801",2008-11-13,1338998,2016-06-17,1585000,246002,2773,88.7133068878471
"301 CATHEDRAL PARKWAY, 3H",2005-05-20,655000,2016-10-20,1025000,370000,4171,88.70774394629585
"382 CENTRAL PARK WEST, 12W",2007-08-29,750000,2013-12-27,955000,205000,2312,88.66782006920415
"330 EAST 38 STREET, 36M",2003-03-11,414500,2014-02-26,769500,355000,4005,88.63920099875156
"32 WEST 132 STREET, 32-2",2003-03-11,188044,2008-12-01,373448,185404,2092,88.62523900573613
"425 FIFTH AVENUE, 34A",2005-03-03,850000,2018-04-26,1275000,425000,4802,88.50478967097042
"225 WEST 60TH STREET, 8E",2013-09-10,1358000,2018-07-20,1515000,157000,1774,88.50056369785794
"1 IRVING PLACE, V25D",2005-10-11,1450000,2012-09-27,1675000,225000,2543,88.47817538340543
"106 CENTRAL PARK SOUTH, 18CD",2004-10-21,790000,2012-11-07,1050000,260000,2939,88.46546444368833
"120 RIVERSIDE BOULEVARD, PH1E",2006-04-06,811036,2016-06-13,1140000,328964,3721,88.40741736092448
"500 WEST END AVENUE, 6C",2007-04-18,4174825,2013-08-26,4380000,205175,2322,88.36132644272179
"404 EAST 76 STREET, 27B",2004-04-29,765000,2009-11-04,943000,178000,2015,88.33746898263027
"425 5 AVENUE, 22C",2004-06-28,446176,2017-02-28,855000,408824,4628,88.33707865168539
"18 PINE STREET, 2313",2009-10-16,661862,2017-08-21,915000,253138,2866,88.32449406838799
"225 WEST 83RD STREET, 11A",2009-12-03,795500,2018-06-07,1070000,274500,3108,88.32046332046332
"90 WILLIAM STREET, 14C",2008-07-07,942899,2018-07-03,1265000,322101,3648,88.29523026315789
"1601 3 AVENUE, 34B",2003-02-20,180999,2014-08-01,550000,369001,4180,88.27775119617225
"5 HARRISON STREET, 3",2005-05-23,2000000,2013-02-22,2250000,250000,2832,88.2768361581921
"280 PARK AVENUE SOUTH, 4F",2004-04-23,585000,2017-02-24,999000,414000,4690,88.27292110874201
"16 WEST 19TH   STREET, 3-C",2008-01-18,997885,2017-02-09,1290000,292115,3310,88.25226586102718
"555 WEST 23RD   STREET, N7F",2007-02-13,1056006,2011-08-03,1200000,143994,1632,88.23161764705883
"10 WEST END AVENUE, 4C",2007-07-03,775906,2017-11-14,1110000,334094,3787,88.22128333773435
"250 WEST 88TH STREET, 603",2010-08-03,630000,2014-06-20,755000,125000,1417,88.21453775582216
"340 EAST 23RD STREET, 3K",2008-04-03,763687,2014-03-12,955000,191313,2169,88.20331950207469
"300 EAST 95TH STREET, 7A",2005-06-03,545000,2007-02-28,601000,56000,635,88.18897637795276
"124 WEST 93RD STREET, 7C",2005-04-06,900000,2013-06-28,1165000,265000,3005,88.18635607321131
"360 EAST 88TH STREET, 11E",2009-05-20,430000,2016-03-22,650000,220000,2498,88.07045636509207
"1965 BROADWAY, 15C",2009-07-13,995000,2012-10-18,1100000,105000,1193,88.01341156747695
"150 WEST 56TH STREET, 3907",2005-04-14,775000,2013-01-23,1025000,250000,2841,87.99718409010912
"200 EAST 69 STREET, 7H",2004-04-21,355000,2007-04-06,450000,95000,1080,87.96296296296296
"220 RIVERSIDE BOULEVARD, 10D",2005-05-05,1050000,2016-03-28,1400000,350000,3980,87.93969849246231
"350 WEST 50TH   STREET, 4A",2011-01-14,550000,2016-08-22,730000,180000,2047,87.93356130923303
"225 WEST 83RD STREET, 8C",2004-11-22,625000,2007-07-17,710000,85000,967,87.90072388831437
"145 EAST 48TH STREET, 23D",2005-04-18,420000,2007-10-04,499000,79000,899,87.87541713014461
"188 EAST 70 STREET, 24B",2003-04-16,800000,2004-11-05,850000,50000,569,87.87346221441125
"200 WEST END AVENUE, 12J",2008-07-11,1181170,2017-05-15,1465000,283830,3230,87.87306501547988
"120 RIVERSIDE BOULEVARD, 7R",2006-01-23,977520,2013-12-06,1230000,252480,2874,87.84968684759916
"2628 BROADWAY, 5B",2007-10-10,1781937,2011-01-24,1887500,105563,1202,87.82279534109817
"215 WEST 90TH   STREET, 8-F",2008-10-31,1390000,2016-08-18,1640000,250000,2848,87.78089887640449
"56 PINE STREET, 9B",2005-11-18,420810,2016-02-25,750000,329190,3751,87.76059717408691
"445 WEST 54TH STREET, 5B",2006-01-18,882000,2014-07-30,1155000,273000,3115,87.64044943820225
"220 RIVERSIDE BOULEVARD, 26B",2004-08-20,1550000,2011-05-10,1765000,215000,2454,87.6120619396903
"310 WEST 52ND   STREET, 22C",2007-06-22,959955,2017-06-22,1280000,320045,3653,87.61155214891869
"120 RIVERSIDE BOULEVARD, 9D",2006-03-23,563500,2009-09-16,675000,111500,1273,87.58837391987431
"100 RIVERSIDE BOULEVARD, 10R",2008-06-27,1338998,2016-08-24,1600000,261002,2980,87.58456375838927
"630 FIRST AVENUE, 24K",2007-11-02,1030000,2015-07-01,1275000,245000,2798,87.5625446747677
"392 CENTRAL PARK WEST, 7E",2006-06-15,450000,2016-12-05,785000,335000,3826,87.55880815473078
"200 EAST 61ST   STREET, 9D",2007-11-16,940000,2015-10-15,1193000,253000,2890,87.5432525951557
"350 WEST 42ND STREET, 15D",2006-06-12,689237,2013-08-30,920000,230763,2636,87.5428679817906
"421 EAST 13TH   STREET, 2A",2008-02-05,911333,2016-05-06,1175000,263667,3013,87.50979090607368
"20 CLINTON STREET, 2B",2004-12-07,550000,2010-07-26,730000,180000,2057,87.50607681088964
"677 WASHINGTON STREET, 15B",2003-03-31,1185000,2009-12-21,1400000,215000,2457,87.5050875050875
"108 5 AVENUE, 11A",2006-03-23,1100000,2012-06-25,1300000,200000,2286,87.48906386701663
"630 1 AVENUE, 31P",2005-11-14,749000,2018-03-07,1142287,393287,4496,87.4748665480427
"305 WEST 18TH   STREET, 3D",2008-11-19,765000,2014-09-04,950000,185000,2115,87.47044917257683
"350 WEST 42ND STREET, 16K",2006-06-16,690373,2018-06-28,1074800,384427,4395,87.46916951080773
"515 EAST 72ND STREET, 5F",2013-08-15,864494,2017-07-20,990000,125506,1435,87.46062717770035
"425 5 AVENUE, 27D",2004-04-14,575311,2012-04-05,830000,254689,2913,87.43185719189839
"56 PINE STREET, 7A",2005-06-30,441090,2013-08-09,700000,258910,2962,87.4105334233626
"200 RIVERSIDE BOULEVARD, 11M",2004-07-22,1200000,2010-09-01,1395000,195000,2232,87.36559139784946
"240 RIVERSIDE BOULEVARD, 9 N-T",2005-11-03,801750,2014-05-28,1075000,273250,3128,87.35613810741688
"408 EAST 79TH   STREET, 9B",2007-07-03,2647450,2013-11-07,2850000,202550,2319,87.34368262181975
"222 RIVERSIDE DRIVE, PH2E",2003-12-30,415000,2014-08-29,755000,340000,3895,87.29139922978177
"2 SOUTH END AVENUE, 3K",2011-06-09,330000,2018-07-18,556600,226600,2596,87.28813559322033
"309 WEST 118 STREET, 3N",2005-03-30,405600,2012-07-03,637000,231400,2652,87.25490196078431
"280 PARK AVENUE SOUTH, 4E",2005-02-03,672500,2016-12-12,1050000,377500,4330,87.1824480369515
"230 RIVERSIDE DRIVE, 3O",2007-01-12,952063,2017-01-07,1270000,317937,3648,87.15378289473684
"309 WEST 118 STREET, 4C",2005-03-09,436020,2012-06-22,668000,231980,2662,87.145003756574
"107 EAST 31ST STREET, 6A",2008-08-07,509252,2012-01-30,620000,110748,1271,87.1345397324941
"254 PARK AVENUE SOUTH, 11R",2009-12-23,572105,2018-05-25,840000,267895,3075,87.12032520325204
"99 JOHN STREET, 702",2012-12-10,500000,2018-06-11,675000,175000,2009,87.10801393728222
"88 GREENWICH STREET, 829",2009-08-26,540000,2015-05-05,721000,181000,2078,87.10298363811357
"99 BATTERY PLACE, 19-F",2005-04-22,560000,2016-12-09,930000,370000,4249,87.07931277947752
"99 JOHN STREET, 1003",2011-10-05,495000,2017-10-30,688000,193000,2217,87.05457825890844
"80 PARK AVENUE, 6P",2003-06-27,615000,2014-01-10,950000,335000,3850,87.01298701298701
"515 EAST 72ND   STREET, 28J",2011-12-27,805000,2014-05-07,880000,75000,862,87.00696055684455
"1619 3 AVENUE, 23J",2003-02-20,307699,2018-08-21,800000,492301,5661,86.96361066949302
"260 PARK AVENUE SOUTH, 9B",2012-05-22,5940000,2017-06-05,6100000,160000,1840,86.95652173913044
"166 EAST 63RD   STREET, 8H",2015-01-21,650000,2015-09-08,670000,20000,230,86.95652173913044
"52 PARK AVENUE, 9",2004-08-25,967337,2011-12-23,1200000,232663,2676,86.94431988041853
"211 EAST 46TH   STREET, 31E",2008-08-13,827776,2015-08-14,1050000,222224,2557,86.90809542432538
"677 WASHINGTON STREET, 9E",2003-05-22,625000,2007-04-30,750000,125000,1439,86.86587908269631
"222 RIVERSIDE DRIVE, 6F",2003-01-31,340000,2011-06-10,605000,265000,3052,86.82830930537352
"120 RIVERSIDE BOULEVARD, 9P",2006-01-18,587000,2017-06-30,950000,363000,4181,86.82133460894522
"382 CENTRAL PARK WEST, 4K",2006-05-12,735000,2017-05-26,1085000,350000,4032,86.80555555555556
"491-497 GREENWICH STREET, 4A",2006-03-31,1807393,2010-09-29,1950000,142607,1643,86.79671332927572
"372 CENTRAL PARK WEST, 14S",2003-12-03,335000,2017-10-23,775000,440000,5073,86.73368815296669
"25 CENTRAL PARK WEST, 6X",2003-07-16,885000,2012-09-10,1175000,290000,3344,86.72248803827752
"325 5 AVENUE, 26B",2008-07-01,2000000,2013-03-27,2150000,150000,1730,86.70520231213872
"259 ELIZABETH STREET, 5A",2006-05-19,560000,2014-02-12,805000,245000,2826,86.69497523000707
"175 EAST 2ND   STREET, 2A",2008-04-07,915000,2013-08-20,1085000,170000,1961,86.69046404895461
"200 EAST 89TH   STREET, 9D",2009-08-12,530000,2016-09-20,755000,225000,2596,86.67180277349769
"117 EAST 57 STREET, 21F",2004-07-21,995000,2007-11-15,1100000,105000,1212,86.63366336633663
"200 CHAMBERS STREET, 2M",2006-02-27,820709,2016-11-18,1160000,339291,3917,86.62011743681389
"161 WEST 133 STREET, 5A",2010-10-21,295000,2018-03-27,530000,235000,2714,86.58806190125276
"520 EAST 81ST   STREET, 7B",2010-08-05,375000,2016-02-17,550000,175000,2022,86.54797230464887
"44 WEST 22ND STREET, 3",2007-03-22,1486645,2011-06-10,1620000,133355,1541,86.53796236210253
"350 WEST 50TH STREET, 22E",2005-10-05,1380000,2017-06-20,1750000,370000,4276,86.52946679139383
"2280 FREDERICK DOUGLASS B, 3G",2011-11-17,347415,2018-04-05,549000,201585,2331,86.48005148005149
"134 WEST 93RD STREET, 7C",2010-05-10,675000,2017-10-18,910000,235000,2718,86.46063281824871
"300 EAST 90TH STREET, 2C",2010-01-19,484000,2018-06-25,750000,266000,3079,86.39168561221176
"15 BROAD STREET, 2628",2006-11-01,610950,2016-08-19,920000,309050,3579,86.35093601564682
"392 CENTRAL PARK WEST, 12J",2004-03-05,506000,2012-11-13,780000,274000,3175,86.2992125984252
"555 LENOX AVENUE, PHF",2011-09-08,315000,2017-11-15,510000,195000,2260,86.28318584070796
"200 EAST 66TH   STREET, D0404",2009-02-12,2150385,2013-03-26,2280000,129615,1503,86.2375249500998
"400 CENTRAL PARK WEST, 14G",2004-06-04,307405,2013-11-15,605000,297595,3451,86.23442480440453
"184 THOMPSON STREET, 1O",2007-04-27,544763,2014-06-23,770000,225237,2614,86.16564651874522
"350 WEST 53RD   STREET, 1BTHB",2007-09-17,870000,2016-08-10,1150000,280000,3250,86.15384615384616
"1 IRVING PLACE, G15G",2007-11-20,710000,2008-08-13,733000,23000,267,86.14232209737828
"75 WALL STREET, 31B",2009-06-01,967337,2014-09-30,1135000,167663,1947,86.11350796096559
"445 WEST 19TH STREET, 6D",2006-02-24,420000,2017-06-16,775595,355595,4130,86.10048426150121
"400 EAST 54TH STREET, 20A",2006-10-12,887500,2017-07-06,1225000,337500,3920,86.09693877551021
"240 RIVERSIDE BOULEVARD, 6 M",2006-02-03,1017450,2016-09-01,1350000,332550,3863,86.08594356717578
"211 EAST 46TH   STREET, 12B",2008-04-25,703610,2013-12-04,880000,176390,2049,86.08589555880917
"304 EAST 65TH STREET, 21C",2005-02-01,660000,2013-11-01,935000,275000,3195,86.07198748043818
"77 WEST 55TH   STREET, 15C",2007-09-29,525000,2014-08-01,740000,215000,2498,86.06885508406725
"432 WEST 52ND   STREET, 3B",2015-03-12,676177,2017-07-17,750000,73823,858,86.04079254079254
"220 EAST 65TH STREET, 5B",2010-08-31,880000,2014-05-28,997500,117500,1366,86.01756954612006
"380 LENOX AVENUE, 9J",2007-01-26,813530,2018-02-08,1160000,346470,4031,85.95137682957083
"200 EAST 61ST STREET, 14F",2004-08-03,707750,2017-02-02,1100000,392250,4566,85.90670170827858
"225 5 AVENUE, 4F",2007-05-11,1657201,2013-01-09,1835000,177799,2070,85.89323671497584
"26 WEST 119 STREET, G",2008-04-09,565128,2018-07-02,886000,320872,3736,85.8865096359743
"211 EAST 46TH   STREET, 7E",2010-05-07,679000,2017-11-14,915000,236000,2748,85.8806404657933
"307 WEST 126 STREET, 5B",2007-07-20,490776,2016-12-05,785000,294224,3426,85.87974314068884
"99 JOHN STREET, 924",2009-10-05,500000,2015-10-27,690000,190000,2213,85.85630366018978
"99 JOHN STREET, 909",2012-12-12,498000,2017-10-06,649000,151000,1759,85.84422967595225
"342 EAST 110 STREET, 3D",2010-06-18,528471,2018-02-01,767500,239029,2785,85.82728904847397
"250 EAST 53RD STREET, 3001",2008-03-19,2431554,2016-10-12,2700000,268446,3129,85.79290508149569
"130 BARROW STREET, 404",2007-04-17,1110000,2012-11-16,1285000,175000,2040,85.7843137254902
"301 EAST 45TH STREET, 18B",2006-06-09,620000,2017-06-16,965000,345000,4025,85.71428571428571
"330 EAST 38TH STREET, 45M",2012-04-05,631580,2018-06-12,825000,193420,2259,85.62195661797256
"393 WEST 49TH STREET, 3I",2006-06-16,456300,2008-08-27,525000,68700,803,85.55417185554172
"200 RECTOR PLACE, 15F",2003-09-19,460000,2018-04-12,915000,455000,5319,85.54239518706524
"90 WILLIAM STREET, 16C",2008-08-19,976502,2018-05-09,1280000,303498,3550,85.49239436619719
"555 WEST 23RD STREET, S7J",2008-09-16,760000,2017-03-13,1025000,265000,3100,85.48387096774194
"706 RIVERSIDE DRIVE, 8B",2007-03-29,456300,2017-02-16,765000,308700,3612,85.46511627906976
"350 WEST 42ND   STREET, 28B",2007-03-16,651680,2012-06-08,815000,163320,1911,85.46310832025118
"425 5 AVENUE, 46C",2004-10-15,507088,2017-03-21,895000,387912,4540,85.4431718061674
"342 EAST 110 STREET, PH8C",2009-12-22,435000,2016-10-14,647500,212500,2488,85.40996784565917
"102 MADISON STREET, 5B",2004-12-14,290000,2006-05-02,333000,43000,504,85.31746031746032
"350 WEST 42ND STREET, 7B",2006-04-27,616041,2013-05-07,835000,218959,2567,85.29762368523568
"240 PARK AVENUE SOUTH, 6A",2008-04-04,2851100,2013-01-14,3000000,148900,1746,85.28064146620848
"1623 3 AVENUE, 41J",2003-02-20,346738,2014-06-26,700000,353262,4144,85.24662162162163
"1600 BROADWAY, 15C",2006-06-16,1557922,2012-08-17,1750000,192078,2254,85.21650399290151
"1619 3 AVENUE, 24B",2003-02-20,161125,2015-08-20,550000,388875,4564,85.20486415425066
"1623 3 AVENUE, 39B",2003-02-20,191646,2017-01-26,625000,433354,5089,85.15504028296326
"2112 BROADWAY, 4D",2007-03-29,1832850,2017-06-09,2150000,317150,3725,85.14093959731544
"15 WILLIAM STREET, 16A",2009-10-20,1500000,2015-04-09,1670000,170000,1997,85.12769153730596
"162 WEST 56TH STREET, 1702",2008-06-30,1040000,2013-12-19,1210000,170000,1998,85.08508508508508
"77 HUDSON STREET, 5-RES",2005-01-28,1622500,2012-10-19,1862500,240000,2821,85.07621410847217
"250 EAST 65TH   STREET, 13C",2007-05-14,1364455,2014-06-19,1585000,220545,2593,85.05399151561897
"160 WADSWORTH AVENUE, 307",2004-09-01,350000,2006-08-31,412000,62000,729,85.0480109739369
"382 CENTRAL PARK WEST, 15V",2006-08-11,633000,2014-09-22,885000,252000,2964,85.02024291497976
"120 RIVERSIDE BOULEVARD, 8A",2006-02-07,571849,2018-02-13,945000,373151,4389,85.01959444064707
"350 WEST 50 STREET, 4EE",2003-10-17,207100,2015-11-17,582000,374900,4414,84.93429995468962
"111 FULTON STREET, 605",2009-07-16,476580,2012-07-20,570000,93420,1100,84.92727272727272
"10 WEST END AVENUE, 11B",2007-07-30,1221900,2017-09-06,1535000,313100,3691,84.82795990246545
"62 WEST 62ND STREET, 5E",2004-09-24,710000,2017-04-28,1100000,390000,4599,84.80104370515329
"382 CENTRAL PARK WEST, 9B",2005-09-30,625000,2014-08-06,899000,274000,3232,84.77722772277228
"171 EAST 84TH STREET, 8F",2009-08-11,550000,2017-01-03,779000,229000,2702,84.7520355292376
"225 EAST 34TH STREET, 4D",2007-11-21,741780,2014-05-21,942875,201095,2373,84.74294142435735
"20 CLINTON STREET, 6B",2007-05-04,710000,2016-07-19,995000,285000,3364,84.7205707491082
"143 AVENUE B, 14B",2004-07-20,730000,2018-02-16,1150000,420000,4959,84.69449485783424
"150 EAST 85TH STREET, 13A",2007-06-29,1200000,2018-06-26,1540000,340000,4015,84.6824408468244
"27 WEST 72ND   STREET, 1515",2007-06-12,1471371,2010-10-18,1575000,103629,1224,84.66421568627452
"100 UNITED NATIONS PLAZA, 16C",2008-06-10,770000,2016-11-07,1030000,260000,3072,84.63541666666667
"230 RIVERSIDE DRIVE, 17E",2007-06-25,773870,2014-10-14,999520,225650,2668,84.57646176911544
"304 WEST 114 STREET, 1A",2009-11-02,314340,2015-10-26,499000,184660,2184,84.55128205128206
"120 RIVERSIDE BOULEVARD, 6N",2005-12-15,840056,2018-08-02,1230000,389944,4613,84.53154129633644
"322 WEST 57TH STREET, 26V",2007-12-26,829873,2015-10-06,1070000,240127,2841,84.52199929602253
"240 RIVERSIDE BOULEVARD, 12N-T",2005-10-27,829000,2013-07-26,1068000,239000,2829,84.48214916931778
"200 CHAMBERS STREET, 20D",2007-05-10,2571081,2011-07-14,2700000,128919,1526,84.48165137614679
"306 EAST 82ND   STREET, 2A",2010-12-09,675000,2016-04-15,840000,165000,1954,84.44216990788127
"301 CATHEDRAL PARKWAY, 18G",2005-01-19,660000,2008-06-16,765000,105000,1244,84.40514469453376
"310 WEST 52ND   STREET, 10C",2007-05-23,877731,2010-03-22,965000,87269,1034,84.39941972920697
"2000 BROADWAY, 9C",2006-06-07,475000,2010-06-28,600000,125000,1482,84.34547908232119
"301 WEST 57 STREET, 44D",2004-04-15,668000,2012-02-24,910000,242000,2871,84.2911877394636
"225 EAST 86TH   STREET, 1006",2010-03-11,487500,2014-05-02,615000,127500,1513,84.26966292134831
"324 PEARL STREET, 2A",2014-12-04,516000,2018-05-15,622000,106000,1258,84.26073131955485
"321 EAST 48TH   STREET, 12A",2008-06-02,880000,2015-11-17,1109500,229500,2724,84.2511013215859
"1628 2 AVENUE, 4N",2004-02-10,215000,2016-08-01,598800,383800,4556,84.24056189640035
"15 BROAD STREET, 2430",2007-04-23,1013158,2013-11-18,1215000,201842,2401,84.06580591420241
"15 BROAD STREET, 2012",2006-06-16,1486645,2014-01-21,1720000,233355,2776,84.06159942363112
"150 NASSAU STREET, 3C",2003-03-19,348365,2013-05-15,660000,311635,3710,83.99865229110512
"393 WEST 49TH STREET, 4NN",2010-03-23,410000,2016-06-01,600000,190000,2262,83.99646330680814
"235 EAST 40TH   STREET, 7I",2010-03-15,395000,2013-03-27,488000,93000,1108,83.93501805054152
"184 THOMPSON STREET, 5S",2007-05-08,636406,2016-10-06,925000,288594,3439,83.91799941843558
"400 CENTRAL PARK WEST, 7F",2007-08-14,532000,2008-10-28,569000,37000,441,83.90022675736961
"305 EAST 108 STREET, 3G",2008-12-09,825000,2016-12-09,1070000,245000,2922,83.8466803559206
"15 EAST 26TH   STREET, 15G",2010-04-12,253500,2018-04-30,500000,246500,2940,83.84353741496598
"210 EAST 47TH STREET, 6H",2010-06-04,583000,2016-06-14,767500,184500,2202,83.7874659400545
"300 RECTOR PLACE, 9D",2011-01-26,380000,2018-04-05,600000,220000,2626,83.77760853008378
"215 WEST 95TH STREET, 9A",2004-12-10,425000,2016-11-15,790000,365000,4358,83.75401560348784
"801 RIVERSIDE DRIVE, 2E",2010-01-14,385000,2017-05-24,610000,225000,2687,83.73650911797544
"300 EAST 93RD   STREET, 3C",2010-10-25,345000,2018-01-04,565000,220000,2628,83.71385083713851
"80 JOHN STREET, 9B",2007-07-09,934753,2018-06-26,1270000,335247,4005,83.70711610486892
"255 HUDSON STREET, 8C",2007-04-24,1170987,2016-12-06,1465000,294013,3514,83.66903813318156
"2360 AMSTERDAM AVENUE, 4B",2011-07-28,228150,2015-07-24,350000,121850,1457,83.63074811256006
"100 RIVERSIDE BOULEVARD, 9J",2008-03-31,982611,2015-09-10,1210000,227389,2719,83.62964325119529
"58 WEST 58TH STREET, 10C",2006-05-16,1200000,2009-08-06,1298500,98500,1178,83.616298811545
"155 EAST 38TH STREET, 14A",2014-02-27,555000,2018-04-02,680000,125000,1495,83.61204013377926
"1474 THIRD AVENUE, 4N",2008-02-12,1832850,2013-10-02,2005003,172153,2059,83.61000485672656
"1 IRVING PLACE, G24C",2007-12-06,945000,2013-07-01,1115000,170000,2034,83.57915437561455
"18 PINE STREET, 1608",2010-01-25,1120075,2018-03-05,1367500,247425,2961,83.5612968591692
"99 BATTERY PLACE, 10-S",2004-02-09,315000,2007-03-22,410000,95000,1137,83.55321020228672
"120 RIVERSIDE BOULEVARD, 7N",2006-02-14,982611,2015-05-18,1265000,282389,3380,83.54704142011835
"372 CENTRAL PARK WEST, 18V",2004-10-13,550000,2014-08-14,850000,300000,3592,83.51893095768374
"153 EAST 87TH STREET, 3A",2006-10-27,925000,2015-12-10,1203128,278128,3331,83.49684779345542
"55 WHITE STREET, 1C",2006-01-31,2599000,2013-07-01,2825000,226000,2708,83.45642540620383
"2056 5 AVENUE, 5-C",2013-08-05,412500,2015-08-24,475000,62500,749,83.44459279038718
"425 CENTRAL PARK WEST, 2J",2007-11-28,436985,2018-07-05,760000,323015,3872,83.42329545454545
"21 SOUTH END AVENUE, 522",2003-01-13,910000,2016-06-29,1320000,410000,4916,83.40113913751017
"261 WEST 28TH STREET, 8A",2007-11-27,1807393,2013-11-25,1990000,182607,2190,83.38219178082191
"45 PARK AVENUE, 705",2007-11-30,890968,2014-09-18,1098000,207032,2484,83.34621578099839
"1 SHERIDAN SQUARE, 3E",2013-07-23,685000,2015-12-16,758000,73000,876,83.33333333333333
"101 WARREN STREET, 9F",2008-07-09,1675021,2018-07-17,1980000,304979,3660,83.3275956284153
"150 NASSAU STREET, 6C",2003-09-08,395460,2012-01-19,650000,254540,3055,83.31914893617021
"90 WILLIAM STREET, 9E",2008-07-10,560037,2015-12-02,785000,224963,2701,83.28878193261755
"372 CENTRAL PARK WEST, 4E",2003-11-07,350000,2015-03-12,695000,345000,4143,83.27299058653149
"120 RIVERSIDE BOULEVARD, 14G",2006-05-02,728048,2014-08-15,980000,251952,3027,83.23488602576809
"5 EAST 22ND   STREET, 11-K",2006-03-19,940000,2013-02-13,1150000,210000,2523,83.23424494649227
"455 CENTRAL PARK WEST, 8",2005-09-28,1400093,2015-08-11,1700000,299907,3604,83.21503884572697
"107 AVENUE A, 4F",2006-03-30,651680,2016-09-19,970000,318320,3826,83.19916361735494
"351 EAST 51 STREET, 10E",2003-05-22,850000,2011-06-16,1095000,245000,2947,83.1353919239905
"2250 BROADWAY, 6E",2004-08-06,610000,2017-04-14,995000,385000,4634,83.08157099697885
"235 WEST END AVENUE, 2C",2007-06-29,644000,2015-06-08,885000,241000,2901,83.07480179248535
"150 NASSAU STREET, 4J",2003-05-02,126750,2013-03-01,425000,298250,3591,83.05485937064884
"845 UNITED NATIONS PLAZA, 16G",2004-08-05,1045000,2014-04-15,1338998,293998,3540,83.05028248587571
"250 EAST 40 STREET, 6A",2003-09-18,415000,2015-09-30,780000,365000,4395,83.04891922639364
"41 WEST 72ND   STREET, 6H",2007-12-04,770000,2013-03-14,930000,160000,1927,83.03061754021796
"72 EAST 3RD   STREET, 4B",2007-01-18,707000,2013-07-30,905000,198000,2385,83.01886792452831
"90 WILLIAM STREET, 2E",2008-09-22,486720,2015-08-06,695000,208280,2509,83.01315265045835
"200 RECTOR PLACE, 32C",2003-05-15,385000,2015-03-30,745000,360000,4337,83.0066866497579
"80 PARK AVENUE, 12H",2004-06-28,625000,2016-11-10,999999,374999,4518,83.00110668437361
"200 CHAMBERS STREET, 19E",2007-05-07,1442350,2013-05-29,1626000,183650,2214,82.94941282746161
"62 WEST 62ND STREET, 14A",2005-02-18,695000,2014-05-19,975000,280000,3377,82.9138288421676
"135 EAST 54TH   STREET, 15E",2009-08-14,832500,2017-07-12,1072000,239500,2889,82.90065766701281
"20 WEST STREET, 27A",2008-07-21,997797,2014-11-26,1190000,192203,2319,82.8818456231134
"101 WARREN STREET, 990",2008-09-19,1445915,2017-02-10,1700000,254085,3066,82.87181996086106
"416 EAST 117 STREET, 5C",2009-09-14,410670,2015-05-26,583000,172330,2080,82.85096153846153
"116 CENTRAL PARK SOUTH, 5E",2004-10-25,435000,2013-07-29,700000,265000,3199,82.83838699593623
"400 EAST 54 STREET, 17D",2005-05-16,570220,2006-08-03,607000,36780,444,82.83783783783784
"455 MAIN STREET, 11N",2006-04-10,334620,2017-11-10,685000,350380,4232,82.79300567107751
"163 ST NICHOLAS AVENUE, 7B",2004-05-18,707684,2013-03-21,975000,267316,3229,82.78600185816042
"111 FULTON STREET, 813",2008-12-10,837510,2015-12-21,1050000,212490,2567,82.7775613556681
"275 GREENWICH STREET, 6CS",2006-04-26,825000,2009-12-16,935000,110000,1330,82.70676691729324
"300 EAST 93RD   STREET, 28C",2011-07-14,395000,2017-08-28,580000,185000,2237,82.70004470272687
"211 EAST 46TH   STREET, 25D",2008-10-23,688011,2013-11-05,840000,151989,1839,82.64763458401305
"45 PARK AVENUE, 1606",2008-02-08,1287812,2010-12-29,1375000,87188,1055,82.64265402843601
"220 RIVERSIDE BOULEVARD, 10B",2004-06-22,795000,2016-03-28,1150000,355000,4297,82.61577845008145
"139 WOOSTER STREET, 5B",2007-08-21,2316518,2013-09-19,2500000,183482,2221,82.61233678523188
"200 CHAMBERS STREET, 27A",2007-08-03,3075115,2011-09-23,3200000,124885,1512,82.59589947089947
"103 NORFOLK STREET, 7C",2007-04-05,860421,2014-08-15,1082500,222079,2689,82.58795091111938
"1641 3 AVENUE, 31C",2003-02-20,316928,2015-03-31,682000,365072,4422,82.558118498417
"166 EAST 63RD STREET, 4J",2007-11-15,1488937,2014-03-18,1680000,191063,2315,82.53261339092873
"254 PARK AVENUE SOUTH, 12G",2010-01-12,590093,2014-09-05,730000,139907,1697,82.44372421921037
"1601 3 AVENUE, 19B",2003-02-20,155447,2013-05-03,462500,307053,3725,82.4303355704698
"80 PARK AVENUE, 11H",2005-01-14,585493,2009-10-09,728000,142507,1729,82.42163100057837
"715 PARK AVENUE, 3E",2007-05-03,1055000,2010-06-17,1149000,94000,1141,82.38387379491674
"11 EAST 36TH STREET, 405",2007-04-23,1107682,2015-09-11,1360000,252318,3063,82.37610186092067
"1 IRVING PLACE, G21D",2006-08-31,885000,2013-06-25,1090000,205000,2490,82.3293172690763
"88 GREENWICH STREET, 524",2010-06-30,500000,2015-09-01,655500,155500,1889,82.31868713605083
"425 FIFTH AVENUE, 32C",2004-10-06,456300,2016-01-12,795000,338700,4115,82.3086269744836
"56 PINE STREET, 3E",2005-11-15,410670,2017-03-03,750000,339330,4126,82.24188075618032
"255 EAST 49TH   STREET, 31C",2007-03-30,785000,2017-10-24,1102500,317500,3861,82.23258223258223
"120 WEST 58TH STREET, 6D",2007-09-17,821500,2015-04-28,1050000,228500,2780,82.19424460431655
"250 EAST 40TH   STREET, 10A",2008-08-28,640000,2016-06-28,875000,235000,2861,82.13911219853198
"342 EAST 110 STREET, 7C",2009-11-24,445000,2017-05-26,670000,225000,2740,82.11678832116789
"15 BROAD STREET, 3114",2006-08-28,1114983,2014-10-30,1360000,245017,2985,82.08274706867671
"352 CATHEDRAL PARKWAY, 10C",2006-02-01,661862,2014-05-14,910000,248138,3024,82.05621693121694
"350 WEST 53RD   STREET, 1JTHJ",2008-09-08,905000,2016-01-12,1125000,220000,2682,82.0283370618941
"200 RECTOR PLACE, 10C",2003-09-08,369000,2016-03-31,745000,376000,4588,81.95292066259809
"401 EAST 84TH STREET, 11C",2004-08-24,699000,2014-07-15,995000,296000,3612,81.94905869324474
"415 EAST 37TH   STREET, 40K",2007-07-12,1650000,2014-03-18,1850000,200000,2441,81.9336337566571
"455 CENTRAL PARK WEST, 21B",2004-10-14,1664838,2013-08-27,1930000,265162,3239,81.86539055263971
"186 WEST 80 STREET, 5J",2004-01-23,335000,2015-02-06,665000,330000,4032,81.8452380952381
"80 ELIZABETH STREET, 2K",2003-08-25,395000,2016-03-11,770000,375000,4582,81.84199039720646
"120 RIVERSIDE BOULEVARD, 4L",2007-11-15,997000,2014-09-03,1200000,203000,2484,81.72302737520128
"15 WILLIAM STREET, 20A",2008-12-19,1603743,2014-09-15,1775000,171257,2096,81.70658396946565
"505 GREENWICH STREET, 8B",2004-12-21,1456097,2010-02-17,1610000,153903,1884,81.68949044585987
"233 EAST 17TH   STREET, 2",2007-05-21,2014098,2015-04-17,2250000,235902,2888,81.68351800554017
"220 RIVERSIDE BOULEVARD, 10W",2005-06-16,567000,2008-07-29,660000,93000,1139,81.6505706760316
"255 HUDSON STREET, 4D",2006-12-01,1185000,2017-06-14,1499000,314000,3848,81.6008316008316
"10 WEST END AVENUE, 10B",2007-07-30,1211717,2018-08-06,1540000,328283,4025,81.56099378881987
"2101 BROADWAY, 10137",2005-05-31,1150000,2005-10-19,1161500,11500,141,81.56028368794327
"80 ELIZABETH STREET, 2Q",2003-03-18,395000,2013-06-14,700000,305000,3741,81.52900294039027
"120 RIVERSIDE BOULEVARD, 12R",2006-03-10,1048797,2016-04-21,1350000,301203,3695,81.51637347767253
"230 RIVERSIDE DRIVE, 17L",2008-06-30,425000,2015-11-20,645000,220000,2699,81.51167098925528
"119 FULTON STREET, 12",2007-01-31,1374637,2014-10-28,1605000,230363,2827,81.48673505482844
"420 CENTRAL PARK WEST, 2H",2006-08-07,500000,2016-09-06,800000,300000,3683,81.45533532446375
"255 EAST 49 STREET, 4A",2005-01-25,570000,2015-06-29,880000,310000,3807,81.42894667717363
"92 WARREN STREET, 5(5W)",2007-03-15,2341975,2011-03-04,2460000,118025,1450,81.39655172413794
"88 GREENWICH STREET, 307",2010-01-07,599000,2016-02-12,780000,181000,2227,81.275258194881
"505 WEST 47TH   STREET, 2G-N",2010-05-24,481650,2015-05-12,629000,147350,1814,81.22932745314223
"220 RIVERSIDE BOULEVARD, 8C",2004-08-13,710000,2015-05-29,1030000,320000,3941,81.19766556711494
"211 EAST 46TH   STREET, 14F",2008-09-18,1170065,2013-08-08,1315000,144935,1785,81.19607843137256
"120 RIVERSIDE BOULEVARD, 15C",2006-02-27,537636,2008-10-07,615000,77364,953,81.1794333683106
"333 EAST 34 STREET, 6G",2004-01-16,390390,2014-12-29,715000,324610,4000,81.1525
"120 RIVERSIDE BOULEVARD, 12W",2006-02-17,866321,2017-05-24,1200000,333679,4114,81.10816723383569
"150 EAST 85TH STREET, 10A",2004-07-26,629000,2016-03-31,975000,346000,4266,81.10642287857478
"350 WEST 42ND   STREET, 23L",2006-12-28,975000,2009-07-10,1050000,75000,925,81.08108108108108
"1760 2 AVENUE, 24A",2003-08-11,510000,2018-06-20,950000,440000,5427,81.07610097659848
"154 ATTORNEY STREET, 405",2006-11-20,794235,2014-08-07,1022500,228265,2817,81.03123890663827
"400 CENTRAL PARK WEST, 3S",2005-02-18,330000,2013-12-02,590000,260000,3209,81.0221252726706
"15 BROAD STREET, 2514",2006-06-30,1028432,2014-10-30,1275000,246568,3044,81.00131406044677
"350 WEST 42ND   STREET, 7F",2007-02-15,710000,2016-06-03,985000,275000,3396,80.97762073027091
"184 THOMPSON STREET, 3P",2007-04-25,471510,2014-08-26,688500,216990,2680,80.96641791044776
"120 RIVERSIDE BOULEVARD, 4P",2005-12-05,626732,2016-09-22,945900,319168,3944,80.92494929006085
"123 WEST 131 STREET, 4",2011-12-08,319000,2017-07-21,485000,166000,2052,80.89668615984405
"35 WOOSTER STREET, 3R",2005-03-16,1425000,2016-03-16,1750000,325000,4018,80.88601294176208
"415 MAIN STREET, 14-A",2009-11-16,764000,2010-04-01,775000,11000,136,80.88235294117646
"255 EAST 49TH STREET, 31C",2005-06-16,599000,2013-06-13,835000,236000,2919,80.84960602946215
"80 JOHN STREET, 7D",2007-04-13,510448,2015-07-27,755000,244552,3027,80.79022134126197
"300 WEST 135TH STREET, 3V",2005-06-23,268666,2011-04-08,439500,170834,2115,80.7725768321513
"505 WEST 47TH   STREET, 1D-S",2010-05-25,399000,2018-01-22,625000,226000,2799,80.74312254376564
"215 WEST 95TH STREET, 14G",2009-02-10,695000,2015-11-23,895000,200000,2477,80.74283407347598
"90 WILLIAM STREET, 4G",2008-07-08,817654,2014-05-14,990000,172346,2136,80.68632958801498
"40 BROAD STREET, 19A",2011-04-29,845147,2018-04-11,1050000,204853,2539,80.68255218589997
"200 RIVERSIDE BOULEVARD, 4E",2003-08-25,563000,2014-09-29,890000,327000,4053,80.68097705403405
"120 RIVERSIDE BOULEVARD, 8T",2006-04-19,1075272,2013-04-01,1280000,204728,2539,80.63332020480505
"159 WEST 53RD   STREET, 28G",2010-01-08,620000,2017-06-29,840000,220000,2729,80.61561011359473
"426 WEST BROADWAY, 2C",2004-08-25,575000,2010-10-06,755000,180000,2233,80.60904612628751
"2 SOUTH END AVENUE, 8T",2011-01-27,420000,2017-01-06,595000,175000,2171,80.60801473975127
"184 THOMPSON STREET, LG",2007-07-10,753505,2010-10-20,850000,96495,1198,80.54674457429049
"18 WEST 48TH   STREET, 23C",2007-07-06,1243283,2015-05-22,1475000,231717,2877,80.54118873826903
"1485 5 AVENUE, 6B",2010-06-07,700000,2012-12-18,774500,74500,925,80.54054054054055
"41 WEST 72ND STREET, 17F",2007-04-25,800000,2015-06-22,1040000,240000,2980,80.53691275167785
"300 WEST 110 STREET, 1F",2003-02-25,136610,2013-01-03,426400,289790,3600,80.49722222222222
"254 PARK AVENUE SOUTH, 9KL",2010-02-25,1364455,2013-01-23,1450000,85545,1063,80.47507055503293
"55 WEST 131 STREET, B-3",2004-07-08,340000,2015-07-30,665000,325000,4039,80.46546174795742
"502 PARK AVENUE, 12H",2004-07-02,794235,2011-03-01,990000,195765,2433,80.46239210850801
"660 RIVERSIDE DRIVE, 3G",2011-06-16,283920,2014-06-10,371519,87599,1090,80.36605504587156
"90 WILLIAM STREET, 2H",2008-10-30,788125,2015-07-16,985000,196875,2450,80.35714285714286
"275 GREENWICH STREET, 10LS",2003-10-29,615000,2013-04-25,893300,278300,3466,80.29428736295442
"382 CENTRAL PARK WEST, 6B",2005-02-15,691500,2014-09-16,972500,281000,3500,80.28571428571429
"88 GREENWICH STREET, 411",2010-06-11,425000,2014-09-15,550000,125000,1557,80.28259473346179
"571 ACADEMY STREET, 1H",2003-05-14,131000,2018-03-21,566500,435500,5425,80.27649769585254
"400 CENTRAL PARK WEST, 14B",2005-02-10,641497,2018-03-09,1024765,383268,4775,80.26554973821989
"300 ALBANY STREET, 3D",2005-06-07,378000,2007-04-05,431500,53500,667,80.20989505247377
"56 EAST 126TH STREET, 3",2007-12-04,517271,2014-07-03,710000,192729,2403,80.20349563046192
"515 EAST 72ND   STREET, 23B",2008-06-02,1425550,2017-10-17,1700000,274450,3424,80.15478971962617
"380 LENOX AVENUE, 3J",2007-05-21,705769,2017-04-07,995000,289231,3609,80.14159046827376
"200 RECTOR PLACE, 5K",2006-08-24,898988,2018-08-21,1250000,351012,4380,80.13972602739726
"66-72 ST NICHOLAS AVENUE, 2B",2006-03-21,425000,2014-04-02,660000,235000,2934,80.09543285616905
"211 EAST 46TH   STREET, 17B",2008-04-17,758280,2015-11-16,980000,221720,2769,80.07222824124233
"372 CENTRAL PARK WEST, 8W",2003-02-05,482000,2012-10-10,765000,283000,3535,80.05657708628006
"845 UNITED NATIONS PLAZA, 11F",2003-01-15,430950,2015-09-01,800000,369050,4612,80.01951431049436
"219 WEST 80TH STREET, 6A",2006-03-28,836200,2017-10-30,1175000,338800,4234,80.0188946622579
"119 FULTON STREET, 3B",2007-01-09,697501,2017-05-04,999000,301499,3768,80.01565817409767
"350 WEST 42ND STREET, 16E",2006-06-15,642515,2018-07-09,995000,352485,4407,79.98298162014976
"39 EAST 29TH STREET, 13D",2008-10-15,962246,2013-07-04,1100000,137754,1723,79.95008705745792
"120 RIVERSIDE BOULEVARD, PH2C",2006-06-05,1420458,2013-04-30,1622000,201542,2521,79.94525981753273
"27 WEST 72ND   STREET, 1207",2008-07-11,1084436,2017-08-16,1350000,265564,3323,79.91694252181763
"1623 3 AVENUE, 23B",2003-02-20,163254,2015-12-11,537000,373746,4677,79.91148171905067
"261 WEST 28TH STREET, 8C",2007-11-29,896060,2016-08-11,1150000,253940,3178,79.9056010069226
"211 EAST 46TH   STREET, 6E",2008-04-17,846183,2013-07-25,999999,153816,1925,79.90441558441559
"75 WALL STREET, 24B",2008-12-01,946972,2018-04-11,1220000,273028,3418,79.87946167349327
"320 EAST 54TH STREET, 8B",2009-08-05,627000,2016-01-15,815000,188000,2354,79.86406117247239
"322 WEST 57TH   STREET, 23U",2008-02-14,865512,2016-09-16,1116000,250488,3137,79.84953777494421
"211 EAST 46TH   STREET, 23J",2009-04-30,631315,2011-11-09,705000,73685,923,79.8320693391116
"155 WEST 68TH   STREET, 18-33",2008-04-30,646000,2015-07-01,855000,209000,2618,79.83193277310924
"300 WEST 53RD   STREET, 4G",2008-04-15,300000,2017-03-16,560000,260000,3257,79.82806263432607
"475 GREENWICH STREET, 3D",2008-06-25,1807393,2010-12-22,1880000,72607,910,79.78791208791209
"237 WEST 115 STREET, 1A",2009-02-12,660000,2012-03-16,750000,90000,1128,79.7872340425532
"60 HENRY STREET, 6B",2005-01-14,220000,2017-05-24,580000,360000,4513,79.7695546199867
"100 RIVERSIDE BOULEVARD, 4M",2008-01-24,1108874,2016-01-25,1342000,233126,2923,79.75573041395826
"342 WEST 85TH   STREET, 1A",2009-06-11,940000,2013-07-25,1060000,120000,1505,79.734219269103
"135 EAST 54TH   STREET, 6M",2010-08-02,648000,2016-06-29,820000,172000,2158,79.70342910101947
"100 RIVERSIDE BOULEVARD, 5A",2008-02-01,928644,2016-01-14,1160000,231356,2904,79.66804407713498
"516 WEST 47TH STREET, S3A",2006-05-03,721837,2014-05-08,955000,233163,2927,79.65937820293816
"300 WEST 135 STREET, 2N",2005-06-06,405409,2014-09-12,675000,269591,3385,79.64283604135893
"30 EAST 37TH   STREET, 10F",2006-12-19,387855,2015-12-11,649000,261145,3279,79.64165904239097
"201 EAST 36TH STREET, 12F",2008-02-22,661000,2016-04-29,899000,238000,2989,79.62529274004685
"305 SECOND AVENUE, 541",2006-11-07,1247356,2016-09-29,1535000,287644,3614,79.59158826784726
"200 CHAMBERS STREET, 2E",2007-02-02,819691,2018-02-12,1140000,320309,4028,79.52060575968223
"200 RIVERSIDE BOULEVARD, 10F",2007-12-08,750000,2015-07-06,970000,220000,2767,79.50849295265631
"422 EAST 72ND   STREET, 34E",2008-11-17,2730000,2014-09-26,2900000,170000,2139,79.47639083683964
"392 CENTRAL PARK WEST, 1E",2003-02-10,253000,2014-10-03,591000,338000,4253,79.47331295556079
"310 WEST 52ND STREET, 15A",2007-07-26,975000,2013-07-24,1149000,174000,2190,79.45205479452055
"120 RIVERSIDE BOULEVARD, 15J",2006-03-14,661292,2012-09-14,850000,188708,2376,79.42255892255892
"100 RIVERSIDE BOULEVARD, 17A",2008-05-22,1109892,2014-06-05,1285000,175108,2205,79.4140589569161
"252 7 AVENUE, 10M",2006-09-29,1155000,2012-12-13,1335000,180000,2267,79.40008822232025
"158 HESTER STREET, 6D",2006-12-07,1316088,2009-06-25,1390000,73912,931,79.38990332975295
"100 RIVERSIDE BOULEVARD, 10H",2008-04-28,1425550,2012-08-13,1550000,124450,1568,79.3686224489796
"30 WEST 90TH STREET, 3A",2009-09-22,650000,2012-08-16,734000,84000,1059,79.3201133144476
"380 LENOX AVENUE, 9E",2008-02-29,863348,2018-07-31,1165000,301652,3805,79.2777923784494
"90 WILLIAM STREET, 7C",2008-07-01,894000,2013-11-20,1050000,156000,1968,79.26829268292683
"255 HUDSON STREET, 4C",2006-09-28,1084436,2017-08-22,1400000,315564,3981,79.26752072343632
"133 SECOND AVENUE, 3",2008-11-10,1088509,2015-12-29,1295000,206491,2605,79.26717850287908
"2101 BROADWAY, 14157",2005-10-03,815000,2007-10-30,875000,60000,757,79.26023778071334
"235 EAST 40TH   STREET, 35F",2010-06-03,695000,2015-09-28,849000,154000,1943,79.25887802367473
"150 NASSAU STREET, 3J",2003-03-20,618808,2012-10-03,895000,276192,3485,79.25164992826399
"71 PARK AVENUE, 4A",2004-12-21,1150000,2006-09-13,1200000,50000,631,79.23930269413628
"450 EAST 83RD STREET, 17A",2006-10-18,2204511,2013-04-12,2392000,187489,2368,79.17609797297297
"56 PINE STREET, 8A",2005-10-06,451230,2014-06-02,701500,250270,3161,79.1743119266055
"71 NASSAU STREET, 15B",2008-12-18,732500,2018-01-16,995000,262500,3316,79.16164053075995
"455 MAIN STREET, PH1G",2006-04-21,829873,2010-06-17,950000,120127,1518,79.13504611330698
"56 PINE STREET, 8D",2005-10-17,415740,2015-04-14,690000,274260,3466,79.12867859203693
"247 WEST 46TH   STREET, 3305",2010-10-28,1705059,2012-05-18,1750000,44941,568,79.12147887323944
"186 WEST 80TH STREET, 4H",2011-09-14,425000,2016-01-11,550000,125000,1580,79.11392405063292
"333 WEST 56TH STREET, 2D",2010-02-11,540000,2014-04-08,660000,120000,1517,79.10349373764008
"154 ATTORNEY STREET, 605",2006-11-28,906242,2015-05-07,1150000,243758,3082,79.09085009733938
"392 CENTRAL PARK WEST, 8J",2006-06-28,711756,2014-05-23,940000,228244,2886,79.08662508662509
"15 BROAD STREET, 2830",2007-02-27,794235,2011-05-04,915000,120765,1527,79.08644400785855
"295 3 AVENUE, 3A",2005-04-08,646000,2015-09-10,946972,300972,3807,79.05752561071711
"350 EAST 82ND STREET, 3K",2010-04-26,615000,2015-11-10,775000,160000,2024,79.05138339920948
"322 WEST 57TH   STREET, 27G",2008-02-12,1242265,2017-09-01,1518000,275735,3489,79.02980796789912
"300 EAST 33RD   STREET, 1-F",2009-12-29,445000,2014-07-01,575000,130000,1645,79.0273556231003
"120 RIVERSIDE BOULEVARD, 6U",2005-12-16,399110,2014-08-26,650000,250890,3175,79.02047244094489
"1600 BROADWAY, PH3C",2006-08-02,2825643,2016-02-03,3100000,274357,3472,79.0198732718894
"169 EAST 102 STREET, 4C",2003-02-21,187500,2016-05-25,570000,382500,4842,78.99628252788104
"100 RIVERSIDE BOULEVARD, 7C",2008-03-19,1369546,2013-08-09,1525000,155454,1969,78.95073641442356
"1619 3 AVENUE, 7D",2003-02-20,238849,2013-11-06,547500,308651,3912,78.89851738241309
"381 BROOME STREET, 2F",2004-02-05,491790,2011-04-28,700000,208210,2639,78.89730958696477
"120 WEST 72ND STREET, 6B",2008-03-13,1985587,2010-06-08,2050000,64413,817,78.84088127294982
"443 WEST 151 STREET, 3B",2010-06-14,265000,2015-11-02,420000,155000,1967,78.8002033553635
"44 EAST 12TH STREET, 2C",2005-11-02,865000,2018-05-09,1225000,360000,4571,78.75738350470357
"10 WEST END AVENUE, 22D",2007-10-11,1565477,2013-11-04,1740000,174523,2216,78.75586642599278
"184 THOMPSON ST, 2B",2007-04-13,491790,2013-10-28,680000,188210,2390,78.7489539748954
"1623 3 AVENUE, 36B",2003-02-20,184548,2013-03-28,475000,290452,3689,78.73461642721605
"400 EAST 70TH STREET, 207",2004-07-27,420000,2013-06-11,675000,255000,3241,78.67941993211971
"215 EAST 80TH STREET, 5A",2005-06-10,675000,2016-09-19,999000,324000,4119,78.6598689002185
"130 WEST 19TH STREET, THD",2006-11-14,2039554,2018-07-19,2375000,335446,4265,78.65087924970692
"200 CHAMBERS STREET, 10C",2007-04-11,2011043,2011-03-30,2125000,113957,1449,78.64527260179435
"150 NASSAU STREET, 3A",2003-03-24,312567,2011-06-30,550000,237433,3020,78.6201986754967
"56 PINE STREET, 7D",2005-08-18,385320,2013-12-23,625000,239680,3049,78.60938012463103
"310 WEST 52ND   STREET, 24C",2007-06-21,834965,2012-05-07,975000,140035,1782,78.58305274971941
"464 WEST 44TH   STREET, 6F",2008-02-22,1344090,2014-08-15,1530000,185910,2366,78.57565511411666
"230 RIVERSIDE DRIVE, 15G",2008-06-30,425000,2013-11-11,579000,154000,1960,78.57142857142857
"2019 1 AVENUE, 6D",2013-05-31,397000,2018-01-31,531000,134000,1706,78.54630715123095
"150 NASSAU STREET, 8F",2003-03-19,460356,2014-04-15,777777,317421,4045,78.47243510506799
"15 BROAD STREET, 2604",2006-09-08,1420458,2013-12-31,1630000,209542,2671,78.45076750280793
"340 EAST 23RD STREET, 3F",2008-04-10,656771,2018-06-22,949000,292229,3725,78.45073825503356
"230 RIVERSIDE DRIVE, 12H",2008-06-30,167000,2013-06-27,310000,143000,1823,78.44212835984641
"45 CHRISTOPHER STREET, 6E",2016-06-24,3250000,2018-07-31,3310125,60125,767,78.38983050847457
"690 RIVERSIDE DRIVE, 3C",2008-05-21,529490,2016-08-12,765000,235510,3005,78.37271214642263
"350 WEST 42ND STREET, 6B",2006-04-24,664917,2014-03-05,890000,225083,2872,78.37151810584959
"80 JOHN STREET, 9E",2007-02-27,541454,2017-01-23,825000,283546,3618,78.37092316196794
"68 BRADHURST AVENUE, 6-Q",2007-08-20,312447,2018-03-16,615000,302553,3861,78.36130536130536
"305 EAST 4TH STREET, 2",2007-06-19,730000,2018-08-24,1050000,320000,4084,78.35455435847209
"16 WEST 19TH   STREET, 9-D",2008-02-15,575311,2014-10-03,765000,189689,2422,78.31915772089182
"1641 3 AVENUE, 11G",2003-02-20,247366,2011-10-18,495000,247634,3162,78.3156230234029
"201 WEST 74TH STREET, 11F",2006-09-18,700000,2013-11-19,905000,205000,2619,78.27415043909889
"275 GREENWICH STREET, 6BS",2004-09-22,600000,2012-01-27,810000,210000,2683,78.27059262020127
"220 RIVERSIDE BOULEVARD, 41B",2005-06-10,2150000,2017-09-08,2500000,350000,4473,78.24726134585289
"45 PARK AVENUE, 1404",2008-01-18,1282282,2013-12-02,1450000,167718,2145,78.19020979020979
"311 GREENWICH STREET, 3J",2004-06-04,360000,2015-08-20,680000,320000,4094,78.16316560820714
"220 EAST 65TH   STREET, 15J",2008-08-15,840000,2015-06-15,1035000,195000,2495,78.15631262525051
"300 ALBANY STREET, 7A",2003-05-30,222500,2004-01-09,240000,17500,224,78.125
"10 WEST END AVENUE, 4F",2007-07-06,715046,2014-07-10,915000,199954,2561,78.07653260445139
"124 WEST 93RD STREET, 9F",2005-01-12,650000,2008-07-16,750000,100000,1281,78.06401249024199
"309 WEST 118 STREET, 4N",2005-03-08,446160,2013-04-03,676250,230090,2948,78.0495251017639
"100 11TH   AVENUE, 3A",2011-05-26,505995,2016-06-15,650000,144005,1847,77.96697347049269
"2 SOUTH END AVENUE, 9K",2003-01-07,658000,2013-04-10,950000,292000,3746,77.94981313400962
"251 WEST 89TH STREET, 8C",2006-06-15,1325000,2017-06-06,1637500,312500,4009,77.94961336991769
"62 WEST 62ND   STREET, 4B",2007-01-02,1150000,2010-07-08,1250000,100000,1283,77.9423226812159
"1175 YORK AVENUE, 1D",2011-05-03,300000,2017-02-17,465000,165000,2117,77.94048181388757
"230 RIVERSIDE DRIVE, 9G",2008-06-30,425000,2013-07-09,568000,143000,1835,77.9291553133515
"85 WEST BROADWAY, 10E",2010-03-10,834965,2011-09-07,877500,42535,546,77.90293040293041
"154 ATTORNEY STREET, 205",2006-11-22,763687,2017-04-24,1060000,296313,3806,77.85417761429322
"100 UNITED NATIONS PLAZA, 10B",2007-02-28,1360000,2013-11-05,1550000,190000,2442,77.8050778050778
"177 EAST 77TH STREET, 3E",2010-07-15,1595000,2013-03-05,1670000,75000,964,77.80082987551867
"88 GREENWICH STREET, 302",2009-11-19,590000,2016-05-24,775000,185000,2378,77.79646761984861
"415 EAST 54TH   STREET, 11E",2009-10-19,925000,2016-08-30,1120000,195000,2507,77.78220981252493
"120 RIVERSIDE BOULEVARD, 3G",2006-01-13,652005,2013-09-17,870000,217995,2804,77.74429386590585
"150 NASSAU STREET, 9A",2003-03-31,370009,2010-10-27,585000,214991,2767,77.6982291290206
"408 EAST 79TH   STREET, 8B",2007-12-10,2622500,2015-12-16,2850000,227500,2928,77.69808743169399
"100 RIVERSIDE BOULEVARD, 5F",2008-08-05,2138325,2014-04-17,2300000,161675,2081,77.69101393560788
"425 5 AVENUE, 21E",2004-06-24,595676,2018-05-18,990000,394324,5076,77.68400315208825
"310 WEST 52ND   STREET, 20H",2007-03-21,1532466,2011-10-21,1662500,130034,1675,77.63223880597015
"75 WALL STREET, 27R",2009-07-24,987702,2016-05-06,1180000,192298,2478,77.60209846650524
"350 WEST 50TH STREET, 6O",2006-06-14,451230,2007-06-20,480000,28770,371,77.54716981132076
"120 RIVERSIDE BOULEVARD, 7H",2006-05-15,886610,2013-11-26,1100000,213390,2752,77.53997093023256
"157 EAST 32ND STREET, 14B",2008-06-25,1040000,2018-05-16,1320000,280000,3612,77.51937984496124
"725 RIVERSIDE DRIVE, 4F",2010-05-26,248430,2013-07-12,337000,88570,1143,77.48906386701663
"71 NASSAU ST, 4D",2006-05-15,733140,2016-07-05,1020000,286860,3704,77.44600431965442
"304 EAST 65TH STREET, 36A",2010-02-01,975000,2017-02-27,1175000,200000,2583,77.42934572202864
"38 STUYVESANT STREET, 10",2008-12-31,1170000,2013-08-06,1300000,130000,1679,77.42703990470518
"118 WEST 112 STREET, 5D",2010-12-08,441090,2013-05-16,510000,68910,890,77.42696629213484
"1400 5 AVENUE, 5L",2007-06-27,630000,2018-05-18,938000,308000,3978,77.42584213172448
"300 WEST 135 STREET, 12C",2005-06-27,467765,2014-05-30,720000,252235,3259,77.39644062595889
"571 ACADEMY STREET, 2H",2005-01-31,155000,2015-03-23,441500,286500,3703,77.36970024304618
"99 BATTERY PLACE, 18-B",2003-01-27,315000,2004-02-19,345000,30000,388,77.31958762886597
"352 WEST 117TH STREET, 4F",2011-11-21,527500,2012-09-07,550000,22500,291,77.31958762886597
"181 EAST 90TH STREET, 18C",2009-08-27,3300000,2012-04-23,3375000,75000,970,77.31958762886597
"250 EAST 54TH STREET, 8A",2011-05-25,1500000,2017-06-01,1670000,170000,2199,77.30786721236926
"21 SOUTH END AVENUE, 738",2004-10-18,360000,2015-12-15,675000,315000,4075,77.30061349693251
"400 CENTRAL PARK WEST, 1T",2004-11-18,306228,2017-12-11,675000,368772,4771,77.29448752881996
"1965 BROADWAY, 12K",2005-03-08,915000,2008-02-28,999000,84000,1087,77.27690892364305
"220 RIVERSIDE BOULEVARD, 5C",2004-08-26,725000,2015-06-19,1030000,305000,3949,77.23474297290453
"93 WORTH STREET, 802",2014-01-23,3487506,2018-01-19,3600000,112494,1457,77.20933424845573
"90 WILLIAM STREET, 8B",2008-07-02,1255502,2015-05-27,1450000,194498,2520,77.18174603174603
"75 WALL STREET, 25K",2010-03-30,999921,2015-07-27,1150000,150079,1945,77.16143958868895
"80 ELIZABETH STREET, 6K",2006-08-25,702500,2014-07-18,925000,222500,2884,77.1497919556172
"153 EAST 87TH STREET, 7C",2005-03-16,610000,2006-03-27,639000,29000,376,77.12765957446808
"250 EAST 53RD STREET, 3002",2008-04-30,2007857,2018-07-11,2295000,287143,3724,77.10606874328678
"52 EAST END AVENUE, 9C",2004-05-19,600000,2014-08-11,888000,288000,3736,77.08779443254818
"825 WEST END AVENUE, 10-G",2006-06-22,1300000,2013-07-30,1500000,200000,2595,77.07129094412332
"90 WILLIAM STREET, 8F",2008-07-21,690373,2015-12-21,899000,208627,2709,77.0125507567368
"555 WEST 149 STREET, 4",2003-09-15,246755,2009-09-09,415000,168245,2186,76.9647758462946
"725 RIVERSIDE DRIVE, 8E",2011-06-10,250000,2012-09-07,285000,35000,455,76.92307692307692
"181 HUDSON STREET, 5C",2006-07-17,1565000,2008-09-04,1625000,60000,780,76.92307692307692
"40 BROAD STREET, 20C",2010-02-23,529490,2015-04-30,675000,145510,1892,76.90803382663847
"392 CENTRAL PARK WEST, 15B",2003-01-27,495000,2011-06-10,730000,235000,3056,76.8979057591623
"630 FIRST AVENUE, 3H",2009-09-15,555000,2017-03-09,765000,210000,2732,76.86676427525622
"376 BROADWAY, 23A",2010-03-22,550000,2013-08-09,645000,95000,1236,76.86084142394822
"70 BATTERY PLACE, 7F",2009-12-14,585493,2014-05-22,710000,124507,1620,76.85617283950617
"100 CENTRAL PARK SOUTH, 3E",2006-07-19,862500,2017-02-23,1160000,297500,3872,76.83367768595042
"120 RIVERSIDE BOULEVARD, 14V",2006-03-07,625612,2010-05-07,742500,116888,1522,76.79894875164257
"310 WEST 52ND   STREET, 17J",2007-03-09,1170987,2018-03-15,1480000,309013,4024,76.79249502982107
"124 WEST 93RD   STREET, 9D",2010-06-21,595000,2018-04-25,815000,220000,2865,76.78883071553228
"393 WEST 49TH   STREET, 2N",2009-11-13,360000,2016-08-24,550000,190000,2476,76.73667205169629
"255 HUDSON STREET, 5D",2007-11-08,1232082,2015-10-23,1455000,222918,2906,76.7095664143152
"20 WEST STREET, 19A",2006-05-26,407426,2008-08-19,470000,62574,816,76.68382352941177
"170 JOHN STREET, 2B",2004-07-01,425000,2014-04-30,700000,275000,3590,76.6016713091922
"325 5TH AVENUE, 22D",2006-11-16,1145531,2018-04-18,1465000,319469,4171,76.5929033804843
"107 AVENUE A, 5R",2006-03-21,585493,2013-11-20,800000,214507,2801,76.58229203855765
"157 EAST 72ND   STREET, 15J",2009-06-09,545000,2016-01-21,730000,185000,2417,76.54116673562267
"630 1 AVENUE, 18C",2007-07-27,1050000,2016-04-05,1293000,243000,3175,76.53543307086615
"401 EAST 60TH STREET, 37B",2005-11-07,2106000,2016-05-16,2400000,294000,3843,76.50273224043715
"668 RIVERSIDE DRIVE, 1J",2010-01-29,354900,2017-07-28,564250,209350,2737,76.48885641213008
"421 WEST 54TH   STREET, 4E",2008-02-20,1055000,2013-04-30,1200000,145000,1896,76.47679324894514
"68 BRADHURST AVENUE, 5-A",2007-08-01,455034,2016-05-09,700000,244966,3204,76.45630461922596
"106 CENTRAL PARK SOUTH, 9M",2009-07-02,475000,2012-03-09,550000,75000,981,76.4525993883792
"211 EAST 46TH   STREET, 21A",2008-07-07,690108,2017-02-08,930000,239892,3138,76.44741873804972
"269 BROADWAY, 12E",2005-06-23,870603,2008-07-01,955000,84397,1104,76.4465579710145
"529 WEST 147 STREET, 5B",2006-01-10,375180,2016-10-06,675000,299820,3922,76.44569097399287
"77 WEST 55TH   STREET, 8B",2008-09-17,1425000,2016-06-01,1640000,215000,2814,76.40369580668089
"106 CENTRAL PARK SOUTH, 18O",2006-10-10,470000,2017-03-03,760000,290000,3797,76.37608638398736
"408 EAST 79TH STREET, 5D",2005-12-14,911741,2016-02-10,1195000,283259,3710,76.35013477088948
"51 ST NICHOLAS AVENUE, 3A",2009-09-23,999000,2012-03-15,1068000,69000,904,76.32743362831859
"340 EAST 23RD STREET, 2G",2008-02-26,423852,2016-04-08,650000,226148,2964,76.29824561403508
"90 WILLIAM STREET, 9A",2008-08-21,1156732,2014-02-20,1310000,153268,2009,76.2906918865107
"333 RECTOR PLACE, PH3W",2013-01-18,625657,2017-07-06,750000,124343,1630,76.2840490797546
"1 IRVING PLACE, V7C",2005-10-03,795000,2018-07-02,1150000,355000,4655,76.26208378088077
"121 EAST 23RD STREET, 7G",2010-06-03,460000,2017-01-24,645000,185000,2427,76.22579316028018
"360 WEST 28TH STREET, 6B",2007-12-21,722000,2016-02-29,950000,228000,2992,76.20320855614973
"1 IRVING PLACE, U21G",2006-08-15,659900,2013-08-19,855000,195100,2561,76.1811792268645
"120 RIVERSIDE BOULEVARD, 14P",2006-02-24,738740,2013-09-30,950000,211260,2775,76.12972972972973
"210 EAST 47 STREET, 8J",2004-11-18,410000,2014-11-18,688000,278000,3652,76.12267250821468
"322 WEST 57TH   STREET, 27P2",2008-02-19,1425550,2018-01-03,1700000,274450,3606,76.10926234054354
"505 WEST 47TH   STREET, 2D-S",2010-06-25,478608,2014-04-23,585000,106392,1398,76.1030042918455
"140 7 AVENUE, 3S",2003-09-03,340000,2013-09-30,620000,280000,3680,76.08695652173913
"120 RIVERSIDE BOULEVARD, 15V",2006-07-05,712775,2014-04-29,930000,217225,2855,76.08581436077058
"235 WEST END AVENUE, 5C",2004-05-21,586000,2015-09-08,900000,314000,4127,76.08432275260479
"1601 3 AVENUE, 24B",2003-02-20,162545,2011-09-09,400000,237455,3123,76.03426192763368
"100 RIVERSIDE BOULEVARD, 18A",2008-06-05,1140440,2015-12-23,1350000,209560,2757,76.01015596663039
"235 WEST END AVENUE, 11F",2006-08-11,950000,2016-07-07,1225000,275000,3618,76.00884466556109
"280 RECTOR PLACE, 3D",2008-08-01,395460,2016-02-18,605000,209540,2757,76.00290170475154
"161 EAST 110 STREET, 2G",2009-10-16,395460,2018-01-24,625000,229540,3022,75.95632031767042
"80 JOHN STREET, 2B",2007-04-26,843111,2013-09-11,1020000,176889,2330,75.91802575107296
"403 EAST 62ND STREET, 3B",2009-02-11,460000,2015-08-10,640000,180000,2371,75.91733445803459
"301 EAST 79 STREET, 9 C",2004-05-19,539000,2015-06-03,845000,306000,4032,75.89285714285714
"426 WEST BROADWAY, 4D",2004-07-29,716000,2009-12-14,865000,149000,1964,75.86558044806517
"45 PARK AVENUE, 904",2008-03-07,1206626,2014-01-24,1369500,162874,2149,75.79060027919962
"18 EAST 12TH STREET, 6C",2006-04-06,999000,2010-03-08,1107500,108500,1432,75.76815642458101
"210 EAST 47TH   STREET, 7D",2009-07-01,580000,2016-06-09,772000,192000,2535,75.7396449704142
"1400 FIFTH AVENUE, 6H",2004-12-21,307150,2015-12-15,610931,303781,4011,75.73697332336076
"100 RIVERSIDE BOULEVARD, 21A T",2008-08-07,1990678,2017-12-22,2250000,259322,3424,75.73656542056075
"100 RIVERSIDE BOULEVARD, 12N",2008-05-12,1996279,2013-12-02,2150000,153721,2030,75.72463054187192
"230 RIVERSIDE DRIVE, 14J",2006-12-29,301665,2016-07-07,565000,263335,3478,75.71449108683152
"1760 SECOND AVENUE, 23B",2007-06-28,905000,2014-07-18,1100000,195000,2577,75.66938300349243
"150 EAST 56TH   STREET, 2D",2009-11-10,562500,2014-04-18,685000,122500,1620,75.61728395061728
"404 EAST 76TH STREET, 5J",2004-11-05,645000,2015-11-24,950000,305000,4036,75.56987115956393
"40 SUTTON PLACE, 5A/J",2003-03-06,705000,2013-04-28,985000,280000,3706,75.55315704263357
"340 EAST 23RD STREET, 10A",2008-02-15,753505,2013-06-07,900000,146495,1939,75.55183084063951
"1438 THIRD AVENUE, 24A",2007-12-06,1013158,2017-10-13,1285000,271842,3599,75.53264795776605
"211 EAST 46TH   STREET, 11G",2008-04-28,885266,2011-06-27,972500,87234,1155,75.52727272727273
"425 FIFTH AVENUE, 31C",2004-08-27,461370,2016-05-25,785000,323630,4289,75.45581720680812
"321 EAST 48TH STREET, 7K",2005-07-22,380000,2008-04-11,455000,75000,994,75.45271629778672
"2 SOUTH END AVENUE, 9H",2006-07-21,525000,2017-06-09,825000,300000,3976,75.45271629778672
"45 WEST 67 STREET, 14J",2003-11-26,190637,2004-03-05,198179,7542,100,75.42
"309 WEST 118 STREET, 4D",2005-03-17,395460,2012-08-20,600000,204540,2713,75.39255436785847
"99 JOHN STREET, 501",2014-07-15,789143,2016-07-25,845000,55857,741,75.38056680161944
"70 BATTERY PLACE, 17A",2008-12-22,990757,2014-12-10,1155000,164243,2179,75.37540156034878
"65 COOPER SQUARE, 3B",2004-11-24,649000,2013-06-25,885000,236000,3135,75.27910685805422
"18 ELDRIDGE STREET, 5A",2008-05-27,425880,2014-09-26,600000,174120,2313,75.27885862516213
"40 SUTTON PLACE, 9C",2010-04-19,335000,2017-07-28,535000,200000,2657,75.27286413248024
"845 UNITED NATIONS PLAZA, 82C",2008-01-16,5770000,2010-12-14,5850000,80000,1063,75.25870178739417
"106 CENTRAL PARK SOUTH, 7F",2006-04-10,735000,2015-09-28,995000,260000,3458,75.18796992481202
"571 ACADEMY STREET, 2G",2012-08-20,196365,2017-04-27,325000,128635,1711,75.18118059614261
"450 EAST 83RD STREET, 12B",2006-06-09,1741207,2007-11-07,1780000,38793,516,75.18023255813954
"475 GREENWICH STREET, 3C",2008-06-26,997885,2012-07-27,1110000,112115,1492,75.1441018766756
"80 JOHN STREET, 9D",2007-04-30,551178,2017-09-08,835500,284322,3784,75.13794926004228
"30 EAST 37TH   STREET, 8E",2007-01-30,382785,2016-11-22,652000,269215,3584,75.11579241071429
"240 EAST 46 STREET, 6H",2004-01-14,220000,2010-06-01,395000,175000,2330,75.10729613733906
"295 3 AVENUE, 1C",2006-12-14,275000,2015-02-26,500000,225000,2996,75.10013351134846
"235 WEST END AVENUE, 11A",2006-09-25,675000,2015-02-13,905000,230000,3063,75.08978126020241
"301 WEST 57TH   STREET, 12F",2007-03-23,632000,2017-11-28,925000,293000,3903,75.07045862157315
"467 CENTRAL PARK WEST, 4E",2006-09-07,560037,2015-06-09,800000,239963,3197,75.0588051298092
"303 GREENWICH STREET, 8C",2007-10-25,525000,2014-11-10,718000,193000,2573,75.00971628449281
"80 ELIZABETH STREET, 3D",2012-03-08,300000,2017-08-29,450000,150000,2000,75.0
"340 EAST 23RD STREET, 3A",2008-02-21,620725,2012-09-04,745000,124275,1657,75.0
"400 EAST 67TH STREET, 7B",2008-12-16,1975405,2016-12-22,2195000,219595,2928,74.99829234972678
"20 CLINTON STREET, 6G",2007-03-09,755000,2017-12-15,1050000,295000,3934,74.9872902897814
"211 EAST 46TH   STREET, 25J",2008-08-28,765357,2013-07-16,899000,133643,1783,74.95401009534493
"222 WEST 14TH STREET, 9D",2007-08-13,540000,2014-12-04,740000,200000,2670,74.90636704119851
"120 RIVERSIDE BOULEVARD, 11G",2006-02-06,596287,2018-06-25,935000,338713,4522,74.90336134453781
"90 WILLIAM STREET, 3H",2008-08-13,798308,2014-10-20,967500,169192,2259,74.89685701637893
"301 EAST 79TH   STREET, 8 N",2008-04-11,640000,2016-09-09,870000,230000,3073,74.84542792059877
"45 PARK AVENUE, 901",2007-11-14,2123051,2011-12-19,2235000,111949,1496,74.8322192513369
"220 RIVERSIDE BOULEVARD, 9U",2005-06-24,795000,2016-08-22,1100000,305000,4077,74.80990924699535
"250 WEST 90TH STREET, 10A",2005-07-27,1325000,2008-04-25,1400000,75000,1003,74.77567298105683
"324 PEARL STREET, 2J",2003-05-16,365040,2009-12-18,545000,179960,2408,74.734219269103
"199 WEST 134 STREET, 3A",2004-05-25,121423,2016-04-04,445000,323577,4332,74.69459833795014
"80 ELIZABETH STREET, 6D",2005-11-03,310000,2014-09-29,552800,242800,3252,74.66174661746618
"117 EAST 57TH STREET, 43F",2006-05-25,525000,2015-09-18,779000,254000,3403,74.64002350866882
"210 BENNETT AVENUE, 4D",2011-09-21,342380,2016-08-02,475000,132620,1777,74.63140123804165
"280 RECTOR PLACE, 8B",2003-08-29,277000,2016-12-22,640000,363000,4864,74.62993421052632
"421 EAST 13TH   STREET, 4N",2008-04-25,784052,2014-01-14,940000,155948,2090,74.61626794258373
"150 NASSAU STREET, 8C",2003-03-14,395359,2012-11-28,660000,264641,3547,74.60981110797857
"160 CENTRAL PARK SOUTH, 420",2006-02-06,720000,2013-06-12,920000,200000,2683,74.54342154304882
"660 RIVERSIDE DRIVE, 1E",2008-04-21,171200,2015-04-17,361380,190180,2552,74.52194357366771
"505 WEST 47TH   STREET, 6D-S",2010-08-24,499000,2016-12-05,670000,171000,2295,74.50980392156863
"20 WEST 64TH STREET, 29R",2006-09-14,1630000,2018-06-20,1950000,320000,4297,74.47056085641145
"170 WEST 23RD STREET, 4B",2007-03-09,585000,2013-04-22,751500,166500,2236,74.46332737030411
"330 SPRING STREET, 10A",2007-01-30,2902012,2014-05-12,3100000,197988,2659,74.45957126739376
"157 EAST 32 STREET, 6D",2003-01-21,279000,2011-03-09,500000,221000,2969,74.43583698214887
"400 CENTRAL PARK WEST, 6Y",2003-08-22,357942,2012-11-29,610000,252058,3387,74.41925007381164
"333 EAST 34 STREET, 5L",2006-08-04,967337,2013-04-24,1150000,182663,2455,74.40448065173116
"130 FULTON STREET, 6A",2006-06-21,1517192,2013-07-26,1710000,192808,2592,74.3858024691358
"400 CENTRAL PARK WEST, 19G",2008-09-15,585000,2015-11-20,780000,195000,2622,74.37070938215103
"88 GREENWICH STREET, 1611",2011-03-28,790000,2017-06-30,960000,170000,2286,74.36570428696413
"220 RIVERSIDE BOULEVARD, 10K",2004-05-12,1125000,2013-01-07,1360000,235000,3162,74.32005060088551
"394 MANHATTAN AVENUE, 3",2007-05-01,813581,2014-04-23,1003000,189419,2549,74.31110239309533
"107 AVENUE A, 3F",2006-02-01,655000,2011-03-31,795000,140000,1884,74.3099787685775
"80 JOHN STREET, 2E",2007-04-18,503705,2017-10-02,787500,283795,3820,74.29188481675392
"400 EAST 14TH   STREET, 3B",2008-10-10,477500,2018-01-30,730000,252500,3399,74.28655486907914
"253 WEST 73RD STREET, 7O",2004-12-17,535000,2009-01-07,645000,110000,1482,74.22402159244264
"340 WEST 57TH   STREET, 8J",2008-02-27,995000,2017-07-25,1250000,255000,3436,74.21420256111757
"200 CHAMBERS STREET, 12F",2007-04-23,967337,2012-03-15,1100000,132663,1788,74.19630872483222
"1400 FIFTH AVENUE, 8L",2005-04-14,442000,2010-05-19,580000,138000,1861,74.15368081676517
"255 HUDSON STREET, 5E",2006-09-13,1313542,2013-08-02,1500000,186458,2515,74.13836978131212
"595 WEST END AVENUE, 16D",2008-11-20,860421,2014-12-19,1025000,164579,2220,74.13468468468469
"105 NORFOLK STREET, 7A",2007-03-06,896060,2014-09-16,1100000,203940,2751,74.1330425299891
"372 CENTRAL PARK WEST, 19T",2004-04-05,377000,2011-03-16,565000,188000,2536,74.13249211356467
"303 EAST 33RD   STREET, 5J",2010-08-24,580402,2016-03-03,730000,149598,2018,74.13181367690783
"80 JOHN STREET, 11A",2007-01-22,597712,2016-05-18,850000,252288,3404,74.11515863689776
"230 RIVERSIDE DRIVE, 11O",2007-03-15,707683,2017-10-25,995000,287317,3877,74.10807325251483
"261 WEST 28TH STREET, 6B",2007-11-29,1603743,2017-05-18,1860000,256257,3458,74.10555234239445
"90 WILLIAM STREET, 3B",2008-07-25,1233119,2014-09-24,1400000,166881,2252,74.10346358792185
"235 WEST END AVENUE, 3G",2003-10-21,445000,2017-02-10,805000,360000,4861,74.05883563052869
"99 JOHN STREET, 214",2012-12-07,440000,2017-12-04,575000,135000,1823,74.05375754251234
"30 EAST 85TH   STREET, 5G",2008-01-10,4095000,2015-08-12,4300000,205000,2771,73.98051245037892
"247 WEST 46TH   STREET, 2204",2008-10-23,1333907,2016-06-10,1540000,206093,2787,73.94797273053463
"322 WEST 57TH   STREET, 39A",2008-08-07,941882,2015-05-20,1125000,183118,2477,73.92733144933388
"350 WEST 42ND STREET, 6D",2006-04-27,639461,2018-03-13,960000,320539,4338,73.89096357768557
"184 THOMPSON STREET, MA",2007-09-26,822436,2014-01-07,992000,169564,2295,73.88409586056645
"350 EAST 82ND STREET, 4L",2006-10-11,623169,2008-11-19,680000,56831,770,73.80649350649351
"27 WEST 72ND STREET, 301",2008-04-29,985000,2018-07-12,1260000,275000,3726,73.80568974771873
"400 CENTRAL PARK WEST, 10N",2005-07-20,725000,2011-06-28,885000,160000,2169,73.76671277086214
"380 LENOX AVENUE, 6E",2007-08-30,795518,2015-10-23,1015000,219482,2976,73.75067204301075
"13 EAST 30TH   STREET, 6",2007-03-30,1183206,2012-04-27,1320000,136794,1855,73.7433962264151
"88 GREENWICH STREET, 1401",2014-01-21,625000,2016-04-14,685000,60000,814,73.71007371007371
"2 SOUTH END AVENUE, 3U",2010-02-12,380000,2015-11-16,535000,155000,2103,73.70423204945317
"404 EAST 79TH STREET, 24A",2008-05-23,669000,2018-06-19,940000,271000,3679,73.66132101114434
"158 HESTER STREET, 3H",2006-08-22,814600,2012-01-17,960000,145400,1974,73.65754812563323
"56 PINE STREET, 7G",2005-08-18,441090,2012-06-20,625000,183910,2498,73.62289831865492
"88 GREENWICH STREET, 403",2010-08-31,507000,2017-04-14,685000,178000,2418,73.61455748552522
"421 HUDSON STREET, M-9",2003-02-10,853000,2012-04-19,1100000,247000,3356,73.59952324195471
"105 NORFOLK STREET, 6C",2007-05-30,876500,2016-11-04,1130000,253500,3446,73.56355194428323
"350 WEST 42ND STREET, 10E",2006-05-31,567667,2010-10-12,685000,117333,1595,73.56300940438871
"150 WEST 56TH STREET, 3409",2005-04-08,520000,2015-07-08,795000,275000,3743,73.47047822602191
"1235 PARK AVENUE, 5D",2004-08-11,868150,2013-04-02,1100000,231850,3156,73.46324461343472
"13 EAST 131 STREET, 4B",2004-04-30,334113,2008-02-04,435000,100887,1375,73.37236363636363
"455 CENTRAL PARK WEST, 19B",2004-10-26,1629200,2018-08-29,2000000,370800,5055,73.35311572700297
"350 WEST 42ND STREET, 45B",2007-03-29,1550000,2012-06-19,1690000,140000,1909,73.33682556312205
"400 CENTRAL PARK WEST, 17V",2004-07-19,557500,2014-07-15,825000,267500,3648,73.32785087719299
"220 RIVERSIDE BOULEVARD, 23F",2005-08-24,1060000,2016-06-23,1350000,290000,3956,73.30637007077857
"400 CENTRAL PARK WEST, 4H",2004-05-03,455000,2014-02-28,718000,263000,3588,73.29988851727983
"60 EAST 55TH STREET, 14B",2005-11-15,789143,2017-06-22,1099710,310567,4237,73.29879631814964
"330 EAST 33RD   STREET, 3-B",2007-05-29,600000,2015-03-06,808000,208000,2838,73.29105003523608
"263 9 AVENUE, 3E",2006-01-11,1578287,2012-01-30,1740000,161713,2210,73.17330316742081
"555 WEST 23 STREET, N10B",2006-04-04,707683,2017-01-03,995000,287317,3927,73.16450216450217
"150 EAST 85 STREET, 2I",2005-02-03,504972,2015-11-16,793000,288028,3938,73.14068054850178
"322 WEST 57TH   STREET, 27K",2008-08-04,850239,2013-10-28,990000,139761,1911,73.13500784929356
"420 WEST 25TH   STREET, 2H",2008-01-24,1013158,2012-09-20,1137500,124342,1701,73.09935332157555
"200 RIVERSIDE BOULEVARD, 7E",2007-07-30,788000,2015-06-26,999000,211000,2888,73.06094182825485
"380 LENOX AVENUE, 4J",2007-02-08,720472,2014-12-16,930000,209528,2868,73.05718270571828
"105 NORFOLK STREET, 10A",2007-07-02,1013158,2016-05-17,1250000,236842,3242,73.05428747686614
"173 PERRY STREET, 2N",2003-07-17,2115000,2009-12-21,2286500,171500,2349,73.009791400596
"40 WEST 55TH STREET, 7D",2007-11-07,1305000,2017-03-24,1555000,250000,3425,72.99270072992701
"18 WEST 48TH   STREET, 22D",2007-06-27,1007400,2017-05-19,1271000,263600,3614,72.93857221914776
"177 EAST 77TH STREET, 6C",2006-03-10,1384820,2010-07-07,1500000,115180,1580,72.89873417721519
"150 WEST 51ST   STREET, 20-27",2009-09-25,436000,2012-02-21,500000,64000,879,72.81001137656428
"392 CENTRAL PARK WEST, 17Y",2005-01-14,450000,2011-06-08,620000,170000,2336,72.77397260273973
"250 EAST 53RD STREET, 2303",2008-06-04,1354256,2018-06-05,1620000,265744,3653,72.74678346564468
"40 BROAD STREET, 28F",2010-07-02,534581,2015-03-23,660000,125419,1725,72.70666666666666
"190 RIVERSIDE DRIVE, 8C",2008-03-05,4990000,2013-04-05,5125000,135000,1857,72.69789983844912
"721 5 AVENUE, 39H",2005-10-27,1300000,2018-04-02,1630000,330000,4540,72.68722466960352
"382 CENTRAL PARK WEST, 19G",2004-07-01,379000,2014-05-30,642000,263000,3620,72.65193370165746
"630 1 AVENUE, 14D",2004-06-30,760000,2009-10-09,900000,140000,1927,72.6517903476907
"120 RIVERSIDE BOULEVARD, 5T",2006-03-24,1221900,2017-08-25,1525000,303100,4172,72.6510067114094
"50 WEST 15TH STREET, 6E",2008-11-20,1680112,2013-05-30,1800000,119888,1652,72.57142857142857
"111 FULTON STREET, 405",2010-02-24,460000,2012-05-31,520000,60000,827,72.55139056831922
"505 WEST 47TH   STREET, 4G-N",2009-12-31,499000,2015-04-17,639000,140000,1933,72.42628039317124
"350 WEST 42ND STREET, 19M",2006-07-05,615023,2010-09-01,725000,109977,1519,72.40092165898618
"15 BROAD STREET, 2728",2006-12-20,549855,2011-09-14,675000,125145,1729,72.37998843262001
"330 EAST 49TH   STREET, TH3",2012-09-27,340000,2017-06-20,465000,125000,1727,72.37984944991314
"50 BAYARD STREET, 2C",2003-04-10,180000,2011-03-21,390000,210000,2902,72.36388697450035
"322 WEST 57TH STREET, 32V",2008-07-09,865512,2016-04-04,1070000,204488,2826,72.3595187544232
"131 WEST 11TH   STREET, UNIT5",2009-06-02,1450000,2011-10-14,1512500,62500,864,72.33796296296296
"400 CENTRAL PARK WEST, 14U",2005-04-29,430000,2014-08-07,675000,245000,3387,72.3354000590493
"505 WEST 47TH   STREET, 4C-N",2011-05-18,697501,2017-09-19,865000,167499,2316,72.32253886010362
"300 CATHEDRAL PARKWAY, 9E",2007-06-13,570000,2015-05-26,780000,210000,2904,72.31404958677686
"40 WEST 55TH   STREET, 2D",2009-11-02,1035000,2012-04-19,1100000,65000,899,72.30255839822024
"205 EAST 85TH   STREET, 6B",2009-04-30,915556,2017-10-31,1140000,224444,3106,72.26142949130714
"220, 40D",2003-05-09,2000000,2004-04-19,2025000,25000,346,72.25433526011561
"106 CENTRAL PARK SOUTH, 10F",2009-12-24,655000,2013-05-23,745000,90000,1246,72.23113964686998
"68 BRADHURST AVENUE, 4-K",2007-06-19,455034,2014-06-23,640000,184966,2561,72.22413119875048
"111 FULTON STREET, 808",2008-11-13,1247356,2015-01-13,1410000,162644,2252,72.22202486678508
"393 WEST 49 STREET, 4PP",2003-08-18,273780,2014-06-25,560000,286220,3964,72.20484359233097
"184 THOMPSON STREET, 3S",2016-08-04,700000,2018-02-09,740000,40000,554,72.20216606498195
"350 WEST 42ND STREET, 8L",2006-04-28,997885,2017-10-12,1300000,302115,4185,72.18996415770609
"380 RECTOR PLACE, 23G",2007-08-07,1150000,2018-07-24,1439000,289000,4004,72.17782217782218
"201 WEST 74 STREET, 9H",2003-11-04,345000,2016-12-06,690000,345000,4781,72.16063585024054
"871 8 AVENUE, 2H",2005-03-29,625000,2014-09-26,875000,250000,3468,72.08765859284891
"18 WEST 48TH STREET, 29C",2007-07-10,1189723,2013-08-12,1350000,160277,2225,72.03460674157303
"1641 3 AVENUE, 11D",2004-11-03,420000,2011-04-21,590000,170000,2360,72.03389830508475
"402 EAST 90TH STREET, 11D",2005-01-07,640000,2017-01-25,957000,317000,4401,72.02908429902295
"692 BROADWAY, 823",2004-06-24,1250000,2013-10-17,1495000,245000,3402,72.01646090534979
"220 RIVERSIDE BOULEVARD, 9M",2006-02-14,2056000,2013-07-01,2250000,194000,2694,72.01187824795842
"88 GREENWICH STREET, 528",2010-11-05,456000,2015-08-21,582000,126000,1750,72.0
"1600 BROADWAY, 9G",2006-05-30,1313542,2013-07-02,1500000,186458,2590,71.99150579150579
"200 EAST 66TH   STREET, A1107",2008-10-27,1509434,2017-12-21,1750000,240566,3342,71.98264512268103
"100 RIVERSIDE BOULEVARD, 22A",2008-09-10,1563013,2013-09-18,1695000,131987,1834,71.96673936750273
"455 MAIN STREET, 12N",2006-04-25,275808,2012-07-10,439000,163192,2268,71.95414462081129
"7 BOND STREET, 4A",2007-06-06,1431000,2011-12-16,1550000,119000,1654,71.94679564691657
"240 EAST 10TH   STREET, 3C",2007-04-05,1485000,2013-07-18,1650000,165000,2296,71.86411149825784
"88 GREENWICH STREET, 824",2009-10-07,514000,2012-01-12,573400,59400,827,71.82587666263603
"300 EAST 93RD STREET, 26F",2004-07-20,455000,2018-01-31,810000,355000,4943,71.8187335626138
"392 CENTRAL PARK WEST, 20L",2008-01-08,650000,2017-07-20,900000,250000,3481,71.81844297615628
"100 RIVERSIDE BOULEVARD, 11F",2008-04-28,2257969,2013-09-27,2400000,142031,1978,71.80535894843275
"305 2 AVENUE, 529",2006-11-14,1338998,2014-09-22,1545000,206002,2869,71.8027187173231
"200 CHAMBERS STREET, 5S",2007-03-30,641497,2011-05-20,750000,108503,1512,71.7612433862434
"120 RIVERSIDE BOULEVARD, PH1G",2006-03-09,1117020,2012-10-15,1290000,172980,2412,71.71641791044776
"100 RIVERSIDE BOULEVARD, 7N",2008-03-26,1858815,2013-10-25,2005000,146185,2039,71.69445806768023
"845 UNITED NATIONS PLAZA, 24G",2008-09-29,1517500,2017-01-19,1735000,217500,3034,71.68754119973632
"325 LEXINGTON AVENUE, 15C",2015-03-10,972428,2016-01-19,995000,22572,315,71.65714285714286
"313 WEST 119 STREET, 1H",2007-07-19,1295000,2013-06-21,1450000,155000,2164,71.62661737523105
"660 RIVERSIDE DRIVE, 5D",2008-01-22,151300,2010-11-02,224000,72700,1015,71.6256157635468
"1600 BROADWAY, 12E",2006-06-06,768778,2015-08-25,1009900,241122,3367,71.61330561330561
"230 RIVERSIDE DRIVE, 12L",2006-12-19,552400,2016-05-24,799000,246600,3444,71.602787456446
"455 MAIN STREET, 5B",2006-07-21,722500,2014-11-14,940000,217500,3038,71.59315339038841
"455 EAST 86TH STREET, 10E",2010-01-13,610000,2018-06-14,830000,220000,3074,71.5679895901106
"166 EAST 63RD STREET, 11D",2004-09-09,595676,2017-11-15,940000,344324,4815,71.51069574247144
"133 ESSEX STREET, 302",2007-04-18,829873,2015-05-07,1040000,210127,2941,71.44746684801088
"340 EAST 23RD STREET, 8A",2008-02-25,722957,2018-07-30,995000,272043,3808,71.43986344537815
"455 EAST 86TH STREET, 10D",2012-07-13,425000,2016-09-30,535000,110000,1540,71.42857142857143
"299 WEST 12TH STREET, 1F",2013-03-22,1065000,2017-06-09,1175000,110000,1540,71.42857142857143
"40 BROAD STREET, 21FG",2009-11-24,1527375,2014-03-20,1640000,112625,1577,71.41724793912492
"161 EAST 110 STREET, 5C",2009-04-28,395460,2013-09-19,510000,114540,1605,71.3644859813084
"200 CHAMBERS STREET, 2P",2007-02-21,845147,2011-09-30,965000,119853,1682,71.256242568371
"163 ST. NICHOLAS AVENUE, 3D",2006-10-13,630000,2017-02-27,900000,270000,3790,71.2401055408971
"88 GREENWICH STREET, 506",2010-02-24,500000,2017-01-25,680000,180000,2527,71.23070834982192
"88 GREENWICH STREET, 412",2010-06-01,415000,2016-05-03,569000,154000,2163,71.19741100323624
"516 WEST 47TH STREET, S2M",2006-06-07,486111,2013-11-21,680000,193889,2724,71.178046989721
"404 EAST 66TH STREET, 3K",2013-07-31,540000,2018-05-23,665000,125000,1757,71.14399544678429
"415 EAST 37TH STREET, 7K",2006-05-22,550000,2015-10-27,795000,245000,3445,71.11756168359942
"154 ATTORNEY STREET, 204",2006-11-20,466440,2016-06-16,715000,248560,3496,71.09839816933638
"421 EAST 13TH   STREET, 4P",2008-05-14,799326,2013-12-09,944000,144674,2035,71.09287469287469
"630 1 AVENUE, 18-A",2004-02-12,475000,2018-03-06,840000,365000,5136,71.06697819314641
"80 JOHN STREET, 4F",2007-07-31,953845,2017-07-18,1212500,258655,3640,71.05906593406593
"154 ATTORNEY STREET, 603",2006-12-01,885650,2018-01-25,1175000,289350,4073,71.04100171863492
"310 WEST 52ND   STREET, 9A",2007-02-22,784052,2010-11-04,880000,95948,1351,71.019985196151
"120 RIVERSIDE BOULEVARD, 9W",2006-01-18,660314,2010-06-21,775000,114686,1615,71.01300309597524
"21 SOUTH END AVENUE, PH1BB",2010-07-30,398000,2018-04-30,599000,201000,2831,70.99964676792652
"300 ALBANY STREET, 3J",2006-08-22,381000,2015-09-28,617000,236000,3324,70.99879663056558
"112 WEST 72ND   STREET, 3F",2010-10-06,422100,2015-04-17,539500,117400,1654,70.97944377267231
"247 WEST 46TH   STREET, 3002",2008-09-02,1675021,2014-06-16,1825000,149979,2113,70.97917652626597
"56 PINE STREET, 14F",2005-06-27,461370,2014-02-11,685000,223630,3151,70.97112027927642
"2250 BROADWAY, 6R",2003-10-08,375000,2016-09-12,710000,335000,4723,70.92949396569976
"635 WEST 42ND   STREET, 14N",2007-05-23,874881,2017-08-16,1140000,265119,3738,70.92536115569824
"350 WEST 50TH STREET, 9F",2005-02-28,900000,2010-12-15,1050000,150000,2116,70.88846880907373
"200 RIVERSIDE BOULEVARD, 9F",2005-01-14,725000,2007-07-20,790000,65000,917,70.88331515812432
"1601 3 AVENUE, 27E",2003-02-20,154027,2018-06-08,550000,395973,5587,70.8739931984965
"500 WEST 43RD STREET, 17B",2007-03-15,824000,2017-11-14,1100097,276097,3897,70.84860148832435
"350 WEST 42ND STREET, 21J",2006-10-12,600000,2015-04-15,820000,220000,3107,70.80785323463148
"88 GREENWICH STREET, 919",2010-01-05,575311,2016-09-23,749000,173689,2453,70.80676722380758
"366 WEST 11TH STREET, 4G",2007-09-18,745000,2017-05-19,995000,250000,3531,70.80147267063155
"812 RIVERSIDE DRIVE, 36",2008-09-26,410000,2017-06-09,635000,225000,3178,70.79924480805538
"252 SEVENTH AVENUE, 7N",2008-10-03,1200000,2012-06-06,1295000,95000,1342,70.78986587183309
"330 EAST 38 STREET, 22C",2004-01-22,570000,2011-08-09,765000,195000,2756,70.75471698113208
"150 EAST 85TH STREET, 11E",2006-05-08,615000,2016-10-20,885000,270000,3818,70.71765322158198
"220 WEST 111 STREET, 2C",2007-08-20,493000,2017-08-02,750000,257000,3635,70.70151306740027
"100 UNITED NATIONS PLAZA, 15F",2004-12-10,547000,2017-11-02,880000,333000,4710,70.70063694267516
"4260 BROADWAY, 509",2003-02-24,87630,2018-08-28,488000,400370,5664,70.68679378531074
"330 EAST 38TH   STREET, 5O",2007-03-30,540000,2008-09-18,578000,38000,538,70.63197026022304
"119 CHAMBERS STREET, 4",2008-04-11,2978381,2012-12-28,3100000,121619,1722,70.62659698025551
"45 PARK AVENUE, 304",2007-12-19,1089527,2013-05-30,1230000,140473,1989,70.62493715434891
"160 WEST 66TH STREET, 18C",2008-05-19,655000,2018-08-28,920000,265000,3753,70.6101785238476
"315 SEVENTH AVENUE, 14B",2007-05-09,636255,2011-03-08,735000,98745,1399,70.58255897069336
"505 WEST 47TH   STREET, 1H-S",2010-12-21,449000,2017-06-29,617000,168000,2382,70.52896725440806
"60 HENRY STREET, 4E",2003-10-20,274000,2007-03-21,362000,88000,1248,70.51282051282051
"120 RIVERSIDE BOULEVARD, 5R",2008-08-06,1050000,2017-05-02,1275000,225000,3191,70.51081165778753
"225 EAST 34TH   STREET, 8E",2008-03-27,1476462,2012-06-14,1585000,108538,1540,70.47922077922078
"113 ELDRIDGE STREET, 2B",2003-07-10,148450,2015-08-17,460000,311550,4421,70.4704817914499
"160 EAST 22ND   STREET, 5C",2014-09-26,2295125,2018-03-26,2385000,89875,1277,70.37979639780735
"260 PARK AVENUE SOUTH, 11H",2006-04-27,1563013,2010-04-16,1665000,101987,1450,70.33586206896551
"200 RECTOR PLACE, 28L",2006-01-26,385000,2018-05-04,700000,315000,4481,70.29680874804731
"106 CENTRAL PARK SOUTH, 8O",2003-09-13,490000,2015-12-21,805000,315000,4482,70.28112449799197
"208 EAST 32ND STREET, 3A",2005-01-19,325000,2008-06-10,412000,87000,1238,70.27463651050081
"255 CABRINI BOULEVARD, 8F",2004-08-17,19153,2016-02-26,315000,295847,4210,70.27244655581947
"105 NASSAU STREET, 9",2003-04-16,1625000,2010-02-09,1800000,175000,2491,70.2529104777198
"1619 THIRD AVENUE, 8F",2005-06-06,799000,2010-07-15,930000,131000,1865,70.24128686327077
"635 WEST 42ND   STREET, 29J",2008-04-04,1232082,2014-10-21,1400000,167918,2391,70.22919280635718
"515 EAST 72ND   STREET, 11G",2009-02-27,756843,2016-09-09,950000,193157,2751,70.21337695383497
"250 EAST 53RD STREET, 1002",2008-01-28,1656436,2012-09-12,1775000,118564,1689,70.19775014801658
"20 WEST STREET, 28A",2007-05-31,590585,2015-08-03,800000,209415,2986,70.1322839919625
"1 IRVING PLACE, U23A",2006-04-25,846000,2011-09-28,985000,139000,1982,70.13118062563068
"57 WEST 58TH STREET, 5HH",2013-10-31,345000,2018-01-18,453000,108000,1540,70.12987012987013
"40 WEST 116 STREET, B302",2008-11-07,602400,2012-08-30,700000,97600,1392,70.11494252873563
"161 WEST 61ST STREET, 27E",2006-09-08,995000,2014-09-10,1200000,205000,2924,70.10943912448701
"215 WEST 95TH STREET, 14L",2009-02-17,440000,2017-09-22,660000,220000,3139,70.08601465434852
"115 4 AVENUE, 8H",2003-06-02,1210000,2009-06-22,1365000,155000,2212,70.07233273056057
"250 SOUTH END AVENUE, 14E",2004-10-15,453000,2018-03-02,795000,342000,4886,69.99590667212443
"199 BOWERY, 9B",2006-10-04,631315,2014-05-06,825000,193685,2771,69.89714904366654
"115 FOURTH AVENUE, 6D",2004-11-10,659000,2018-03-16,999500,340500,4874,69.86048420188757
"161 WEST 61ST STREET, 15B",2005-06-17,900000,2015-04-06,1150000,250000,3580,69.83240223463687
"345 EAST 80TH STREET, 16L",2004-12-23,479000,2016-08-01,775000,296000,4239,69.82778957301251
"201 WEST 74TH STREET, 16A",2012-11-15,540000,2018-05-15,680000,140000,2007,69.75585450921774
"163 ST NICHOLAS AVENUE, 6D",2004-06-17,420810,2013-04-05,645000,224190,3214,69.75420037336652
"106 CENTRAL PARK SOUTH, 4C",2004-08-13,340000,2009-09-21,470000,130000,1865,69.70509383378015
"555 WEST 23RD   STREET, S3J",2008-09-29,765000,2014-03-31,905000,140000,2009,69.68641114982579
"253 WEST 73RD   STREET, 5M",2013-07-17,1451000,2017-06-07,1550000,99000,1421,69.66924700914849
"249 EAST 48TH STREET, 11F",2011-09-21,400000,2018-08-07,575000,175000,2512,69.6656050955414
"372 CONVENT AVENUE, 1B",2007-03-19,690000,2014-11-18,885000,195000,2801,69.61799357372367
"555 WEST 59TH STREET, 32B",2008-06-06,3350042,2014-02-18,3495000,144958,2083,69.59097455592895
"120 EAST 87TH   STREET, P14-G",2007-03-30,622000,2013-08-28,785000,163000,2343,69.5689287238583
"420 EAST 58TH STREET, 25B",2004-12-20,535000,2014-03-21,770000,235000,3378,69.56779159265838
"99 JOHN STREET, 2204",2009-03-12,750000,2012-07-16,835000,85000,1222,69.55810147299509
"295 GREENWICH STREET, 11DN",2003-04-30,551000,2011-02-28,750000,199000,2861,69.55609926599091
"392 CENTRAL PARK WEST, 18E",2004-05-14,383000,2014-11-18,650000,267000,3840,69.53125
"255 EAST 49TH   STREET, 14B",2009-03-10,700000,2013-09-19,815000,115000,1654,69.52841596130592
"400 CENTRAL PARK WEST, 5Y",2008-10-17,650000,2017-05-12,867500,217500,3129,69.51102588686481
"114 BENNETT AVENUE, 2A",2004-06-04,651680,2015-03-12,925000,273320,3933,69.49402491736588
"1212 5 AVENUE, 2C",2013-06-20,906242,2016-12-19,995000,88758,1278,69.45070422535211
"259 WEST 85TH   STREET, 3",2008-11-13,1050000,2013-08-08,1170000,120000,1729,69.40427993059572
"80 JOHN STREET, 5H",2007-03-01,405600,2016-06-20,641497,235897,3399,69.40188290673727
"515 EAST 72ND   STREET, 9D",2008-01-22,916425,2017-04-11,1150000,233575,3367,69.37184437184438
"220 RIVERSIDE BOULEVARD, 8U",2004-11-30,785000,2017-05-08,1100000,315000,4542,69.35270805812418
"220 EAST 65TH STREET, 20A",2005-01-31,610000,2012-12-24,810000,200000,2884,69.34812760055479
"725 RIVERSIDE DRIVE, 10G",2007-08-17,247517,2014-05-12,418000,170483,2460,69.3020325203252
"88 GREENWICH STREET, 305",2010-12-14,467000,2016-03-17,600000,133000,1920,69.27083333333333
"222 RIVERSIDE DRIVE, 16F",2004-07-29,490000,2015-04-01,760000,270000,3898,69.26629040533606
"635 WEST 42ND   STREET, 26H",2008-07-15,957155,2016-05-12,1155000,197845,2858,69.22498250524842
"225 RECTOR PLACE, 20F",2008-04-29,773870,2017-03-02,997000,223130,3229,69.10188912976153
"376 BROADWAY, 14F",2011-07-07,955000,2016-08-31,1085000,130000,1882,69.07545164718384
"18 WEST 48TH STREET, 33D",2007-06-07,1128833,2017-08-18,1386000,257167,3725,69.03812080536913
"222 RIVERSIDE DRIVE, 3C",2005-01-19,1195000,2012-08-07,1385000,190000,2757,68.91548784911136
"20 PINE STREET, 1107",2012-11-30,635000,2018-04-12,770000,135000,1959,68.91271056661562
"280 PARK AVENUE SOUTH, 7H",2006-01-26,967337,2018-04-19,1275000,307663,4466,68.89005821764442
"21 SOUTH END AVENUE, 233",2010-02-05,375000,2016-06-16,535000,160000,2323,68.87645286267757
"530 EAST 76TH STREET, 23D",2009-05-07,840000,2012-12-04,930000,90000,1307,68.85998469778117
"90 WILLIAM STREET, 5E",2008-07-24,519307,2016-08-22,722500,203193,2951,68.85564215520162
"300 WEST 135TH STREET, 10B",2005-09-01,370696,2015-03-12,610000,239304,3479,68.78528312733545
"55 WALL STREET, 716",2009-12-22,946505,2015-02-03,1075000,128495,1869,68.75066880684858
"215 WEST 95 STREET, 7F",2003-08-18,430000,2004-06-04,450000,20000,291,68.72852233676976
"304 EAST 65TH   STREET, 15B",2007-08-09,710000,2014-07-30,885000,175000,2547,68.70828425598744
"250 EAST 54TH   STREET, 23D",2008-12-09,910000,2017-07-06,1125000,215000,3131,68.66815713829448
"240 RIVERSIDE BOULEVARD, 4 F",2005-11-29,998000,2012-12-20,1175000,177000,2578,68.65787432117921
"68 BRADHURST AVENUE, 7-R",2007-05-18,655000,2016-09-30,890000,235000,3423,68.65322816243062
"111 FULTON STREET, 323",2008-12-04,539672,2017-04-26,750000,210328,3065,68.62251223491027
"581 ACADEMY STREET, 2E",2003-02-19,133591,2016-10-06,475000,341409,4978,68.58356769787063
"100 WEST 39TH   STREET, 42F",2015-12-14,900000,2016-12-13,925000,25000,365,68.4931506849315
"310 WEST 52ND   STREET, 6C",2007-05-31,784052,2009-08-25,840000,55948,817,68.4798041615667
"350 WEST 42ND   STREET, 15L",2008-11-03,1080000,2013-08-07,1199000,119000,1738,68.46950517836594
"382 CENTRAL PARK WEST, 3E",2005-05-27,425000,2016-05-26,700000,275000,4017,68.45904904157331
"56 PINE STREET, 4C",2006-02-17,446160,2014-04-15,650000,203840,2979,68.42564618999664
"40 BROAD STREET, 19C",2010-02-23,529490,2016-05-16,685000,155510,2274,68.38610378188214
"240 RIVERSIDE BOULEVARD, 15 D",2005-11-01,1111929,2009-05-12,1200000,88071,1288,68.3781055900621
"300 ALBANY STREET, 4N",2004-02-23,280000,2009-07-21,415000,135000,1975,68.35443037974683
"200 RECTOR PLACE, 22M",2004-07-29,390000,2018-03-13,730000,340000,4975,68.34170854271356
"30 LITTLE WEST STREET, 15B",2014-04-22,1800000,2018-03-12,1897000,97000,1420,68.30985915492958
"150 EAST 85TH STREET, 11B",2008-04-21,640000,2016-04-28,840000,200000,2929,68.28269033799931
"16 WEST 19TH   STREET, 6-C",2007-11-07,1099710,2012-05-16,1212500,112790,1652,68.27481840193704
"200 RIVERSIDE BOULEVARD, 15J",2004-07-02,675000,2013-06-27,899000,224000,3282,68.25106642291286
"140 7 AVENUE, 6A",2003-02-04,340500,2018-02-13,715000,374500,5488,68.23979591836735
"145 EAST 48TH STREET, 14A",2004-11-12,355471,2013-04-10,565000,209529,3071,68.2282644089873
"635 WEST 42ND   STREET, 10B",2007-12-20,794235,2017-08-10,1034375,240140,3521,68.20221527975008
"386 COLUMBUS AVENUE, 7B",2008-07-08,1400000,2015-08-06,1576250,176250,2585,68.18181818181819
"250 EAST 53RD STREET, 802",2008-06-10,1523797,2010-07-01,1575000,51203,751,68.1797603195739
"1623 THIRD AVENUE, 38A",2004-11-19,1039000,2011-05-10,1200000,161000,2363,68.13372831146847
"200 WEST END AVENUE, 4N",2007-12-21,699537,2017-06-07,935000,235463,3456,68.1316550925926
"45 PARK AVENUE, 1105",2007-12-03,1031130,2017-02-13,1260000,228870,3360,68.11607142857143
"340 EAST 23RD STREET, 6G",2008-01-31,491893,2017-08-30,730000,238107,3499,68.05001428979709
"200 RECTOR PLACE, 6S",2004-06-16,327500,2016-11-03,635000,307500,4523,67.98585009949149
"300 ALBANY STREET, 9E",2004-01-09,215000,2016-08-18,528000,313000,4605,67.96959826275787
"1600 BROADWAY, 5F",2006-05-10,616041,2014-12-24,830000,213959,3150,67.92349206349206
"40 BROAD STREET, 12C",2010-03-26,509125,2017-07-10,690000,180875,2663,67.92151708599324
"330 EAST 75TH   STREET, 11K",2009-07-20,645000,2015-03-17,785000,140000,2066,67.76379477250725
"155 WEST 70TH STREET, 9H",2006-12-08,585000,2013-08-08,750000,165000,2435,67.76180698151951
"1760 2 AVENUE, 7B",2004-05-07,745000,2014-08-27,999999,254999,3764,67.74681190223167
"171 EAST 84TH STREET, 14B",2007-02-01,1332000,2011-11-09,1450000,118000,1742,67.73823191733639
"15 BROAD STREET, 2904",2006-08-02,1308895,2014-09-18,1510000,201105,2969,67.73492758504547
"404 EAST 76TH STREET, 3B",2010-04-08,720000,2014-07-21,826000,106000,1565,67.73162939297124
"184 THOMPSON STREET, 6U",2007-09-18,880786,2016-03-03,1090000,209214,3089,67.72871479443185
"200 RIVERSIDE BOULEVARD, 14C",2006-06-20,1115000,2017-12-28,1400000,285000,4209,67.71204561653599
"125 CENTRAL PARK NORTH, 4B",2006-08-29,804417,2012-12-14,960000,155583,2299,67.67420617659852
"160 CENTRAL PARK SOUTH, 960",2008-07-11,1170987,2014-07-23,1320000,149013,2203,67.64094416704494
"300 ALBANY STREET, 9D",2003-05-05,315000,2011-06-10,515000,200000,2958,67.6132521974307
"140 7 AVENUE, 7S",2003-12-17,382500,2017-12-06,727500,345000,5103,67.60728982951206
"237 EAST 88TH STREET, 101",2007-08-23,1074253,2013-09-30,1225000,150747,2230,67.59955156950673
"14 PRINCE STREET, 6C",2005-08-04,1229000,2011-09-16,1380000,151000,2234,67.591763652641
"380 LENOX AVENUE, 5J",2007-06-04,756631,2014-01-15,920000,163369,2417,67.59164253206454
"581 ACADEMY STREET, 2F",2005-08-01,215000,2015-11-30,470000,255000,3773,67.58547574874106
"71 PARK AVENUE, 8D",2008-02-25,550000,2014-08-21,710000,160000,2369,67.5390460109751
"35 EAST 38TH   STREET, 6E",2007-03-21,525000,2015-04-30,725000,200000,2962,67.5219446320054
"199 BOWERY, 3C",2006-03-03,334620,2013-08-09,518000,183380,2716,67.51840942562592
"425 CENTRAL PARK WEST, 3K",2007-10-04,720000,2014-01-16,875000,155000,2296,67.50871080139373
"350 WEST 42ND STREET, 22K",2006-09-21,742000,2013-07-15,910000,168000,2489,67.49698674166332
"377 RECTOR PLACE, 6J",2004-11-18,540000,2015-08-20,805000,265000,3927,67.48153806977336
"211 EAST 13TH   STREET, 5D",2014-06-17,994793,2016-09-13,1050000,55207,819,67.40781440781441
"20 WEST 64TH STREET, 9O",2005-03-24,740000,2006-03-30,765000,25000,371,67.38544474393531
"350 EAST 82ND   STREET, 15A",2007-01-31,1939766,2013-08-06,2100000,160234,2379,67.35350987810004
"230 RIVERSIDE DRIVE, 18B",2007-05-10,441090,2014-06-05,615000,173910,2583,67.32868757259001
"247 WEST 46TH   STREET, 704",2008-10-28,1176078,2014-09-05,1320000,143922,2138,67.31618334892423
"215 AVENUE B, 1016",2010-11-09,548836,2013-07-19,615000,66164,983,67.30824008138352
"350 WEST 42ND STREET, 15K",2006-06-16,622150,2011-01-19,735000,112850,1678,67.25268176400476
"166 EAST 63RD STREET, 5K",2006-10-16,745000,2016-10-07,990000,245000,3644,67.2338090010977
"142 WEST 10TH   STREET, 2A",2008-05-29,2240000,2013-07-02,2365000,125000,1860,67.20430107526882
"225 EAST 34TH STREET, 3F",2007-10-03,784052,2014-07-11,950000,165948,2473,67.10392236150425
"1438 3 AVENUE, 28A",2007-12-07,1033523,2016-10-07,1250000,216477,3227,67.08304927176944
"330 PEARL STREET, 5A",2003-05-30,547500,2010-03-31,715000,167500,2497,67.0804965959151
"45 PARK AVENUE, 402",2007-10-10,1176078,2013-08-23,1319898,143820,2144,67.08022388059702
"18 WEST 48TH   STREET, 20D",2007-11-09,1007049,2015-11-04,1202700,195651,2917,67.0726774082962
"400 EAST 51ST STREET, 4D",2005-07-29,950000,2007-05-31,995000,45000,671,67.06408345752608
"100 RIVERSIDE BOULEVARD, 12P",2008-07-31,1440823,2014-01-22,1575000,134177,2001,67.05497251374312
"515 EAST 72ND STREET, 16B",2011-09-30,260000,2016-03-28,370000,110000,1641,67.03229737964655
"400 EAST 51ST   STREET, 3D",2010-07-15,815000,2013-08-07,890000,75000,1119,67.02412868632707
"220 RIVERSIDE BOULEVARD, 44B",2007-08-27,2530000,2011-09-27,2630000,100000,1492,67.02412868632707
"82 BEAVER STREET, 1409",2007-04-06,794235,2014-10-08,978000,183765,2742,67.01859956236324
"420 EAST 86TH   STREET, 6E",2008-11-05,370000,2016-03-14,550000,180000,2686,67.01414743112434
"310 EAST 53RD   STREET, 19A",2007-06-01,2730335,2014-05-07,2900000,169665,2532,67.00829383886256
"22 WEST 15TH STREET, 15A",2005-02-10,625000,2010-01-21,746000,121000,1806,66.99889258028793
"340 EAST 23RD   STREET, 5K",2011-01-11,787500,2017-08-04,948000,160500,2397,66.95869837296621
"135 DIVISION STREET, 7B",2004-07-30,315000,2013-10-15,540000,225000,3364,66.884661117717
"300 RECTOR PLACE, 7K",2006-09-08,785000,2014-06-19,975000,190000,2841,66.87785990848293
"225 EAST 34TH STREET, 11J",2007-10-24,992793,2018-07-19,1255000,262207,3921,66.87248150981893
"347 WEST 57TH STREET, 23E",2005-06-10,490000,2007-06-28,540000,50000,748,66.84491978609626
"301 WEST 57TH STREET, 7E",2004-10-15,390000,2017-06-29,700000,310000,4640,66.8103448275862
"845 UNITED NATIONS PLAZA, 44C",2007-12-17,3050000,2017-09-18,3288000,238000,3563,66.79764243614932
"100 RIVERSIDE BOULEVARD, 19D",2008-06-23,1863397,2013-04-04,1980000,116603,1746,66.78293241695303
"1600 BROADWAY, 10E",2006-10-30,702592,2010-05-26,789652,87060,1304,66.7638036809816
"106 CENTRAL PARK SOUTH, 15O",2005-12-12,483000,2014-06-12,690000,207000,3104,66.6881443298969
"350 WEST 42ND STREET, 10H",2006-09-07,475566,2013-08-22,645000,169434,2541,66.68004722550177
"61-63 LENOX AVE, 2A",2006-04-28,293959,2016-11-02,550000,256041,3841,66.65998437906795
"120 RIVERSIDE BOULEVARD, 10U",2006-01-20,524398,2015-04-29,750000,225602,3386,66.62787950383934
"280 PARK AVENUE SOUTH, 2F",2003-03-26,555000,2011-04-01,750000,195000,2928,66.59836065573771
"124 EAST 79TH STREET, 7D",2006-03-22,1675000,2018-07-27,1975000,300000,4510,66.51884700665188
"2019 1 AVENUE, 6E",2011-08-26,270000,2014-12-11,350000,80000,1203,66.50041562759768
"240 RIVERSIDE BOULEVARD, 7 F",2005-10-26,637250,2013-10-03,830000,192750,2899,66.48844429113487
"255 HUDSON STREET, 3A",2006-09-20,1858306,2010-07-01,1950000,91694,1380,66.44492753623189
"250 EAST 54TH STREET, 14A",2008-10-23,1500000,2012-12-07,1600000,100000,1506,66.40106241699867
"425 FIFTH AVENUE, 24C",2007-07-18,675000,2014-12-19,855000,180000,2711,66.39616377720398
"220 RIVERSIDE BOULEVARD, 14U",2005-05-18,840000,2007-06-12,890000,50000,755,66.2251655629139
"200 WEST END AVENUE, 8K",2008-02-06,743322,2014-07-30,900000,156678,2366,66.22062552831784
"330 EAST 49TH STREET, 7J",2004-12-10,458000,2017-08-21,765000,307000,4637,66.20659909424197
"340 EAST 23RD STREET, 15A",2008-04-14,814600,2016-07-28,1015000,200400,3027,66.20416253716552
"300 SPRING STREET, 4A",2007-04-16,896060,2018-08-14,1170000,273940,4138,66.2010633156114
"21-23 S. WILLIAM STREET, 2B",2013-06-12,695000,2017-05-18,790000,95000,1436,66.15598885793872
"313 WEST 119 STREET, 3H",2007-09-07,280000,2015-02-18,460000,180000,2721,66.1521499448732
"15 BROAD STREET, 1501",2006-05-23,656771,2014-05-22,850000,193229,2921,66.1516603902773
"222 RIVERSIDE DRIVE, 7F",2003-02-25,410000,2017-01-23,746000,336000,5081,66.12871481991733
"555 WEST 23RD STREET, N10H",2006-04-24,743322,2014-05-16,938000,194678,2944,66.12703804347827
"80 PARK AVENUE, 16M",2003-06-20,349000,2010-07-19,520000,171000,2586,66.12529002320186
"184 THOMPSON STREET, 4R",2007-05-15,501930,2017-08-23,750000,248070,3753,66.09912070343725
"340 EAST 23RD STREET, 9C",2008-02-15,789143,2013-12-17,930000,140857,2132,66.06801125703565
"200 RECTOR PLACE, 33A",2005-04-11,535000,2016-01-20,795000,260000,3936,66.0569105691057
"200 WEST END AVENUE, 10N",2008-06-11,789143,2015-04-27,955000,165857,2511,66.05217045001991
"311 EAST 38 STREET, 5B",2003-04-29,395000,2011-11-02,600000,205000,3109,65.93760051463494
"2101 BROADWAY, 12142",2005-12-16,395000,2008-06-13,455000,60000,910,65.93406593406593
"690 RIVERSIDE DRIVE, 5F",2008-06-17,309270,2016-05-19,500000,190730,2893,65.92810231593502
"311 GREENWICH STREET, 9A",2004-06-25,310000,2010-11-17,463999,153999,2336,65.92422945205479
"2 SOUTH END AVENUE, 8B",2003-06-04,509295,2010-09-21,685000,175705,2666,65.90585146286571
"200 WEST 78TH STREET, 3B",2005-01-21,329550,2009-08-24,440000,110450,1676,65.90095465393794
"225 RECTOR PLACE, 7E",2008-07-22,568795,2018-01-15,797000,228205,3464,65.8790415704388
"510 EAST 80TH STREET, 5A",2006-09-12,675000,2016-01-20,900000,225000,3417,65.84723441615452
"88 GREENWICH STREET, 1312",2010-01-29,644552,2017-05-18,820000,175448,2666,65.80945236309077
"166 EAST 63RD STREET, 7E",2015-08-25,1035000,2018-05-09,1100000,65000,988,65.78947368421052
"155 WEST 68TH   STREET, 16-24",2013-11-20,2100000,2014-12-05,2125000,25000,380,65.78947368421052
"143 AVENUE B, 11E",2005-03-09,657000,2018-06-04,975000,318000,4835,65.77042399172699
"1619 3 AVENUE, 14E",2003-02-20,130604,2012-04-10,350000,219396,3337,65.74647887323944
"107 AVENUE A, 2F",2006-02-28,620000,2014-01-28,810000,190000,2891,65.72120373573158
"77 PARK AVENUE, 6E",2007-11-07,2115000,2013-06-07,2249000,134000,2039,65.7184894556155
"140 7 AVENUE, 4J",2003-08-22,460000,2010-07-09,625000,165000,2513,65.65857540787903
"55 WALL STREET, 820",2013-01-31,930049,2015-05-18,985000,54951,837,65.65232974910394
"100 RIVERSIDE BOULEVARD, 6D",2008-04-10,754523,2014-02-18,895000,140477,2140,65.64345794392523
"400 EAST 90TH   STREET, 5I",2007-07-02,328536,2014-03-27,490000,161464,2460,65.63577235772358
"517 WEST 46TH STREET, 303",2007-11-16,707083,2016-07-20,915000,207917,3169,65.60965604291574
"340 EAST 23RD STREET, 4D",2008-05-30,1083418,2010-02-23,1125000,41582,634,65.58675078864353
"635 WEST 42ND   STREET, 36J",2007-12-20,1364455,2014-09-02,1525000,160545,2448,65.58210784313725
"635 WEST 42ND STREET, 32G",2007-06-15,861439,2016-12-30,1090000,228561,3486,65.56540447504302
"100 RIVERSIDE BOULEVARD, 7J",2008-03-25,990000,2015-05-01,1160000,170000,2593,65.56112610875434
"56 PINE STREET, 3C",2005-11-08,436020,2014-10-17,650000,213980,3265,65.5375191424196
"50 FRANKLIN STREET, 8B",2010-02-12,626223,2017-05-18,800000,173777,2652,65.52677224736048
"400 CENTRAL PARK WEST, 3L",2003-10-14,395000,2013-05-28,625000,230000,3514,65.45247581104155
"435 EAST 117 STREET, 2",2009-02-25,748413,2017-08-02,950000,201587,3080,65.45032467532468
"68 BRADHURST AVENUE, 4-V",2007-05-23,471510,2018-08-20,740000,268490,4107,65.37375213050889
"199 BOWERY, 6C",2007-03-14,410670,2009-06-24,465000,54330,833,65.22208883553421
"181 SEVENTH AVENUE, 7A",2005-09-19,500000,2015-06-25,732500,232500,3566,65.19910263600673
"16 WEST 19TH   STREET, 5-C",2007-12-21,1074253,2013-04-02,1200000,125747,1929,65.18766200103681
"88 GREENWICH STREET, 1713",2009-08-03,549000,2015-07-07,690000,141000,2164,65.15711645101663
"215 AVENUE B, 1007",2010-08-13,486720,2013-12-12,566000,79280,1217,65.14379622021364
"871 8 AVENUE, 2D",2008-12-30,669028,2018-01-30,885000,215972,3318,65.09101868595539
"123 WASHINGTON STREET, 39D",2012-02-08,1314626,2016-07-15,1420000,105374,1619,65.08585546633725
"421 EAST 13TH   STREET, 5G",2008-03-18,809508,2012-08-10,914000,104492,1606,65.06351183063512
"225 EAST 34TH STREET, 14J",2007-11-01,1017231,2018-06-07,1269000,251769,3871,65.03978300180832
"211 WEST 71ST   STREET, 5C",2008-08-05,950000,2016-12-21,1149000,199000,3060,65.0326797385621
"88 GREENWICH STREET, 405",2009-12-29,462000,2016-08-25,620000,158000,2431,64.99382969971205
"200 RIVERSIDE BOULEVARD, 410",2006-01-27,1200000,2013-09-12,1381000,181000,2785,64.99102333931778
"15 BROAD STREET, 2726",2006-11-01,855330,2009-10-09,925000,69670,1073,64.93010251630942
"1630 MADISON AVENUE, 3C",2003-02-26,278850,2016-09-13,600000,321150,4948,64.90501212611156
"1 IRVING PLACE, G19H",2006-03-30,560000,2014-03-20,749000,189000,2912,64.90384615384616
"225 EAST 34TH STREET, 7A",2007-09-26,569201,2015-05-13,750000,180799,2786,64.89554917444364
"56 PINE STREET, 10A",2005-08-30,471510,2016-12-28,740000,268490,4138,64.8840019333011
"311 WEST BROADWAY, 2C",2011-06-02,2036500,2016-06-17,2156000,119500,1842,64.87513572204126
"18 MORNINGSIDE AVENUE, 8",2007-09-18,1350000,2013-08-15,1490000,140000,2158,64.87488415199259
"354 BROOME STREET, 6I",2005-08-19,1700000,2014-01-28,1900000,200000,3084,64.85084306095979
"2 SOUTH END AVENUE, 6D",2003-03-14,355000,2018-03-12,710000,355000,5477,64.8165053861603
"630 1 AVENUE, 19B",2007-05-09,990000,2014-02-11,1150000,160000,2470,64.77732793522267
"11 EAST 36TH   STREET, 703",2007-10-18,411938,2015-02-10,585000,173062,2672,64.7687125748503
"159 WEST 53RD STREET, 19C",2006-08-21,530000,2017-11-03,795000,265000,4092,64.76050830889541
"222 WEST 14TH STREET, 3J",2004-03-19,325000,2009-09-17,455000,130000,2008,64.7410358565737
"500 WEST 43RD STREET, 7B",2005-07-12,511000,2006-10-03,540000,29000,448,64.73214285714286
"160 CENTRAL PARK SOUTH, 2707",2008-05-05,2250000,2013-08-19,2375000,125000,1932,64.69979296066252
"181 EAST 65 STREET, 17D",2003-01-23,2400000,2017-11-15,2750000,350000,5410,64.69500924214418
"1630 MADISON AVENUE, 2C",2003-03-26,290000,2017-08-15,630000,340000,5256,64.68797564687975
"53 MURRAY STREET, 1",2007-10-03,3003837,2018-03-05,3250000,246163,3806,64.67761429322123
"376 BROADWAY, 9F",2005-01-28,645000,2013-10-03,850000,205000,3170,64.66876971608833
"12 EAST 12TH STREET, 7NE",2008-04-09,999000,2014-06-23,1145531,146531,2266,64.66504854368932
"402 EAST 90TH STREET, 6D",2005-02-17,575000,2018-01-17,880000,305000,4717,64.65974136103456
"404 EAST 76TH STREET, 23A",2005-09-20,1700000,2018-05-22,1999000,299000,4627,64.62070456019019
"360 EAST 88TH STREET, 8D",2005-04-20,406000,2017-05-02,690000,284000,4395,64.6188850967008
"200 RECTOR PLACE, 16F",2006-08-14,620000,2018-06-27,900000,280000,4335,64.59054209919262
"377 RECTOR PLACE, 6A",2004-11-01,600000,2016-06-30,875000,275000,4259,64.56914768725053
"505 WEST 47TH   STREET, 2A-S",2009-10-07,569000,2017-11-13,760000,191000,2959,64.54883406556269
"255 EAST 49TH STREET, 6D",2005-08-11,1125000,2011-10-06,1270000,145000,2247,64.53048509123275
"245 EAST 93RD STREET, 25J",2006-08-22,745000,2013-03-21,900000,155000,2403,64.50270495214315
"505 GREENWICH STREET, 14F",2005-04-15,1013158,2013-03-22,1200000,186842,2898,64.4727398205659
"21 SOUTH END AVENUE, 737",2003-01-22,475000,2014-02-07,735000,260000,4034,64.45215666831929
"100 WEST 39TH STREET, 41B",2013-09-04,715000,2018-05-09,825000,110000,1708,64.40281030444964
"342 WEST 85TH   STREET, 4B",2007-05-08,860000,2012-08-30,985000,125000,1941,64.39979392065945
"220 MANHATTAN AVENUE, 7A",2006-02-21,536300,2015-08-27,760000,223700,3474,64.39263097294186
"138 WEST 124 STREET, 7B",2008-01-04,996357,2014-06-16,1148000,151643,2355,64.39193205944798
"319 EAST 105 STREET, 4C",2003-07-30,150000,2015-02-06,421000,271000,4209,64.38583986695177
"40 BROAD STREET, 18C",2010-03-22,530508,2017-01-30,691750,161242,2506,64.34237829209896
"125 CENTRAL PARK NORTH, 7A",2006-08-24,1170987,2017-06-15,1425000,254013,3948,64.33966565349544
"150 WEST 51ST STREET, 20-19",2008-07-03,655000,2017-03-28,860000,205000,3190,64.26332288401254
"100 RIVERSIDE BOULEVARD, 20G",2008-06-11,1635000,2013-05-07,1750000,115000,1791,64.20993858179787
"250 WEST 90TH STREET, 8C",2009-01-21,735000,2012-09-06,820000,85000,1324,64.19939577039275
"100 UNITED NATIONS PLAZA, 16D",2003-07-24,535000,2012-12-11,755000,220000,3428,64.17736289381564
"301 CATHEDRAL PARKWAY, 4J",2004-08-03,429000,2009-06-23,543500,114500,1785,64.14565826330532
"111 FULTON STREET, 504",2008-11-19,544763,2015-03-19,693000,148237,2311,64.14409346603202
"200 EAST 66TH   STREET, A2002",2009-05-18,4900000,2017-11-30,5100000,200000,3118,64.14368184733804
"27 WEST 72ND   STREET, G6",2008-03-18,481650,2010-12-01,545000,63350,988,64.11943319838056
"295 GREENWICH STREET, 6EN",2005-07-28,595000,2011-08-29,737500,142500,2223,64.1025641025641
"161 WEST 61ST   STREET, 35H",2010-01-13,780000,2017-04-21,950000,170000,2655,64.030131826742
"100 RIVERSIDE BOULEVARD, 14T",2008-06-13,831910,2015-08-06,999000,167090,2610,64.01915708812261
"400 CENTRAL PARK WEST, 14E",2007-07-17,435000,2014-05-21,595000,160000,2500,64.0
"635 WEST 42ND STREET, 38E",2007-08-02,1365473,2012-04-10,1475000,109527,1713,63.938704028021014
"1 MORTON SQUARE, 4B E",2004-11-10,1731025,2011-01-10,1875000,143975,2252,63.932060390763766
"220 RIVERSIDE BOULEVARD, 17W",2004-09-20,590000,2008-01-16,667500,77500,1213,63.891178895300904
"15 BROAD STREET, 2022",2006-07-07,549855,2012-12-13,700000,150145,2351,63.864313058273076
"199 BOWERY, 2B",2007-05-21,540000,2011-01-11,625000,85000,1331,63.86175807663411
"15 RENWICK STREET, 401",2016-02-19,2777786,2018-08-03,2835000,57214,896,63.854910714285715
"100 RIVERSIDE BOULEVARD, 5D",2008-02-04,754523,2016-05-23,948000,193477,3031,63.832728472451336
"530 EAST 76TH STREET, 16K",2005-06-29,780000,2008-01-25,840000,60000,940,63.829787234042556
"80 JOHN STREET, 4B",2007-05-18,871622,2018-04-03,1125000,253378,3973,63.774981122577394
"255 EAST 49 STREET, 16C",2004-06-15,535000,2009-10-28,660000,125000,1961,63.74298827129016
"184 THOMPSON STREET, 5R",2007-06-26,702592,2017-06-20,935000,232408,3647,63.72580202906499
"90 WILLIAM STREET, 4E",2008-08-08,509125,2014-08-28,650000,140875,2211,63.71551334237901
"400 CENTRAL PARK WEST, 15N",2008-03-31,840000,2010-09-15,897200,57200,898,63.69710467706013
"392 CENTRAL PARK WEST, 16K",2004-05-18,1365000,2009-02-09,1475000,110000,1728,63.657407407407405
"635 WEST 42ND STREET, 43E",2007-07-26,1351726,2013-01-31,1480000,128274,2016,63.62797619047619
"101 ALLEN STREET, 4B",2003-05-13,175000,2007-01-08,260000,85000,1336,63.622754491017965
"235 WEST END AVENUE, 1E",2004-08-26,530000,2015-03-13,775000,245000,3851,63.6198390028564
"260 PARK AVENUE SOUTH, 2K",2006-03-23,814600,2010-09-04,918000,103400,1626,63.59163591635917
"68 BRADHURST AVENUE, 8-Q",2008-07-30,392767,2016-03-18,570000,177233,2788,63.56994261119082
"11 EAST 29TH   STREET, 16B",2008-01-30,860421,2010-11-11,925000,64579,1016,63.56200787401575
"313 WEST 119 STREET, 3K",2007-08-07,687318,2018-03-08,933000,245682,3866,63.54940506983963
"16 WEST 19TH   STREET, 9-A",2007-12-14,646558,2015-07-22,823000,176442,2777,63.53691033489377
"184 THOMPSON STREET, 3K",2007-06-11,461370,2012-10-09,585000,123630,1947,63.49768875192604
"50 EAST END AVENUE, 50-1B",2006-04-07,219024,2011-09-12,345000,125976,1984,63.49596774193548
"240 PARK AVENUE SOUTH, 4C",2008-04-09,2240150,2013-01-04,2350000,109850,1731,63.460427498555745
"111 FULTON STREET, 612",2008-11-21,885877,2015-07-09,1039500,153623,2421,63.454357703428336
"16 WEST 19TH   STREET, 4-A",2007-11-27,595676,2014-07-11,749000,153324,2418,63.40942928039702
"330 EAST 38 STREET, 29J",2004-09-08,761000,2010-04-05,890000,129000,2035,63.39066339066339
"15 BROAD STREET, 2300",2006-07-25,1787028,2014-01-14,1960000,172972,2730,63.35970695970696
"219 WEST 81ST   STREET, 10E",2009-02-27,1600000,2012-08-13,1680000,80000,1263,63.34125098970705
"530 PARK AVENUE, 3A",2014-01-08,5804025,2016-01-04,5850000,45975,726,63.32644628099174
"250 SOUTH END AVENUE, 16B",2007-09-10,1200000,2017-11-07,1435000,235000,3711,63.32524925895985
"15 WILLIAM STREET, 19G",2008-12-22,957155,2016-03-29,1125000,167845,2654,63.242275810097965
"106 CENTRAL PARK SOUTH, 19N",2005-05-18,450000,2015-05-04,680000,230000,3638,63.22155030236394
"4260 BROADWAY, 402",2003-09-12,140000,2012-05-11,340000,200000,3164,63.21112515802781
"144 COLUMBUS AVENUE, 17B",2005-07-28,1150000,2012-01-26,1300000,150000,2373,63.21112515802781
"250 EAST 53RD STREET, 1603",2008-04-29,1316021,2018-06-19,1550000,233979,3703,63.18633540372671
"15 BROAD STREET, 1002",2007-05-02,743322,2013-10-18,892500,149178,2361,63.18424396442185
"280 RECTOR PLACE, 6B",2003-11-25,285000,2011-01-19,450000,165000,2612,63.16998468606432
"88 GREENWICH STREET, 821",2010-02-02,579384,2014-11-20,690000,110616,1752,63.136986301369866
"527 CATHEDRAL PARKWAY, 3",2011-02-02,320000,2016-06-27,444500,124500,1972,63.13387423935091
"845 UNITED NATIONS PLAZA, 24F",2004-03-29,475000,2017-11-28,790000,315000,4992,63.10096153846154
"111 FULTON STREET, 502",2008-12-10,534581,2015-04-03,680000,145419,2305,63.0885032537961
"300 RECTOR PLACE, 5E",2003-05-30,305000,2010-10-15,475000,170000,2695,63.07977736549165
"447 WEST 18TH   STREET, 5B",2008-09-25,1145531,2011-12-20,1220000,74469,1181,63.05588484335309
"50 FRANKLIN STREET, 3B",2010-01-29,595676,2018-07-09,790000,194324,3083,63.03081414206941
"382 CENTRAL PARK WEST, 3M",2010-02-03,740000,2013-08-16,821240,81240,1290,62.97674418604651
"392 CENTRAL PARK WEST, 3U",2006-04-10,325000,2013-05-29,489000,164000,2606,62.93169608595549
"150 NASSAU STREET, 6K",2004-04-19,350000,2018-03-08,669000,319000,5071,62.906724511930584
"20 WEST 64 STREET, 36S",2005-06-28,798000,2012-10-04,965000,167000,2655,62.900188323917135
"172 WEST 79TH STREET, 9B",2008-05-30,1100000,2015-08-06,1265000,165000,2624,62.88109756097561
"120 RIVERSIDE BOULEVARD, 7P",2006-01-12,606367,2013-05-17,775000,168633,2682,62.875838926174495
"230 RIVERSIDE DRIVE, 7E",2007-04-13,677136,2014-08-04,845000,167864,2670,62.87041198501873
"56 PINE STREET, 9A",2006-01-24,486720,2014-06-26,680000,193280,3075,62.855284552845525
"201 EAST 36TH STREET, 11C",2004-09-07,925000,2013-03-08,1120000,195000,3104,62.82216494845361
"56 PINE STREET, 11D",2005-11-28,466440,2015-08-27,690000,223560,3559,62.815397583590894
"253 WEST 73RD   STREET, 1E",2009-08-31,625000,2014-01-10,725000,100000,1593,62.77463904582549
"310 EAST 53RD   STREET, 14A",2007-03-15,2291062,2013-01-16,2425000,133938,2134,62.763823805060916
"420 CENTRAL PARK WEST, 1F",2012-12-28,450000,2017-10-18,560000,110000,1755,62.67806267806268
"350 WEST 42ND STREET, 5F",2006-05-31,591603,2011-02-24,700000,108397,1730,62.65722543352601
"184 THOMPSON STREET, MF",2007-12-17,549855,2014-07-10,700000,150145,2397,62.63871506049228
"130 BARROW STREET, 310",2007-05-24,850000,2018-05-01,1100000,250000,3995,62.57822277847309
"200 EAST 66TH STREET, B1802",2008-12-30,1577573,2017-09-06,1776000,198427,3172,62.55580075662043
"30 WEST 63RD   STREET, 31FGH",2011-08-12,4836687,2014-05-21,4900000,63313,1013,62.5004935834156
"111 FULTON STREET, 307",2008-11-21,707683,2014-09-09,840000,132317,2118,62.47261567516525
"418 CENTRAL PARK WEST, 80",2003-09-29,350000,2010-04-28,500000,150000,2403,62.421972534332085
"630 1 AVENUE, 19R",2009-02-24,707000,2011-01-14,750000,43000,689,62.40928882438316
"80 PARK AVENUE, 6B",2010-06-24,500000,2018-08-06,685000,185000,2965,62.39460370994941
"330 EAST 38TH STREET, 8P",2007-10-09,899000,2018-07-30,1145000,246000,3947,62.32581707626045
"80 JOHN STREET, 9I",2007-04-24,758799,2015-09-17,950000,191201,3068,62.321056062581484
"200 WEST END AVENUE, 6N",2008-01-08,787107,2014-09-30,940000,152893,2457,62.22751322751323
"530 EAST 76TH STREET, 11A",2004-09-03,715000,2008-05-15,799000,84000,1350,62.22222222222222
"221 WEST 148 STREET, 1A",2010-05-06,195000,2018-06-27,380000,185000,2974,62.205783456624076
"421 EAST 13TH   STREET, 3L",2008-01-23,717866,2017-07-06,932500,214634,3452,62.17670915411356
"1 IRVING PLACE, G8L",2006-07-14,565000,2016-03-24,785000,220000,3541,62.129341993787065
"160 WEST 12TH STREET, 82",2016-05-24,5852877,2018-06-22,5900000,47123,759,62.08563899868248
"161 WEST 61 STREET, 5E",2004-03-04,585000,2013-01-31,787050,202050,3255,62.07373271889401
"75 WALL STREET, 32H",2011-02-14,565128,2014-11-13,650000,84872,1368,62.04093567251462
"200 RIVERSIDE BOULEVARD, 4H",2005-09-22,1399000,2014-08-07,1600000,201000,3241,62.01789571120025
"377 RECTOR PLACE, 6H",2005-03-31,485000,2016-12-19,750000,265000,4281,61.90142490072413
"1031 6 AVENUE, 41D",2006-08-15,692410,2008-09-22,740000,47590,769,61.88556566970091
"155 EAST 34TH STREET, 20L",2003-01-23,325000,2011-01-10,505000,180000,2909,61.876933654176696
"340 EAST 23RD STREET, 12G",2008-03-11,560037,2015-09-18,730000,169963,2747,61.87222424463051
"106 CENTRAL PARK SOUTH, 12E",2004-07-27,342000,2013-11-13,552000,210000,3396,61.83745583038869
"510 CATHEDRAL PARKWAY, 10F",2006-01-25,510000,2015-01-13,712500,202500,3275,61.83206106870229
"158 EAST 100 STREET, 6R",2007-07-09,505986,2015-09-03,690000,184014,2978,61.79113498992613
"445 WEST 54 STREET, 7A",2004-05-25,732000,2013-08-13,940000,208000,3367,61.77606177606177
"310 EAST HOUSTON STREET, 5A",2007-07-27,778961,2014-09-15,940000,161039,2607,61.77176831607211
"301 CATHEDRAL PARKWAY, 15J",2006-04-10,579000,2015-05-28,785000,206000,3335,61.76911544227886
"68 BRADHURST AVENUE, 1-V",2008-02-01,455034,2013-04-25,573000,117966,1910,61.76230366492147
"220 RIVERSIDE BOULEVARD, 5T",2005-09-22,1260000,2014-06-25,1457500,197500,3198,61.757348342714195
"20 WEST STREET, 22F",2006-07-11,533563,2017-01-03,770000,236437,3829,61.749020632018805
"555 WEST 23RD   STREET, S12G",2006-02-28,768778,2014-03-13,950000,181222,2935,61.74514480408859
"345 EAST 80TH STREET, 6K",2005-01-27,495000,2016-08-23,755832,260832,4226,61.72077614765736
"40 BROAD STREET, 26F",2010-04-06,543745,2014-12-23,650000,106255,1722,61.70441347270616
"1 IRVING PLACE, P11H",2005-10-19,572500,2008-10-17,640000,67500,1094,61.70018281535649
"504 WEST 110TH STREET, 8F",2008-11-24,540000,2010-08-10,578500,38500,624,61.69871794871795
"104 WEST 70TH STREET, 6B",2011-07-01,1730000,2017-12-07,1875000,145000,2351,61.6758826031476
"305 2 AVENUE, 502",2006-11-20,946972,2013-06-17,1095000,148028,2401,61.65264473136193
"116 CENTRAL PARK SOUTH, 8G",2005-03-29,455000,2013-02-05,631824,176824,2870,61.611149825783976
"255 CABRINI BOULEVARD, 8D",2003-06-18,349000,2015-08-14,622500,273500,4440,61.5990990990991
"303 GREENWICH STREET, 9A",2006-01-25,650000,2014-07-07,840000,190000,3085,61.58833063209076
"13 EAST 131 STREET, 5B",2003-09-02,344253,2017-01-17,645000,300747,4886,61.55280392959476
"200 RIVERSIDE BOULEVARD, 15G",2005-01-19,675000,2016-03-04,925000,250000,4062,61.54603643525357
"121 WEST 19TH STREET, 9D",2007-04-20,1300000,2012-03-12,1410000,110000,1788,61.52125279642058
"520 EAST 81ST   STREET, 2M",2008-04-08,400000,2018-01-25,620000,220000,3579,61.46968426934898
"275 GREENWICH STREET, 9FS",2004-04-15,525000,2013-01-07,721000,196000,3189,61.4612731263719
"421 EAST 13TH   STREET, 6L",2008-03-14,738231,2016-02-03,915000,176769,2882,61.33553088133241
"319 EAST 105TH STREET, 4B",2005-06-20,248000,2014-06-11,449000,201000,3278,61.317876754118366
"530 EAST 76TH STREET, 17G",2013-07-25,1570000,2017-08-03,1660000,90000,1470,61.224489795918366
"230 RIVERSIDE DRIVE, 6P",2006-12-06,677136,2013-07-18,825000,147864,2416,61.20198675496689
"21 SOUTH END AVENUE, 231",2004-03-01,273000,2007-11-01,355000,82000,1340,61.19402985074627
"1600 BROADWAY, PH3A",2006-08-09,962246,2018-08-02,1230000,267754,4376,61.18692870201097
"230 RIVERSIDE DRIVE, 5O",2006-11-29,962246,2014-03-12,1125000,162754,2660,61.18571428571428
"2000 BROADWAY, 6C",2004-09-24,450000,2011-11-22,610000,160000,2615,61.185468451242826
"200 RIVERSIDE BOULEVARD, 42D",2004-10-29,1450000,2012-08-31,1625000,175000,2863,61.12469437652812
"225 RECTOR PLACE, 17F",2008-05-19,784052,2016-01-15,955000,170948,2797,61.11834107972828
"340 WEST 86 STREET, 4D",2005-04-27,610000,2016-01-28,850000,240000,3928,61.09979633401222
"2250 BROADWAY, 2M",2003-05-02,296000,2016-12-20,600000,304000,4981,61.03192130094359
"404 EAST 76TH   STREET, 7M",2009-01-12,465000,2016-08-30,635000,170000,2787,60.99748833871546
"130 WEST 19TH   STREET, 6B",2007-05-29,1425550,2008-07-03,1450000,24450,401,60.97256857855361
"45 PARK AVENUE, 701",2007-12-07,1980496,2011-01-20,2050000,69504,1140,60.96842105263158
"50 WEST 15TH STREET, 7A",2008-10-29,773870,2017-08-21,970000,196130,3218,60.947793660658796
"117 EAST 57TH, 31G",2004-12-09,725000,2012-10-22,900000,175000,2874,60.890744606819766
"382 CENTRAL PARK WEST, 15M",2004-07-28,630000,2013-05-06,825000,195000,3204,60.86142322097378
"154 ATTORNEY STREET, 203",2006-11-29,753505,2013-09-26,905000,151495,2493,60.768150822302445
"330 EAST 38 STREET, 53C",2005-03-22,950000,2017-11-03,1230000,280000,4609,60.750705142113254
"107 AVENUE A, 4R",2006-04-04,597712,2013-02-13,750000,152288,2507,60.745113681691265
"150 NASSAU STREET, 19D",2003-05-29,1231149,2007-08-21,1325000,93851,1545,60.74498381877023
"300 ALBANY STREET, 3N",2003-05-29,230000,2018-05-01,561045,331045,5451,60.731058521372226
"15 WILLIAM STREET, 18A",2009-01-20,1644473,2015-03-02,1780000,135527,2232,60.71998207885304
"250 EAST 65TH   STREET, 5D",2007-02-07,850000,2017-06-22,1080000,230000,3788,60.71805702217529
"100 RIVERSIDE BOULEVARD, 5E",2008-02-07,841583,2015-01-09,995000,153417,2528,60.68710443037975
"247 WEST 46TH STREET, 2505",2010-06-30,935000,2013-05-20,999000,64000,1055,60.66350710900474
"18 PINE STREET, 2210",2010-06-28,670000,2015-06-16,780000,110000,1814,60.639470782800444
"150 NASSAU STREET, 7J",2004-04-21,250000,2013-10-16,460000,210000,3465,60.60606060606061
"394 MANHATTAN AVENUE, 1",2007-04-25,950000,2013-08-22,1090000,140000,2311,60.57983556901774
"1420 YORK AVENUE, 5N",2003-10-08,175000,2017-07-21,480000,305000,5035,60.5759682224429
"253 WEST 73RD STREET, 2J",2012-07-23,965000,2018-08-30,1100000,135000,2229,60.56527590847914
"635 WEST 42ND   STREET, 2M",2008-03-28,1328816,2018-03-29,1550000,221184,3653,60.54859019983575
"220 RIVERSIDE BOULEVARD, 9F",2004-11-23,815000,2013-06-27,1005000,190000,3138,60.548119821542386
"1400 5 AVENUE, 7P-DU",2005-02-08,780000,2010-06-28,899000,119000,1966,60.52899287894201
"200 EAST 69TH STREET, 7M",2005-07-14,760000,2018-03-15,1040000,280000,4627,60.514372163388806
"115 NORFOLK STREET, 503",2012-05-03,860421,2018-08-13,999000,138579,2293,60.435673789795025
"300 EAST 64TH STREET, 15A",2015-07-01,1850000,2017-10-06,1900000,50000,828,60.38647342995169
"464 WEST 44TH   STREET, 3C",2008-02-15,820699,2016-01-11,995000,174301,2887,60.37443713197091
"310 WEST 52ND STREET, 30A",2009-08-20,1050000,2012-05-10,1110000,60000,994,60.36217303822938
"420 WEST 23RD   STREET, 4B",2007-06-21,775000,2017-08-18,999000,224000,3711,60.361088655348965
"382 CENTRAL PARK WEST, 18U",2004-11-11,420000,2013-06-26,610000,190000,3149,60.336614798348684
"88 GREENWICH STREET, 322",2010-08-23,563000,2016-11-10,700000,137000,2271,60.3258476442096
"56 PINE STREET, 8G",2005-10-14,514216,2013-10-10,690000,175784,2918,60.24126113776559
"20 WEST STREET, 22G",2006-06-13,532749,2015-06-03,730000,197251,3277,60.19255416539518
"342 EAST 110 STREET, 4C",2009-11-20,405000,2015-02-13,520000,115000,1911,60.17791732077446
"400 CENTRAL PARK WEST, 4S",2007-09-05,460000,2018-08-09,700000,240000,3991,60.1353044349787
"230 RIVERSIDE DRIVE, 18O",2007-05-21,486720,2018-03-28,725000,238280,3964,60.11099899091826
"175 WEST 12TH STREET, 3K",2007-07-26,675000,2017-02-17,885000,210000,3494,60.10303377218088
"300 RECTOR PLACE, 8C",2004-09-15,385000,2016-07-22,645000,260000,4328,60.07393715341959
"103 NORFOLK STREET, 6A",2007-03-15,880786,2013-08-29,1022500,141714,2359,60.07376006782535
"220 RIVERSIDE BOULEVARD, 6M",2005-08-15,2007000,2014-06-02,2200000,193000,3213,60.06847183317772
"261 WEST 28TH STREET, 9C",2008-05-16,1272812,2014-08-18,1410000,137188,2285,60.03851203501094
"21 SOUTH END AVENUE, PH2BB",2006-05-04,385000,2008-11-06,440000,55000,917,59.978189749182114
"10 WEST END AVENUE, 12J",2007-11-19,756689,2017-11-07,975000,218311,3641,59.959077176599834
"400 EAST 51ST STREET, 7A",2009-12-18,1075000,2011-02-08,1100000,25000,417,59.95203836930455
"90 WILLIAM STREET, 9B",2008-07-15,1280958,2017-11-09,1485000,204042,3404,59.94183313748531
"392 CENTRAL PARK WEST, 19T",2003-10-07,282500,2009-10-27,415000,132500,2212,59.90054249547921
"460 EAST 79 STREET, 12F",2004-05-18,560000,2013-06-24,759000,199000,3324,59.8676293622142
"422 EAST 72ND STREET, 42A",2007-08-22,2700000,2016-10-14,2900000,200000,3341,59.86231667165519
"247 WEST 115 STREET, 2B",2008-10-22,504972,2015-06-11,650000,145028,2423,59.85472554684276
"68 BRADHURST AVENUE, 10-W",2008-04-07,405317,2016-09-01,589000,183683,3069,59.85109156076898
"165 CHARLES STREET, RU4",2005-10-05,1272812,2018-06-12,1550000,277188,4633,59.82905244981654
"2 SOUTH END AVENUE, 9C",2005-11-21,630000,2015-12-18,850000,220000,3679,59.798858385430826
"680 RIVERSIDE DRIVE, 5B",2008-08-04,329550,2016-03-02,495000,165450,2767,59.79400072280448
"255 HUDSON STREET, 8D",2007-08-28,1323725,2015-04-09,1490000,166275,2781,59.78964401294498
"184 THOMPSON STREET, LD",2007-05-03,804417,2014-07-21,962000,157583,2636,59.781107738998486
"100 UNITED NATIONS PLAZA, 8F",2003-10-22,430000,2017-02-03,720000,290000,4853,59.75685143210385
"20 WEST STREET, 14A",2007-04-04,385320,2016-11-17,595000,209680,3515,59.652916073968704
"16 WEST 19TH   STREET, 9-F",2009-02-06,1191097,2012-09-21,1270000,78903,1323,59.63945578231292
"120 RIVERSIDE BOULEVARD, 6C",2005-12-13,428313,2012-11-30,580000,151687,2544,59.625393081761004
"99 JOHN STREET, 802",2013-09-30,549855,2017-08-28,635000,85145,1428,59.62535014005602
"255 HUDSON STREET, 4F",2006-10-03,890968,2014-09-30,1065000,174032,2919,59.620417951353204
"123 BAXTER STREET, 4B",2007-10-15,1845000,2017-03-15,2050000,205000,3439,59.610351846467
"122 GREENWICH AVENUE, 2",2009-09-04,2825643,2016-11-18,2982500,156857,2632,59.59612462006079
"222 RIVERSIDE DRIVE, 2C",2005-08-31,1225000,2013-08-29,1399000,174000,2920,59.58904109589041
"350 WEST 42ND STREET, 18M",2006-07-13,684264,2013-09-12,840000,155736,2618,59.48663101604278
"18 WEST 48TH STREET, 33A",2007-06-27,2092503,2014-04-14,2240150,147647,2483,59.463149416029
"80 JOHN STREET, 13F",2007-04-26,633606,2018-08-30,880000,246394,4144,59.45801158301158
"310 WEST 52ND   STREET, 9J",2007-01-22,997885,2011-10-06,1100000,102115,1718,59.438300349243306
"99 BATTERY PLACE, 18-K",2005-04-13,390000,2017-06-29,655000,265000,4460,59.417040358744394
"1437 3 AVENUE, 19A",2005-07-22,1702000,2018-05-14,1980000,278000,4679,59.41440478734772
"300 ALBANY STREET, 8K",2003-01-14,240000,2015-06-25,510000,270000,4545,59.40594059405941
"15 BROAD STREET, 3508",2006-11-22,911333,2008-09-03,950000,38667,651,59.3963133640553
"516 WEST 47TH STREET, N7D",2013-12-09,525000,2017-11-10,610000,85000,1432,59.357541899441344
"35 EAST 38TH STREET, 8E",2004-08-04,399000,2014-07-22,615000,216000,3639,59.35696619950536
"635 WEST 42ND   STREET, 2J",2007-08-29,712775,2017-11-29,935000,222225,3745,59.33911882510014
"100 WEST 18TH STREET, 5D",2008-05-27,1731025,2011-02-16,1790000,58975,995,59.2713567839196
"120 RIVERSIDE BOULEVARD, 7U",2006-01-06,471510,2017-09-27,725000,253490,4282,59.19897244278375
"380 RECTOR PLACE, 12C",2006-12-14,620000,2017-08-04,850000,230000,3886,59.18682449819866
"225 WEST 83RD   STREET, 15A",2007-05-18,925000,2014-10-14,1085000,160000,2706,59.127864005912784
"300 EAST 93RD STREET, 23D",2005-02-24,320000,2017-07-26,588000,268000,4535,59.09592061742006
"120 RIVERSIDE BOULEVARD, PH3A",2006-06-29,1759536,2010-09-07,1850000,90464,1531,59.088177661659046
"1600 BROADWAY, PH2D",2006-09-20,2846008,2016-02-29,3049658,203650,3449,59.04610031893302
"77 PARK AVENUE, 14H",2004-10-19,800000,2012-06-14,965000,165000,2795,59.03398926654741
"300 EAST 55TH STREET, 8D",2005-03-01,1486645,2018-07-19,1775000,288355,4888,58.99243044189853
"111 FULTON STREET, 403",2008-12-30,570000,2016-08-29,735000,165000,2799,58.949624866023576
"184 THOMPSON STREET, 4T",2007-05-02,471510,2010-09-30,545000,73490,1247,58.93344025661588
"250 WEST 90TH   STREET, 4G",2007-03-28,699000,2015-06-04,875000,176000,2990,58.862876254180605
"392 CENTRAL PARK WEST, 14S",2005-04-21,379000,2014-11-24,585000,206000,3504,58.789954337899545
"150 WEST 51ST STREET, 17-23",2005-07-19,560000,2018-08-03,840000,280000,4763,58.786479109804745
"20 WEST STREET, 21A",2007-03-26,410670,2014-07-15,567500,156830,2668,58.78185907046477
"236 EAST 47TH STREET, 20C",2007-01-16,622000,2016-09-26,830000,208000,3541,58.74046879412595
"415 EAST 37TH   STREET, 25N",2008-10-17,825000,2018-02-12,1025000,200000,3405,58.737151248164466
"100 UNITED NATIONS PLAZA, 23A",2004-07-30,1300000,2011-07-28,1450000,150000,2554,58.73140172278779
"300 EAST 55TH   STREET, 16B",2011-10-26,2550000,2016-06-24,2650000,100000,1703,58.71990604815032
"392 CENTRAL PARK WEST, 16S",2006-09-12,463500,2014-06-19,630000,166500,2837,58.68875572788156
"106 CENTRAL PARK SOUTH, 2G",2003-12-04,385000,2012-04-30,565000,180000,3070,58.63192182410423
"201 EAST 36TH STREET, 4E",2004-11-24,560000,2015-12-15,796688,236688,4038,58.61515601783061
"40 BROAD STREET, 12F",2011-05-05,499761,2013-03-22,540000,40239,687,58.572052401746724
"464 WEST 44TH   STREET, 7F",2008-02-28,1496817,2016-09-21,1680000,183183,3128,58.56234015345269
"122 GREENWICH AVENUE, 1",2010-04-21,2275000,2013-10-23,2350000,75000,1281,58.5480093676815
"1600 BROADWAY, 10B",2008-08-06,834965,2013-01-16,930000,95035,1624,58.51908866995074
"736 WEST 187 STREET, 305",2005-10-25,643534,2014-04-22,825000,181466,3101,58.51854240567559
"100 RIVERSIDE BOULEVARD, 14J",2008-08-05,942797,2013-08-12,1050000,107203,1833,58.48499727223132
"205 EAST 68TH   STREET, T6B",2009-01-22,500000,2015-08-13,640000,140000,2394,58.47953216374269
"305 WEST 18TH STREET, 1K",2004-09-30,520000,2018-08-27,817000,297000,5079,58.47607796810396
"100 UNITED NATIONS PLAZA, 6F",2004-12-15,495000,2016-11-23,750000,255000,4361,58.47282733318046
"57 READE STREET, 9A",2012-11-28,1715000,2018-08-16,1837000,122000,2087,58.4571154767609
"295 GREENWICH STREET, 9GN",2007-01-29,815000,2010-08-04,890000,75000,1283,58.456742010911924
"100 UNITED NATIONS PLAZA, 9C",2008-08-14,775000,2015-11-20,930000,155000,2654,58.40241145440844
"201 WEST 74TH STREET, 12F",2005-06-21,699000,2013-07-01,870000,171000,2932,58.32196452933152
"400 CENTRAL PARK WEST, 10G",2006-03-17,490000,2018-08-29,755000,265000,4548,58.26737027264732
"415 EAST 54TH   STREET, 6 C",2013-06-27,1355000,2017-12-14,1450000,95000,1631,58.24647455548743
"10 WEST END AVENUE, 9G",2007-07-31,865512,2013-11-08,999000,133488,2292,58.24083769633508
"1991 BROADWAY, 8C",2004-10-28,437000,2018-08-08,730000,293000,5032,58.227344992050874
"215 WEST 95TH STREET, 14H",2006-12-15,982125,2010-02-23,1050000,67875,1166,58.211835334476845
"50 BAYARD STREET, 3N",2007-08-13,250000,2014-09-03,400000,150000,2578,58.18463925523662
"21 SOUTH END AVENUE, 207",2004-11-05,582500,2014-08-12,790000,207500,3567,58.17213344547238
"175 EAST BROADWAY, 3D",2006-11-20,1120075,2010-08-25,1200000,79925,1374,58.16957787481805
"354 BROOME STREET, 4C",2004-08-19,1325000,2011-09-12,1475000,150000,2580,58.13953488372093
"1965 BROADWAY, 18B",2005-03-31,5500000,2011-02-18,5625000,125000,2150,58.13953488372093
"516 WEST 47TH STREET, S4M",2007-06-21,618000,2016-07-06,810000,192000,3303,58.12897366030881
"250 SOUTH END AVENUE, 2A",2004-07-30,355000,2013-05-30,542500,187500,3226,58.12151270923744
"300 CATHEDRAL PARKWAY, 14D",2004-08-26,349000,2014-09-25,563000,214000,3682,58.1205866376969
"871 8 AVENUE, 3D",2005-08-17,600000,2018-08-01,875000,275000,4732,58.11496196111581
"80 PARK AVENUE, 15A-B",2004-12-16,1400000,2009-09-03,1500000,100000,1722,58.07200929152149
"45 PARK AVENUE, 1602",2007-12-27,1344090,2012-12-26,1450000,105910,1826,58.00109529025192
"80 JOHN STREET, 4D",2007-01-23,486300,2018-07-26,730000,243700,4202,57.99619228938601
"350 WEST 42ND STREET, 10I",2006-05-19,500979,2013-08-26,655000,154021,2656,57.9898343373494
"199 PRINCE STREET, 17",2004-12-21,587000,2011-06-28,725000,138000,2380,57.983193277310924
"382 CENTRAL PARK WEST, 16U",2008-01-17,626223,2018-02-20,840000,213777,3687,57.981285598047194
"15 WILLIAM STREET, 34F",2009-08-07,1170987,2015-06-17,1295000,124013,2140,57.95
"610 WEST 110TH STREET, 15D",2008-08-29,1196443,2018-03-27,1399000,202557,3497,57.92307692307692
"306 MOTT STREET, 6C",2004-07-23,262626,2018-04-23,553500,290874,5022,57.91995221027479
"300 RECTOR PLACE, 8H",2004-02-26,335000,2014-10-16,560000,225000,3885,57.915057915057915
"421 EAST 13TH   STREET, 3G",2008-01-15,789143,2017-12-18,999000,209857,3625,57.891586206896555
"20 CLINTON STREET, 6E",2005-06-03,926000,2013-08-26,1100000,174000,3006,57.884231536926144
"350 WEST 50TH   STREET, 2GG",2012-07-18,405000,2018-02-08,522500,117500,2031,57.85327424913836
"510 EAST 80TH   STREET, 10G",2006-12-15,527000,2017-12-08,759000,232000,4011,57.840937422089254
"106 CENTRAL PARK SOUTH, 11O",2005-03-16,425000,2015-11-09,650000,225000,3890,57.840616966580974
"400 EAST 70TH   STREET, 1906",2013-06-03,860000,2017-07-25,947500,87500,1513,57.83212161269002
"350 WEST 42ND   STREET, 4A",2006-12-27,660844,2018-04-23,899887,239043,4135,57.80967351874244
"301 EAST 79TH   STREET, 18 S",2013-09-04,870000,2018-04-18,967500,97500,1687,57.79490219324244
"240 EAST 47TH STREET, 34B",2006-09-26,1175000,2013-11-06,1325000,150000,2598,57.736720554272516
"100 RIVERSIDE BOULEVARD, 11P",2008-04-24,1501918,2016-04-15,1670000,168082,2913,57.700652248541026
"111 FULTON STREET, 404",2008-11-17,575311,2017-08-24,760000,184689,3202,57.679262960649595
"111 FULTON STREET, 410",2008-11-19,697501,2017-07-21,880000,182499,3166,57.64339861023373
"200 RIVERSIDE BOULEVARD, 11F",2005-04-29,725000,2017-03-17,975000,250000,4340,57.6036866359447
"295 GREENWICH STREET, 6MN",2007-08-30,472000,2014-06-17,615000,143000,2483,57.59162303664922
"15 WILLIAM STREET, 16G",2009-01-07,926607,2014-08-25,1045000,118393,2056,57.584143968871594
"308 EAST 72ND STREET, 17A",2005-04-18,3100000,2010-01-19,3200000,100000,1737,57.570523891767415
"100 RIVERSIDE BOULEVARD, 9B",2008-06-12,946972,2015-09-23,1100000,153028,2659,57.55095900714554
"350 WEST 50 STREET, 34I",2004-11-17,583750,2017-01-27,840000,256250,4454,57.53255500673552
"701 MADISON AVENUE, 10D",2006-05-09,500000,2013-02-19,642500,142500,2478,57.506053268765136
"270 WEST 19TH STREET, 5B",2005-11-16,1216808,2011-08-17,1337500,120692,2100,57.47238095238095
"8-10 WEST 19TH STREET, R8",2005-09-23,4400000,2010-06-29,4500000,100000,1740,57.47126436781609
"50 WEST 127TH STREET, 4A",2007-10-22,585493,2015-08-25,750000,164507,2864,57.43959497206704
"315 7TH AVENUE, 10C",2007-07-26,490000,2012-05-01,590000,100000,1741,57.43825387708214
"425 EAST 13TH   STREET, 4L",2008-01-14,728048,2017-07-18,927500,199452,3473,57.42931183414915
"225 RECTOR PLACE, 3K",2008-11-10,682227,2015-09-02,825000,142773,2487,57.407720144752716
"250 EAST 54TH STREET, 14E",2004-06-09,368500,2016-11-29,630000,261500,4556,57.39683933274802
"303 EAST 43RD STREET, 2B",2007-06-27,1550000,2013-06-13,1675000,125000,2178,57.3921028466483
"100 WEST 119TH STREET, 7B",2006-05-12,1306414,2014-05-29,1475000,168586,2939,57.361687648860155
"392 CENTRAL PARK WEST, 12U",2005-12-13,449000,2008-11-12,510000,61000,1065,57.27699530516432
"150 EAST 85TH STREET, 4F",2007-01-30,629000,2017-08-24,850000,221000,3859,57.268722466960355
"40 WEST 55TH STREET, 3D",2007-07-19,1201535,2014-04-15,1342500,140965,2462,57.256295694557274
"444 WEST 19TH STREET, 303",2006-07-20,828000,2012-05-21,950000,122000,2132,57.22326454033771
"150 NASSAU STREET, 6G",2005-01-11,630000,2017-12-15,900000,270000,4721,57.19127303537386
"300 EAST 33 STREET, 6-H",2004-11-29,340000,2005-05-23,350000,10000,175,57.142857142857146
"205 EAST 68TH STREET, T4E",2008-01-24,695000,2018-02-15,905000,210000,3675,57.142857142857146
"199 BOWERY, 7E",2006-05-08,395460,2011-05-12,500000,104540,1830,57.12568306010929
"200 WEST END AVENUE, 7L",2008-01-22,1349181,2013-06-28,1462500,113319,1984,57.116431451612904
"20 WEST STREET, 38H",2006-06-01,466440,2016-03-04,670000,203560,3564,57.11560044893378
"350 WEST 42ND STREET, 14C",2006-06-08,607895,2012-04-16,730000,122105,2139,57.085086489013555
"571 ACADEMY STREET, 2A",2005-08-16,220000,2012-08-01,365000,145000,2542,57.041699449252555
"13 MORTON STREET, APT4",2006-05-02,1064250,2016-09-12,1280000,215750,3786,56.986265187533014
"230 RIVERSIDE DRIVE, 2J",2007-05-31,375180,2013-05-30,500000,124820,2191,56.96942035600183
"200 CHAMBERS STREET, 2U",2007-02-26,778961,2010-07-27,850000,71039,1247,56.967923015236565
"211 WEST 71 STREET, 5B",2004-12-08,600000,2011-09-01,740000,140000,2458,56.95687550854353
"517 WEST 46TH   STREET, 504",2008-02-13,661862,2017-11-20,865000,203138,3568,56.93329596412556
"125 CENTRAL PARK NORTH, PH5",2006-09-26,1705568,2014-04-15,1862500,156932,2758,56.90065264684554
"230 RIVERSIDE DRIVE, 8F",2007-07-18,410670,2016-05-31,595000,184330,3240,56.891975308641975
"350 WEST 50TH STREET, 35C",2006-06-13,715000,2015-08-05,905000,190000,3340,56.88622754491018
"111 FULTON STREET, 702",2009-01-12,549855,2015-09-25,689000,139145,2447,56.86350633428688
"422 EAST 72ND STREET, 3A",2007-09-20,1500000,2013-01-07,1610000,110000,1936,56.81818181818182
"425 MAIN STREET, 10L",2007-07-16,400000,2008-05-22,417664,17664,311,56.79742765273312
"40 BROAD STREET, 14H",2011-12-08,1151000,2018-02-27,1280000,129000,2273,56.75318961724593
"455 CENTRAL PARK WEST, 21C",2005-09-29,3640243,2018-04-12,3900000,259757,4578,56.74027959807776
"100 WEST 18TH STREET, 3B",2008-05-21,1527375,2011-11-22,1600000,72625,1280,56.73828125
"502 PARK AVENUE, 11J",2004-07-09,737213,2011-05-31,880000,142787,2517,56.72904251092571
"82 BEAVER STREET, 1009",2007-05-23,890968,2015-04-29,1055000,164032,2898,56.601794340924776
"68 BRADHURST AVENUE, 1-U",2007-05-21,650000,2018-07-06,880000,230000,4064,56.59448818897638
"75 WALL STREET, 27E",2011-09-20,707683,2017-11-17,835000,127317,2250,56.58533333333333
"215 EAST 80TH   STREET, 8E",2006-12-27,895000,2018-02-12,1125000,230000,4065,56.580565805658054
"75 ALLEN STREET, 2A",2004-04-27,300000,2018-06-22,591888,291888,5169,56.468949506674406
"159 WEST 53RD   STREET, 31A",2008-09-26,582000,2014-06-19,700000,118000,2092,56.40535372848949
"350 WEST 53RD   STREET, 2C",2015-05-13,1711000,2017-08-15,1757500,46500,825,56.36363636363637
"230 RIVERSIDE DRIVE, 5P",2007-02-08,666953,2013-07-10,799000,132047,2344,56.33404436860068
"255 HUDSON STREET, 6E",2007-06-15,1527375,2017-07-18,1735000,207625,3686,56.32799782962561
"203 WEST 81ST STREET, 5B",2005-06-06,1401150,2013-02-14,1559375,158225,2810,56.30782918149466
"56 PINE STREET, 11B",2005-12-08,441090,2017-10-20,685000,243910,4334,56.27826488232579
"780 WEST END AVENUE, 6D",2004-05-13,900000,2012-05-23,1065000,165000,2932,56.27557980900409
"504 WEST 136 STREET, 6D",2006-10-24,621132,2017-06-19,840000,218868,3891,56.24980724749422
"1438 THIRD AVENUE, 23A",2007-07-02,934753,2016-01-12,1110000,175247,3116,56.24101412066752
"15 BROAD STREET, 2306",2006-08-04,1084436,2016-02-12,1280000,195564,3479,56.21270480022995
"307 WEST 126 STREET, 4A",2007-08-15,481650,2014-02-12,615000,133350,2373,56.19469026548673
"350 WEST 42ND STREET, 39H",2006-09-12,878240,2010-03-12,950000,71760,1277,56.194205168363354
"220 RIVERSIDE BOULEVARD, 28E",2006-09-06,980000,2015-06-18,1160000,180000,3207,56.12722170252572
"871 8 AVENUE, 5B",2005-01-03,599000,2014-09-04,797000,198000,3531,56.074766355140184
"300 ALBANY STREET, 7L",2005-08-18,346500,2017-08-31,593000,246500,4396,56.073703366696996
"280 RECTOR PLACE, 5P",2003-05-21,252000,2017-09-15,545000,293000,5231,56.01223475434907
"50 RIVERSIDE BOULEVARD, 5E",2015-08-28,2132142,2017-08-09,2172000,39858,712,55.98033707865169
"16 WEST 19TH   STREET, 10-C",2007-11-27,1099710,2012-04-27,1190000,90290,1613,55.97644141351519
"101 WARREN STREET, 1180",2008-09-04,1908847,2011-11-30,1975000,66153,1182,55.96700507614213
"100 RIVERSIDE BOULEVARD, 5K",2008-02-08,1201535,2015-05-15,1350000,148465,2653,55.96117602713909
"157 EAST 32ND   STREET, 3A",2008-09-24,690000,2017-10-31,876000,186000,3324,55.95667870036101
"106 CENTRAL PARK SOUTH, 9O",2005-12-16,430000,2013-10-15,590000,160000,2860,55.94405594405595
"69 EAST 130 STREET, 6C",2006-06-27,621132,2018-08-17,869000,247868,4434,55.901668921966625
"135 WEST 52ND STREET, 14C",2015-12-02,1659747,2017-11-21,1699990,40243,720,55.893055555555556
"280 PARK AVENUE SOUTH, 23M",2007-09-10,1285000,2018-03-23,1500000,215000,3847,55.88770470496491
"58 THOMAS STREET, 6",2006-04-19,2876556,2011-02-15,2975000,98444,1763,55.838910947249005
"54 WEST 74TH STREET, 306",2007-05-16,735000,2015-06-18,900000,165000,2955,55.83756345177665
"21 SOUTH END AVENUE, 635",2007-02-05,430000,2017-09-27,647000,217000,3887,55.827116027784925
"372 CENTRAL PARK WEST, 17T",2010-01-11,475000,2016-02-29,600000,125000,2240,55.80357142857143
"20 WEST STREET, 11D",2006-07-20,395460,2016-08-04,600000,204540,3668,55.76335877862596
"425 CENTRAL PARK WEST, 3H",2007-11-01,436752,2008-12-22,460000,23248,417,55.750599520383695
"82 BEAVER STREET, PH08",2007-04-18,391404,2017-01-19,590000,198596,3564,55.72278338945006
"4260 BROADWAY, 601",2005-02-08,330000,2017-08-23,585000,255000,4579,55.689015068792315
"80 JOHN STREET, 18A",2007-06-19,1085352,2014-05-02,1225000,139648,2509,55.65882821841371
"250 EAST 30 STREET, 5D",2003-10-24,432978,2017-12-11,720000,287022,5162,55.60286710577296
"126 WEST 22ND STREET, 8S",2005-06-02,2095000,2010-08-04,2200000,105000,1889,55.584965590259394
"21 SOUTH END AVENUE, 423",2005-03-22,426000,2015-07-09,635000,209000,3761,55.57032704068067
"230 RIVERSIDE DRIVE, 3J",2007-02-21,380250,2015-08-27,553000,172750,3109,55.56449018977163
"216 EAST 47TH   STREET, 17A",2007-07-10,645000,2013-05-01,762898,117898,2122,55.55984919886899
"220 RIVERSIDE BOULEVARD, 8F",2006-07-20,999000,2007-10-31,1025000,26000,468,55.55555555555556
"1420 YORK AVENUE, 3G",2004-04-07,240000,2016-06-27,488000,248000,4464,55.55555555555556
"225 RECTOR PLACE, 10A",2014-11-03,1032505,2018-03-02,1100000,67495,1215,55.55144032921811
"350 WEST 42ND STREET, 26J",2006-10-13,551891,2013-05-06,685000,133109,2397,55.53149770546516
"200 EAST 89TH   STREET, 7E",2007-04-30,569000,2015-07-07,735000,166000,2990,55.51839464882943
"325 FIFTH AVENUE, 32C",2007-01-09,1420458,2012-03-09,1525000,104542,1886,55.430540827147404
"310 WEST 52ND   STREET, 12C",2007-05-23,870603,2013-01-15,985000,114397,2064,55.4249031007752
"300 ALBANY STREET, 6N",2003-01-23,251000,2015-05-12,499900,248900,4492,55.40961709706144
"250 EAST 53RD STREET, 2503",2008-05-09,1354782,2012-07-25,1440000,85218,1538,55.40832249674902
"300 ALBANY STREET, 7E",2003-05-28,243000,2015-08-12,490000,247000,4459,55.393586005830905
"529 WEST 147 STREET, 3B",2006-01-31,403572,2013-10-25,560000,156428,2824,55.392351274787536
"845 UNITED NATIONS PLAZA, 22F",2003-01-06,456300,2013-07-30,670000,213700,3858,55.39139450492483
"306 MOTT STREET, 5B",2004-10-06,289045,2009-08-28,388000,98955,1787,55.37493005036374
"201 EAST 36TH   STREET, 12D",2007-04-20,712775,2012-05-15,815000,102225,1852,55.197084233261336
"1619 THIRD AVENUE, 28G",2010-11-29,600000,2013-05-23,650000,50000,906,55.18763796909492
"20 WEST STREET, 36F",2007-03-02,403065,2016-09-08,595000,191935,3478,55.18545140885566
"80 PARK AVENUE, 7B",2005-01-21,421000,2014-07-16,612000,191000,3463,55.15449032630667
"15 RENWICK STREET, 801",2016-05-12,2190255,2018-02-01,2225000,34745,630,55.15079365079365
"150 NASSAU STREET, 19A",2004-04-08,1496828,2011-11-21,1650000,153172,2783,55.03844771828962
"165 CHARLES STREET, RU29",2005-11-23,8296397,2007-01-26,8320000,23603,429,55.018648018648015
"27 WEST 72ND   STREET, 1514",2007-05-24,850238,2011-02-11,925000,74762,1359,55.012509197939664
"20 WEST STREET, 40C",2006-10-12,491790,2018-05-24,725000,233210,4242,54.97642621404998
"75 WALL STREET, 19J",2009-02-13,580402,2015-01-29,700000,119598,2176,54.96231617647059
"524 EAST 72ND STREET, 29A",2007-05-02,1600000,2016-01-20,1775000,175000,3185,54.94505494505494
"301 EAST 79TH   STREET, 29 R",2014-10-20,865000,2017-07-17,920000,55000,1001,54.94505494505494
"13 EAST 131 STREET, 1A",2003-12-29,263133,2017-01-20,525000,261867,4771,54.88723538042339
"120 RIVERSIDE BOULEVARD, 6H",2006-01-09,867549,2017-01-17,1088500,220951,4026,54.88102334823646
"155 WEST 68TH   STREET, 16-28",2016-06-30,745000,2017-05-24,763000,18000,328,54.8780487804878
"400 EAST 70TH STREET, 706",2005-11-14,625000,2018-05-07,875000,250000,4557,54.86065393899495
"421 EAST 13TH   STREET, 6B",2008-05-07,738231,2016-10-27,908000,169769,3095,54.852665589660745
"155 EAST 34 STREET, 12B",2004-08-17,425000,2006-11-16,470000,45000,821,54.81120584652862
"1 MORTON SQUARE, 2E W",2004-10-12,1705568,2009-07-01,1800000,94432,1723,54.80673244341265
"443 WEST 151 STREET, 1D",2003-04-15,153700,2014-05-09,375000,221300,4042,54.75012370113805
"77 PARK AVENUE, 8E",2007-06-19,2225000,2014-09-19,2370000,145000,2649,54.73763684409211
"225 RECTOR PLACE, 18F",2008-04-10,789143,2016-10-27,960000,170857,3122,54.726777706598334
"301 CATHEDRAL PARKWAY, 19D",2007-02-08,475000,2017-05-12,680000,205000,3746,54.72504004271222
"90 EAST END AVENUE, 4C",2003-10-23,1500000,2011-04-25,1650000,150000,2741,54.72455308281649
"100 WEST 58 STREET, 2A",2006-04-07,514216,2015-10-06,703800,189584,3469,54.650908042663595
"1 IRVING PLACE, V7K",2006-07-27,615000,2013-06-26,753000,138000,2526,54.63182897862233
"160 WADSWORTH AVENUE, 206",2004-06-28,255000,2008-07-02,335000,80000,1465,54.60750853242321
"31 EAST 28TH   STREET, 10E",2007-04-27,2382705,2011-12-13,2475000,92295,1691,54.58013010053223
"330 EAST 49TH STREET, 11M",2009-02-10,425000,2015-05-21,550000,125000,2291,54.56132693147097
"90 WILLIAM STREET, 5H",2008-07-23,818673,2015-02-25,950000,131327,2408,54.53779069767442
"14 PRINCE STREET, 2C",2006-08-24,1095000,2014-06-06,1250000,155000,2843,54.51987337319733
"350 WEST 50TH   STREET, 4RR",2009-10-28,420000,2017-08-29,576000,156000,2862,54.507337526205454
"400 EAST 90TH   STREET, 3I",2007-07-10,319410,2013-07-31,440000,120590,2213,54.49164030727519
"225 WEST 83RD STREET, 8N",2006-09-26,705000,2017-08-31,922500,217500,3992,54.483967935871746
"120 RIVERSIDE BOULEVARD, 8U",2006-02-08,481650,2013-07-24,630000,148350,2723,54.480352552331986
"20 WEST STREET, 21K",2006-09-14,534581,2017-10-13,755000,220419,4047,54.46478873239437
"635 WEST 42ND STREET, 21F",2007-10-05,951554,2015-03-26,1100000,148446,2729,54.395749358739465
"80 JOHN STREET, 16D",2007-04-13,325494,2016-10-27,515000,189506,3485,54.377618364418936
"312 WEST 23RD STREET, 3R",2006-12-21,365040,2016-04-14,550000,184960,3402,54.368018812463255
"1 CENTRAL PARK SOUTH, 2002",2010-12-01,4600000,2018-06-22,4750000,150000,2760,54.34782608695652
"255 HUDSON STREET, 7D",2006-12-12,1282995,2017-11-17,1500000,217005,3993,54.34635612321563
"15 BROAD STREET, 1704",2006-11-06,950000,2012-02-21,1055000,105000,1933,54.319710294878426
"235 WEST END AVENUE, 12A",2005-02-16,610950,2013-08-07,779000,168050,3094,54.31480284421461
"158 EAST 100 STREET, 6F",2007-11-15,503019,2015-07-15,655000,151981,2799,54.29832082886745
"318 WEST 100 STREET, 1C",2008-09-03,1175000,2014-04-28,1287000,112000,2063,54.28986912263694
"516 WEST 47TH   STREET, S6J",2011-01-24,440000,2013-05-02,485000,45000,829,54.28226779252111
"220 RIVERSIDE BOULEVARD, 17N",2004-08-31,2900000,2009-09-17,3000000,100000,1843,54.25935973955507
"420 WEST 25TH STREET, 3K",2013-03-28,999000,2018-05-03,1100000,101000,1862,54.242749731471534
"280 RECTOR PLACE, 9L",2005-01-06,366000,2017-09-26,618000,252000,4646,54.24020662935859
"75 WALL STREET, 26K",2009-03-10,1064071,2016-04-21,1205000,140929,2599,54.224317045017315
"311 GREENWICH STREET, 5J",2008-06-24,540000,2010-07-02,580000,40000,738,54.200542005420054
"20 WEST STREET, 21E",2006-06-14,481650,2015-09-18,665000,183350,3383,54.197457877623414
"160 WADSWORTH AVENUE, 507",2004-11-09,297000,2017-05-25,545000,248000,4580,54.148471615720524
"225 EAST 34TH   STREET, 2J",2008-01-18,880786,2013-10-29,995000,114214,2111,54.10421601136902
"120 RIVERSIDE BOULEVARD, 8V",2006-01-20,669601,2017-09-20,900000,230399,4261,54.07157944144567
"247 WEST 46TH   STREET, 1605",2009-06-03,957155,2017-06-01,1115000,157845,2920,54.05650684931507
"124 EAST 79 STREET, 5D",2003-07-17,425000,2004-07-21,445000,20000,370,54.054054054054056
"350 WEST 50TH STREET, 15F",2004-08-13,925000,2009-12-08,1030000,105000,1943,54.04014410705095
"2112 BROADWAY, 5G",2007-06-22,6042295,2012-12-07,6150000,107705,1995,53.987468671679196
"75 WALL STREET, 18H",2009-03-12,519307,2017-08-10,685000,165693,3073,53.918971688903355
"350 WEST 50TH STREET, 2MM",2004-11-22,390000,2015-03-26,593500,203500,3776,53.89300847457627
"106 CENTRAL PARK SOUTH, 8E",2008-01-22,470000,2013-08-06,579000,109000,2023,53.88037567968364
"16 WEST 19TH   STREET, 4-B",2007-12-19,870603,2013-04-09,975000,104397,1938,53.86842105263158
"112 WEST 72ND STREET, 6F",2006-06-07,549000,2008-12-22,599000,50000,929,53.821313240043054
"350 WEST 42ND STREET, 5L",2006-05-08,962246,2018-06-12,1200000,237754,4418,53.81484834766863
"245 EAST 93RD STREET, 3C",2007-04-17,1125000,2014-07-17,1267500,142500,2648,53.814199395770395
"220 MANHATTAN AVENUE, 6A",2005-08-03,473000,2015-10-09,673000,200000,3719,53.77789728421619
"517 WEST 46TH STREET, 505",2007-11-15,651680,2017-12-20,850000,198320,3688,53.77440347071583
"2628 BROADWAY, 5A",2007-10-09,1282995,2012-04-30,1372500,89505,1665,53.75675675675676
"306 MOTT STREET, 2B",2004-08-25,283920,2012-08-07,440000,156080,2904,53.7465564738292
"380 RECTOR PLACE, 22D",2005-09-08,635000,2017-08-09,868889,233889,4353,53.73053066850448
"500 WEST 43RD STREET, 17G",2010-02-11,425000,2018-05-17,587000,162000,3017,53.695724229366924
"120 RIVERSIDE BOULEVARD, 10P",2006-02-03,812850,2015-02-18,990000,177150,3302,53.64930345245306
"372 CENTRAL PARK WEST, 8B",2009-05-29,875000,2018-04-17,1049000,174000,3245,53.62095531587057
"255 WEST 85TH   STREET, 6A",2008-05-29,1350000,2012-06-29,1430000,80000,1492,53.61930294906166
"455 MAIN STREET, 10P",2006-04-07,380250,2016-03-18,575000,194750,3633,53.605835397742915
"40 BROAD STREET, 23G",2010-03-24,505338,2017-12-01,655888,150550,2809,53.59558561765753
"200 RECTOR PLACE, 12G",2003-12-19,445000,2010-02-04,565000,120000,2239,53.59535506922733
"2 EAST 55 STREET, 918",2006-08-17,590585,2006-11-20,595676,5091,95,53.589473684210525
"155 EAST 38TH STREET, 15H",2008-11-24,470000,2013-10-03,565000,95000,1774,53.55129650507328
"1965 BROADWAY, 12F",2007-12-18,1350000,2011-10-19,1425000,75000,1401,53.53319057815846
"200 RECTOR PLACE, 12M",2005-02-18,429000,2016-06-10,650000,221000,4130,53.51089588377724
"100 RIVERSIDE BOULEVARD, 6R T",2008-03-10,1523556,2013-07-15,1628000,104444,1953,53.478750640040964
"75 WALL STREET, 31G",2009-10-13,970000,2016-06-09,1100000,130000,2431,53.475935828877006
"350 WEST 42ND STREET, 14H",2006-06-27,471510,2009-12-29,540000,68490,1281,53.46604215456674
"360 EAST 88TH STREET, 20A",2007-06-04,1202000,2015-12-15,1368500,166500,3116,53.43388960205392
"392 CENTRAL PARK WEST, 17S",2007-10-22,605858,2017-10-03,800000,194142,3634,53.42377545404513
"40 SUTTON PLACE, 8D",2003-04-22,220000,2014-11-03,445000,225000,4213,53.406123902207455
"400 FIFTH AVENUE, 44C",2013-04-03,946972,2018-04-13,1045000,98028,1836,53.3921568627451
"73 WORTH STREET, 4C",2005-10-06,2375000,2013-03-15,2520000,145000,2717,53.367684946632316
"18 WEST 48TH STREET, 27C",2007-06-27,1170987,2013-01-29,1280000,109013,2043,53.3592755751346
"377 RECTOR PLACE, 10G",2006-06-29,560000,2007-07-09,580000,20000,375,53.333333333333336
"225 5 AVENUE, 11C",2007-09-10,1680112,2011-04-15,1750000,69888,1313,53.227722772277225
"230 RIVERSIDE DRIVE, 1H",2007-09-05,415740,2014-04-30,545000,129260,2429,53.21531494442157
"115 ALLEN STREET, 5",2005-09-01,1425550,2009-07-02,1500000,74450,1400,53.17857142857143
"311 GREENWICH STREET, 6G",2004-09-10,640000,2011-08-26,775000,135000,2541,53.128689492325854
"1600 BROADWAY, 6B",2006-07-28,901151,2018-05-16,1130000,228849,4310,53.09721577726218
"377 RECTOR PLACE, 9G",2004-11-09,475000,2015-09-10,685000,210000,3957,53.070507960576194
"515 EAST 72ND   STREET, 23G",2008-01-14,1582360,2016-08-22,1749000,166640,3143,53.019408208717785
"305 WEST 18TH   STREET, 2H",2006-12-11,450000,2011-10-19,544000,94000,1773,53.01748448956571
"201 EAST 36TH STREET, 5E",2006-08-14,680000,2015-05-27,850000,170000,3208,52.99251870324189
"342 EAST 110 STREET, 5E",2010-01-07,550000,2013-08-20,620000,70000,1321,52.99015897047691
"100 RIVERSIDE BOULEVARD, 12G",2008-05-08,1812485,2012-11-16,1900000,87515,1653,52.94313369630974
"367 MANHATTAN AVENUE, H",2004-04-14,570000,2012-02-07,721000,151000,2855,52.88966725043783
"40 SUTTON PLACE, 3D",2003-07-18,205000,2014-12-08,425000,220000,4161,52.871905791876955
"20 WEST STREET, 31G",2007-02-01,436020,2016-11-16,625000,188980,3576,52.84675615212528
"779 RIVERSIDE DRIVE, A-51",2008-09-10,721524,2016-02-18,865000,143476,2717,52.80677217519323
"50 EAST END AVENUE, 50-3B",2010-05-25,345000,2016-03-16,457000,112000,2122,52.780395852968894
"82 BEAVER STREET, 1303",2007-04-11,420810,2015-07-17,580000,159190,3019,52.7293805895992
"1420 YORK AVENUE, 2G",2004-02-06,240000,2014-03-26,435000,195000,3701,52.688462577681705
"275 WEST 96TH STREET, 10L",2005-03-11,565000,2013-07-08,725000,160000,3041,52.614271621177245
"106 CENTRAL PARK SOUTH, 4H",2007-08-09,549000,2016-10-07,725000,176000,3347,52.584403943830296
"120 RIVERSIDE BOULEVARD, 10J",2006-01-26,755032,2017-01-02,965000,209968,3994,52.57085628442664
"157 EAST 32 STREET, 3C",2004-08-25,325000,2006-09-25,365000,40000,761,52.562417871222074
"300 EAST 33RD   STREET, 14-G",2012-06-12,450000,2017-02-21,540000,90000,1715,52.478134110787174
"21 SOUTH END AVENUE, 223",2004-05-17,422500,2016-06-17,654000,231500,4414,52.446760308110555
"235 WEST END AVENUE, 9D",2007-08-14,780000,2017-10-19,975000,195000,3719,52.43344985211078
"188 EAST 70TH STREET, 17B",2005-05-17,540000,2017-05-24,770000,230000,4390,52.391799544419136
"255 WEST 85TH STREET, 11C",2008-03-13,755000,2016-06-10,912700,157700,3011,52.37462636997675
"120 RIVERSIDE BOULEVARD, 11U",2006-02-10,467251,2011-03-23,565000,97749,1867,52.35618639528656
"135 WEST 16TH STREET, 336",2004-08-09,480000,2010-08-03,594355,114355,2185,52.336384439359264
"66 LEONARD STREET, 5F",2005-02-17,1205000,2012-09-20,1350000,145000,2772,52.308802308802306
"254 PARK AVENUE SOUTH, 3M",2010-06-28,777943,2013-09-27,840000,62057,1187,52.28053917438922
"3 WEST 122 STREET, 5D",2007-04-25,589000,2017-01-20,775000,186000,3558,52.27655986509275
"11 EAST 36TH   STREET, 1102",2007-07-19,805435,2015-02-17,950000,144565,2770,52.18953068592058
"35 BETHUNE STREET, 2C",2005-09-01,1550000,2009-11-12,1630000,80000,1533,52.18525766470972
"1255 5 AVENUE, 4G",2004-01-30,375000,2013-07-11,555000,180000,3450,52.17391304347826
"2322 ADAM C POWELL BLVD, 5A",2010-06-29,345000,2014-03-21,416000,71000,1361,52.167523879500365
"120 RIVERSIDE BOULEVARD, 14U",2006-03-02,580402,2016-05-24,775000,194598,3736,52.0872591006424
"75 WALL STREET, 26G",2010-03-05,896060,2011-03-31,916425,20365,391,52.084398976982094
"88 GREENWICH STREET, 415",2010-10-01,430950,2013-11-08,490000,59050,1134,52.07231040564374
"90 WILLIAM STREET, 9D",2008-07-18,708702,2017-10-25,885000,176298,3386,52.06674542232723
"146 WEST 57TH   STREET, 41A",2009-08-07,2150000,2017-09-06,2303675,153675,2952,52.05792682926829
"350 WEST 50TH STREET, 6P",2006-04-11,481650,2018-05-24,712000,230350,4426,52.04473565295978
"130 WEST 19TH STREET, 4F",2006-08-23,1267721,2010-12-21,1350000,82279,1581,52.042378241619225
"425 MAIN STREET, 8E",2007-06-21,771000,2008-06-23,790148,19148,368,52.03260869565217
"225 WEST 60TH   STREET, 8F",2007-02-23,1221900,2012-04-25,1320000,98100,1888,51.95974576271186
"45 PARK AVENUE, 706",2007-01-07,1258557,2017-11-27,1465000,206443,3977,51.90922806135278
"44 WEST 105 STREET, 66",2008-09-22,548000,2014-08-21,660000,112000,2159,51.87586845761927
"200 EAST 66TH STREET, E0501",2008-10-14,1374637,2018-08-16,1561000,186363,3593,51.86835513498469
"400 EAST 70TH STREET, 3003",2006-07-21,1550000,2017-05-17,1755000,205000,3953,51.8593473311409
"1600 BROADWAY, 10F",2006-06-27,570220,2017-11-21,786000,215780,4165,51.80792316926771
"55 WALL STREET, 720",2010-09-30,869589,2016-08-01,980000,110411,2132,51.7875234521576
"275 WEST 96TH STREET, 16C",2008-07-01,690000,2018-05-22,877000,187000,3612,51.7718715393134
"350 WEST 50TH STREET, 3HH",2006-02-28,409403,2013-08-06,550000,140597,2716,51.76620029455081
"467 CENTRAL PARK WEST, 2E",2007-06-01,615000,2017-03-15,800000,185000,3575,51.74825174825175
"317 WEST 95TH   STREET, C4",2014-12-18,730000,2016-07-20,760000,30000,580,51.724137931034484
"100 RIVERSIDE BOULEVARD, 10T",2009-01-14,789143,2013-08-01,875000,85857,1660,51.721084337349396
"311 GREENWICH STREET, 5H",2004-05-10,610000,2008-08-04,690000,80000,1547,51.71299288946348
"1255 5 AVENUE, 5B",2005-07-22,482500,2017-08-14,710000,227500,4406,51.63413527008625
"71 NASSAU STREET, 10A",2006-10-26,1262630,2014-05-15,1405000,142370,2758,51.620739666424946
"100 UNITED NATIONS PLAZA, 42C",2004-04-05,1180000,2011-12-14,1325000,145000,2809,51.619793520825915
"8 UNION SQUARE SOUTH, 5A",2012-08-16,3575000,2016-08-08,3650000,75000,1453,51.6173434273916
"209 WEST 104 STREET, 5G",2003-08-20,215000,2010-04-08,340000,125000,2423,51.588939331407346
"80 PARK AVENUE, 5N",2004-06-28,712500,2013-02-12,875000,162500,3151,51.57092986353538
"82 BEAVER STREET, 301",2007-05-25,957155,2017-01-20,1139000,181845,3528,51.54336734693877
"56 PINE STREET, 15B",2005-12-21,425880,2012-12-28,558000,132120,2564,51.528861154446176
"230 RIVERSIDE DRIVE, 5M",2007-01-19,390390,2015-07-14,550000,159610,3098,51.5203357004519
"200 RECTOR PLACE, 5J",2007-08-24,655000,2016-02-24,815000,160000,3106,51.513200257566
"300 RECTOR PLACE, 4L",2003-04-30,295000,2009-12-21,420000,125000,2427,51.50391429748661
"425 CENTRAL PARK WEST, 2H",2007-12-14,410000,2014-05-01,530000,120000,2330,51.502145922746784
"330 EAST 38TH   STREET, 5E",2008-12-23,1300000,2016-12-16,1450000,150000,2915,51.45797598627787
"230 RIVERSIDE DRIVE, 6M",2007-01-09,395460,2015-07-07,555000,159540,3101,51.447920025798126
"15 BROAD STREET, 2428",2006-11-02,697501,2014-06-04,840000,142499,2771,51.42511728617828
"555 WEST 23RD STREET, N10R",2006-04-19,585493,2014-07-11,740000,154507,3005,51.41663893510815
"460 EAST 79TH   STREET, 2C",2007-08-14,300000,2014-08-26,432048,132048,2569,51.40054495912806
"120 EAST 90TH   STREET, 5G",2008-12-18,395000,2017-05-19,553000,158000,3074,51.398828887443074
"502 PARK AVENUE, 12A",2004-02-04,895000,2012-05-08,1050000,155000,3016,51.39257294429708
"330 EAST 38TH   STREET, 18F",2008-09-22,770000,2013-10-15,865000,95000,1849,51.379123850730124
"353 WEST 56TH STREET, 3E",2005-03-04,460000,2017-06-08,690000,230000,4479,51.350747934806876
"230 RIVERSIDE DRIVE, 3F",2007-02-16,385320,2016-06-14,560000,174680,3406,51.28596594245449
"400 CENTRAL PARK WEST, 20D",2006-07-26,1075000,2009-10-08,1135000,60000,1170,51.282051282051285
"145 EAST 48TH STREET, 29A",2005-06-03,570000,2013-01-11,712500,142500,2779,51.277437927311986
"250 EAST 54TH   STREET, 33C",2007-01-23,937000,2013-08-19,1060000,123000,2400,51.25
"350 EAST 82ND   STREET, 7E",2007-03-09,560037,2017-05-03,750000,189963,3708,51.230582524271846
"15 BROAD STREET, 901",2008-05-22,775000,2017-09-28,950000,175000,3416,51.22950819672131
"200 RIVERSIDE BOULEVARD, 9L",2005-12-28,1225000,2010-10-20,1315000,90000,1757,51.22367672168469
"15 WILLIAM STREET, 26G",2009-04-23,999000,2014-09-16,1100000,101000,1972,51.217038539553755
"400 EAST 70TH STREET, 404",2004-09-20,633600,2009-08-10,725000,91400,1785,51.20448179271709
"10 WEST END AVENUE, 22C",2007-08-20,1689811,2013-04-05,1795000,105189,2055,51.18686131386861
"100 WEST 119 STREET, 6A",2006-03-31,1125000,2015-08-10,1300000,175000,3419,51.18455688797894
"106 CENTRAL PARK SOUTH, 15B",2007-07-09,825000,2011-07-14,900000,75000,1466,51.15961800818554
"20 WEST STREET, 44C",2006-11-08,520000,2015-02-24,675000,155000,3030,51.15511551155115
"2 SOUTH END AVENUE, 6I",2004-01-16,410000,2013-12-18,595000,185000,3624,51.04856512141281
"350 WEST 57TH STREET, 6G",2005-03-18,950000,2013-04-04,1100000,150000,2939,51.037767948281726
"300 EAST 23RD   STREET, 7G",2012-06-19,1230000,2016-10-04,1310000,80000,1568,51.02040816326531
"420 WEST 25TH   STREET, 4B",2008-01-18,1013158,2013-10-15,1120000,106842,2097,50.949928469241776
"250 EAST 54TH STREET, 29A",2004-12-02,1735000,2012-06-11,1875000,140000,2748,50.946142649199416
"340 EAST 23RD STREET, 4H",2008-01-25,819691,2013-09-24,925000,105309,2069,50.89850169163847
"392 CENTRAL PARK WEST, 20S",2005-09-30,515000,2014-11-25,685000,170000,3343,50.852527669757706
"340 EAST 23RD STREET, 6H",2008-01-16,850238,2013-10-28,957500,107262,2112,50.78693181818182
"103 NORFOLK STREET, TWR15",2008-08-12,2291062,2013-09-05,2385000,93938,1850,50.777297297297295
"300 EAST 90TH STREET, 9B",2006-12-08,585000,2016-05-17,760000,175000,3448,50.754060324825986
"350 WEST 50TH STREET, 3M",2005-02-10,405000,2018-01-24,645000,240000,4731,50.72923272035511
"15 WILLIAM STREET, 19F",2009-09-09,996866,2014-03-06,1080000,83134,1639,50.722391702257475
"11 EAST 36TH   STREET, 504",2007-05-03,727758,2015-07-22,880000,152242,3002,50.713524317121916
"516 WEST 47TH STREET, S5E",2006-05-01,567370,2018-05-09,790000,222630,4391,50.701434752903666
"404 EAST 79TH   STREET, 23D",2008-06-05,665000,2010-08-03,705000,40000,789,50.69708491761724
"330 EAST 49TH   STREET, 6E",2012-04-13,442500,2018-02-02,550000,107500,2121,50.683639792550686
"145 EAST 48TH STREET, 30A",2006-07-19,780000,2017-05-10,980000,200000,3948,50.65856129685917
"154 ATTORNEY STREET, 305",2006-11-28,794235,2011-10-26,885000,90765,1793,50.62186279977691
"56 PINE STREET, 5A",2005-12-15,491790,2013-12-23,640000,148210,2930,50.58361774744027
"230 RIVERSIDE DRIVE, 14G",2007-04-24,461370,2016-03-03,625000,163630,3236,50.565512978986405
"330 EAST 49TH   STREET, 2D",2009-09-30,565000,2013-09-13,638000,73000,1444,50.554016620498615
"220 RIVERSIDE BOULEVARD, 9V",2004-11-02,730000,2008-07-29,799000,69000,1365,50.54945054945055
"340 EAST 23RD STREET, 5H",2008-04-07,834965,2016-12-09,995000,160035,3168,50.516098484848484
"111 FULTON STREET, 304",2008-11-12,534581,2014-07-31,640000,105419,2087,50.51221849544801
"350 WEST 50TH   STREET, 3HH",2007-11-19,447500,2016-09-30,611000,163500,3238,50.49413218035824
"119 FULTON STREET, 6A",2007-01-24,1135348,2012-09-27,1240000,104652,2073,50.483357452966715
"250 EAST 30TH STREET, 8B",2004-10-01,615000,2014-10-16,800000,185000,3667,50.44995909462776
"1400 FIFTH AVENUE, 7F",2005-02-24,471500,2011-08-02,590000,118500,2350,50.42553191489362
"340 CABRINI BOULEVARD, 201",2003-12-19,595675,2014-07-08,790000,194325,3854,50.42163985469642
"200 RIVERSIDE BOULEVARD, 406",2006-06-27,715000,2015-12-28,890000,175000,3471,50.41774704696053
"350 WEST 50TH STREET, 4CC",2004-07-21,360000,2017-02-28,592000,232000,4605,50.3800217155266
"148 MADISON STREET, 8H",2004-08-16,410670,2014-11-12,599000,188330,3740,50.355614973262036
"206 EAST 95TH   STREET, 18B",2009-12-30,692410,2016-08-31,815000,122590,2436,50.32430213464696
"99 JOHN STREET, 1224",2009-01-27,594000,2017-07-25,750000,156000,3101,50.30635278942277
"27 COMMERCE STREET, 271A",2009-07-23,750000,2011-09-27,790000,40000,796,50.25125628140704
"443 WEST 151 STREET, 4D",2004-01-29,78000,2013-06-13,250000,172000,3423,50.248320186970496
"27 WEST 72ND STREET, 208",2008-06-23,945000,2018-04-16,1125000,180000,3584,50.223214285714285
"247 WEST 46TH   STREET, 1005",2008-10-07,931698,2017-02-16,1085000,153302,3054,50.19711853307138
"415 EAST 37TH STREET, 40N",2005-01-13,775000,2015-04-17,963000,188000,3746,50.18686599038975
"184 THOMPSON STREET, 5J",2007-06-20,733140,2013-11-04,850000,116860,2329,50.17604121940747
"312 WEST 23RD STREET, 1G",2006-04-27,330427,2015-07-29,500000,169573,3380,50.169526627218936
"779 RIVERSIDE DRIVE, B-30",2008-09-25,456300,2016-04-25,595000,138700,2769,50.09028530155291
"230 RIVERSIDE DRIVE, 1P",2007-08-24,646588,2017-02-15,820000,173412,3463,50.07565694484551
"311 CHERRY STREET, M3",2005-08-02,440000,2013-07-08,585000,145000,2897,50.05177770107007
"130 WEST 79TH STREET, 11C",2006-07-24,685000,2016-12-16,875000,190000,3798,50.02632964718273
"77 PARK AVENUE, 2C",2007-05-11,975000,2018-07-30,1180000,205000,4098,50.02440214738897
"20 WEST STREET, 39F",2007-04-26,451230,2017-05-17,635000,183770,3674,50.019052803483945
"200 RECTOR PLACE, 19F",2005-07-18,651000,2018-01-30,880000,229000,4579,50.01091941471937
"230 RIVERSIDE DRIVE, 14CC",2006-12-04,486720,2017-03-28,675000,188280,3767,49.98141757366605
"500 WEST END AVENUE, 4D",2004-04-27,1775000,2011-09-20,1910000,135000,2702,49.96299037749815
"225 RECTOR PLACE, 19D",2008-04-04,794235,2017-10-18,968000,173765,3484,49.87514351320321
"1760 SECOND AVENUE, 16E",2006-09-05,610000,2018-06-29,825000,215000,4315,49.826187717265356
"443 WEST 151ST STREET, 2D",2004-09-01,165000,2009-12-11,261000,96000,1927,49.81837052413077
"125 WEST 21ST STREET, 8C",2008-07-24,773870,2017-08-22,939000,165130,3316,49.79794933655006
"160 WEST 66TH STREET, PHD",2005-07-26,1995000,2011-05-05,2100000,105000,2109,49.786628733997155
"635 WEST 42ND   STREET, 9C",2009-08-07,743332,2016-07-28,870000,126668,2547,49.73223400078524
"505 GREENWICH STREET, 7B",2004-12-20,1415367,2011-01-03,1525000,109633,2205,49.720181405895694
"865 1 AVENUE, 3B",2008-02-28,446000,2015-04-07,575000,129000,2595,49.71098265895954
"56 PINE STREET, 6D",2005-10-14,405600,2009-09-30,477500,71900,1447,49.68901174844506
"236 EAST 47 STREET, 19F",2005-05-11,1100000,2011-06-03,1210000,110000,2214,49.68383017163505
"209 WEST 104 STREET, 2E",2003-10-31,350000,2013-03-15,520000,170000,3423,49.66403739409874
"239 WEST 135 STREET, 4A",2010-08-17,380000,2013-11-07,438500,58500,1178,49.66044142614601
"5 HARRISON STREET, 4",2005-01-12,2250000,2010-07-19,2350000,100000,2014,49.65243296921549
"425 CENTRAL PARK WEST, 5J",2007-10-15,655000,2012-01-24,732500,77500,1562,49.61587708066581
"150 WEST 51 STREET, 12389",2005-02-16,440000,2011-06-23,555000,115000,2318,49.61173425366695
"120 RIVERSIDE BOULEVARD, 10V",2006-01-19,717866,2006-09-21,730000,12134,245,49.5265306122449
"232 EAST 118TH STREET, 4B",2008-01-22,437034,2015-06-02,570000,132966,2688,49.466517857142854
"225 EAST 86TH STREET, 905",2005-03-04,492000,2013-08-26,645000,153000,3097,49.402647723603486
"62 BEACH STREET, 6A",2013-05-06,1142461,2015-06-05,1180000,37539,760,49.39342105263158
"68 BRADHURST AVENUE, 4-P",2007-06-28,455034,2013-08-02,565000,109966,2227,49.37853614728334
"148 MADISON STREET, 6A",2004-02-23,236262,2014-07-02,423000,186738,3782,49.37546271813855
"20 WEST STREET, 41D",2007-01-17,420810,2016-11-15,598000,177190,3590,49.35654596100279
"15 BROAD STREET, 2700",2006-07-31,1613926,2012-09-28,1725000,111074,2251,49.344291426032875
"515 EAST 72ND   STREET, 26F",2008-02-15,1972716,2016-09-28,2128000,155284,3148,49.327827191867854
"249 EAST 48TH STREET, 8A",2007-12-28,560000,2017-09-14,735000,175000,3548,49.32356257046223
"327 CENTRAL PARK WEST, 7E",2004-05-21,750000,2014-10-20,937500,187500,3804,49.290220820189276
"132A EAST 65TH   STREET, 2B",2013-11-01,1870000,2016-11-21,1925000,55000,1116,49.2831541218638
"250 SOUTH END AVENUE, 12A",2007-09-04,456300,2014-06-30,579000,122700,2491,49.25732637494982
"159 WEST 53RD STREET, 30C",2005-12-08,512000,2016-10-31,708000,196000,3980,49.246231155778894
"25 CENTRAL PARK WEST, 20U",2005-11-17,775000,2010-01-19,850000,75000,1524,49.21259842519685
"120 RIVERSIDE BOULEVARD, 4K",2006-02-27,560000,2013-12-13,700000,140000,2846,49.191848208011244
"327 CENTRAL PARK WEST, 6E",2005-03-02,768778,2017-10-05,995000,226222,4600,49.178695652173914
"505 GREENWICH STREET, 7C",2005-02-02,1089527,2011-03-30,1200000,110473,2247,49.1646639964397
"150 NASSAU STREET, 6H",2004-05-20,835000,2009-09-04,930000,95000,1933,49.146404552509054
"30 RUTGERS STREET, 6A",2009-11-24,527453,2017-04-13,660000,132547,2697,49.14608824619948
"2250 BROADWAY, 3L",2003-09-12,365000,2011-07-21,506000,141000,2869,49.14604391774137
"255 HUDSON STREET, 4A",2006-09-22,1883762,2013-06-24,2005000,121238,2467,49.143899473044186
"21 SOUTH END AVENUE, 728",2006-09-18,350000,2017-01-12,535000,185000,3769,49.084637834969485
"30 WEST 90TH STREET, 8D",2007-03-07,620000,2014-01-07,742500,122500,2498,49.03923138510809
"1991 BROADWAY, 3B",2006-04-28,440000,2011-01-27,525000,85000,1735,48.99135446685879
"80 JOHN STREET, 12H",2007-03-27,549702,2015-08-24,700000,150298,3072,48.925130208333336
"300 WEST 135TH STREET, 4U",2005-05-20,338177,2014-05-23,499000,160823,3290,48.88237082066869
"170 WEST 23RD STREET, 6Z",2007-12-31,585000,2013-11-20,690000,105000,2151,48.81450488145049
"350 WEST 53RD   STREET, 6H",2009-03-12,841000,2011-06-30,882000,41000,840,48.80952380952381
"230 RIVERSIDE DRIVE, 6G",2006-12-07,430950,2017-04-04,615000,184050,3771,48.80668257756563
"230 RIVERSIDE DRIVE, 6J",2008-06-30,425000,2014-08-13,534000,109000,2235,48.769574944071586
"106 CENTRAL PARK SOUTH, 18N",2006-05-05,470000,2009-12-29,535000,65000,1334,48.7256371814093
"235 WEST END AVENUE, 16E",2006-08-31,795000,2017-07-10,987500,192500,3966,48.537569339384774
"75 WALL STREET, 22L",2009-12-07,621132,2016-08-22,740000,118868,2450,48.51755102040816
"45 PARK AVENUE, 1006",2007-11-27,1272812,2018-06-21,1460000,187188,3859,48.50686706400622
"421 EAST 13TH   STREET, 7H",2008-03-07,819691,2015-07-16,950000,130309,2687,48.49609229624116
"111 FULTON STREET, 415",2008-12-08,758596,2016-12-02,900000,141404,2916,48.49245541838135
"200 RECTOR PLACE, 7T",2005-10-24,385000,2013-10-25,526700,141700,2923,48.477591515566196
"421 EAST 13TH   STREET, 2D",2008-03-06,763687,2014-06-20,875000,111313,2297,48.46016543317371
"680 RIVERSIDE DRIVE, 2D",2008-07-11,486720,2014-12-05,600000,113280,2338,48.451668092386655
"1630 MADISON AVENUE, 2A",2003-03-07,277163,2015-07-01,495000,217837,4499,48.41898199599911
"20 WEST STREET, 21D",2006-05-30,447174,2017-11-20,650000,202826,4192,48.38406488549618
"206 EAST 95TH   STREET, 5B",2008-08-22,605349,2017-07-14,762500,157151,3248,48.38392857142857
"350 WEST 50TH   STREET, 11C",2007-04-12,690000,2016-04-11,849000,159000,3287,48.37237602677213
"312 WEST 23RD STREET, 1S",2006-03-30,299130,2014-10-14,450000,150870,3120,48.35576923076923
"130 BARROW STREET, 307",2007-03-29,975000,2017-09-18,1160000,185000,3826,48.3533716675379
"75 WALL STREET, 33J",2010-01-22,580402,2018-01-08,721000,140598,2908,48.34869325997249
"250 SOUTH END AVENUE, 11A",2007-10-26,534500,2015-03-20,665000,130500,2702,48.29755736491488
"120 GREENWICH STREET, 4J",2006-08-25,538654,2016-08-25,715000,176346,3653,48.27429509991788
"60 HENRY STREET, 10E",2003-05-28,215000,2018-06-08,480000,265000,5490,48.2695810564663
"150 NASSAU STREET, 9E",2003-05-23,486720,2010-11-03,618000,131280,2721,48.24696802646086
"403 EAST 62ND STREET, 7C",2005-05-17,540000,2017-04-20,750000,210000,4356,48.209366391184574
"1 IRVING PLACE, V14D",2010-02-10,835000,2012-02-06,870000,35000,726,48.209366391184574
"404 EAST 79TH   STREET, 7B",2008-10-16,645000,2013-08-19,730200,85200,1768,48.19004524886878
"148 MADISON STREET, 9G",2003-05-29,347415,2016-01-28,570000,222585,4627,48.1056840285282
"148 MADISON STREET, 5H",2004-06-17,365040,2017-06-08,593000,227960,4739,48.1029753112471
"310 WEST 52ND   STREET, 17C",2007-06-06,957155,2016-11-16,1123129,165974,3451,48.09446537235584
"100 RIVERSIDE BOULEVARD, 6N",2007-02-19,1767172,2013-04-11,1875000,107828,2243,48.073116362015156
"455 MAIN STREET, 10J",2006-03-21,534581,2012-03-23,640000,105419,2194,48.04876937101185
"255 HUDSON STREET, 6D",2006-10-13,1094618,2016-10-11,1270000,175382,3651,48.03670227334977
"1 IRVING PLACE, 8/G",2006-10-16,588000,2017-03-02,770000,182000,3790,48.02110817941953
"40 SUTTON PLACE, 8J",2005-05-05,495000,2010-03-11,580000,85000,1771,47.99548277809147
"10 WEST END AVENUE, 16D",2007-12-06,1598652,2013-06-06,1695000,96348,2009,47.958188153310104
"158 HESTER STREET, 3C",2006-08-02,520834,2012-10-26,630000,109166,2277,47.94290733421168
"529 WEST 147 STREET, 5A",2006-01-18,452244,2015-12-01,625000,172756,3604,47.93451720310766
"350 EAST 82ND   STREET, 5E",2007-07-06,554946,2014-12-10,685000,130054,2714,47.919675755342666
"200 RIVERSIDE BOULEVARD, 4I",2007-03-08,700000,2017-02-15,874000,174000,3632,47.90748898678414
"143 EAST 34TH STREET, 10S",2007-07-30,999000,2018-03-19,1185000,186000,3885,47.87644787644788
"202 BOWERY, 5",2007-01-11,1323725,2011-05-24,1400000,76275,1594,47.85131744040151
"106 CENTRAL PARK SOUTH, 5D",2004-09-14,307500,2014-08-01,480000,172500,3608,47.810421286031044
"725 RIVERSIDE DRIVE, 7E",2007-10-30,334620,2018-07-16,521500,186880,3912,47.77096114519427
"39 EAST 29TH   STREET, 25D",2009-01-20,1215000,2013-12-05,1300000,85000,1780,47.752808988764045
"210 EAST 47TH STREET, 11B",2004-08-20,640000,2013-10-03,799000,159000,3331,47.73341338937256
"446 WEST 47TH STREET, 4F",2006-01-04,310000,2018-06-29,527500,217500,4559,47.707830664619436
"2 SOUTH END AVENUE, 6N",2004-05-11,275000,2016-06-01,485000,210000,4404,47.68392370572207
"515 EAST 72ND STREET, 23H",2007-12-13,1480211,2016-04-07,1625000,144789,3038,47.65931533903884
"865 FIRST AVENUE, 1E",2008-07-29,399000,2014-04-28,499000,100000,2099,47.641734159123395
"240 RIVERSIDE BOULEVARD, 10N-T",2005-09-23,817500,2010-06-23,900000,82500,1734,47.57785467128028
"82 BEAVER STREET, 1206",2007-01-03,402558,2015-06-29,550000,147442,3099,47.57728299451436
"40 SUTTON PLACE, 5D",2003-01-31,220000,2015-06-16,435000,215000,4519,47.57689754370436
"90 WILLIAM STREET, 15F",2008-07-07,763687,2015-10-14,890000,126313,2655,47.575517890772126
"68 BRADHURST AVENUE, 7-D",2007-06-19,752500,2015-04-28,889000,136500,2870,47.5609756097561
"250 EAST 54TH   STREET, 8F",2007-05-25,1395000,2016-04-27,1550000,155000,3260,47.54601226993865
"1600 BROADWAY, 9B",2006-05-25,1086913,2013-10-09,1215000,128087,2694,47.5452858203415
"11 EAST 36TH   STREET, 604",2007-05-16,735028,2016-08-01,895000,159972,3365,47.53997028231798
"230 RIVERSIDE DRIVE, 4K",2007-05-30,712775,2017-08-15,890000,177225,3730,47.51340482573727
"75 WALL STREET, 21L",2009-08-04,608302,2016-11-22,735000,126698,2667,47.50581177352831
"340 EAST 23RD STREET, 10K",2008-02-29,855330,2013-08-14,950000,94670,1993,47.501254390366284
"225 RECTOR PLACE, 7G",2008-08-20,600768,2018-05-23,770000,169232,3563,47.49705304518664
"2 SOUTH END AVENUE, 7N",2008-02-15,455000,2013-08-16,550000,95000,2009,47.28720756595321
"80 RIVERSIDE BOULEVARD, 8K",2009-06-25,873658,2016-07-05,995000,121342,2567,47.269964939618234
"130 WATER STREET, 8L",2004-03-04,215000,2014-01-08,385000,170000,3597,47.26160689463442
"220 EAST 65TH STREET, 14E",2009-11-30,475000,2013-05-23,535000,60000,1270,47.24409448818898
"300 WEST 135 STREET, 7L",2005-05-18,434356,2012-01-31,550000,115644,2449,47.2209064924459
"106 CENTRAL PARK SOUTH, 10C",2007-04-05,470000,2015-12-17,620000,150000,3178,47.199496538703585
"56 PINE STREET, 9E",2006-01-13,334620,2014-03-07,475000,140380,2975,47.18655462184874
"220 RIVERSIDE BOULEVARD, 27E",2005-01-07,940000,2013-12-05,1093500,153500,3254,47.172710510141364
"2250 BROADWAY, 5D",2004-01-03,600000,2009-10-02,699000,99000,2099,47.16531681753216
"250 EAST 30 STREET, 3C",2003-10-23,299130,2009-12-15,405000,105870,2245,47.15812917594655
"201 WEST 74TH STREET, 15B",2005-07-25,518971,2015-07-01,690000,171029,3628,47.141400220507165
"250 SOUTH END AVENUE, 8G",2003-02-06,295000,2010-10-08,427000,132000,2801,47.126026419136025
"255 WEST 85TH STREET, 8D",2006-04-13,550000,2013-11-01,680000,130000,2759,47.11852120333454
"134 EAST 93RD STREET, 3C",2007-06-04,416000,2016-06-27,572000,156000,3311,47.115675022651764
"250 EAST 30TH   STREET, 7C",2011-07-27,450000,2018-04-02,565000,115000,2441,47.111839410077835
"200 RECTOR PLACE, 31A",2004-11-19,547000,2018-04-02,777000,230000,4882,47.111839410077835
"106 WEST 116 STREET, PH-2B",2009-04-22,1220000,2014-04-01,1305000,85000,1805,47.091412742382275
"340 EAST 23RD   STREET, 16I",2013-08-01,675000,2016-10-12,730000,55000,1168,47.08904109589041
"225 RECTOR PLACE, 11G",2008-07-21,636407,2016-08-12,775000,138593,2944,47.07642663043478
"247 WEST 46TH   STREET, 905",2008-09-24,921516,2016-10-17,1060000,138484,2945,47.023429541595924
"517 WEST 46TH STREET, 104",2008-05-22,1177000,2017-01-03,1325000,148000,3148,47.01397712833545
"411 EAST 53RD STREET, 19B",2006-08-25,1550000,2009-07-24,1600000,50000,1064,46.99248120300752
"120 RIVERSIDE BOULEVARD, 9G",2006-01-24,600767,2012-08-30,714000,113233,2410,46.98464730290456
"100 RIVERSIDE BOULEVARD, 31D",2008-08-20,2163781,2013-08-30,2250000,86219,1836,46.960239651416124
"230 RIVERSIDE DRIVE, 10G",2007-02-01,451230,2014-04-21,575000,123770,2636,46.95371775417299
"92 PERRY STREET, 5",2009-02-11,1110910,2017-10-23,1260000,149090,3176,46.9426952141058
"176 WEST 86TH STREET, 7C",2004-10-29,510000,2016-01-22,702500,192500,4102,46.9283276450512
"124 WEST 93RD STREET, 4E",2005-08-17,663000,2015-08-31,835000,172000,3666,46.91762138570649
"736 WEST 187TH ST, 106",2005-12-20,430950,2015-03-12,589000,158050,3369,46.91303057287029
"90 WILLIAM STREET, 8A",2008-07-22,1151640,2013-09-19,1240000,88360,1885,46.87533156498674
"160 WADSWORTH AVENUE, 605",2007-04-16,270000,2010-03-18,320000,50000,1067,46.860356138706656
"270 WEST 17TH STREET, 11E",2016-05-31,1325000,2018-01-19,1353000,28000,598,46.82274247491639
"130 FULTON STREET, 9B",2006-06-23,2173963,2010-12-03,2250000,76037,1624,46.82081280788177
"199 BOWERY, 7C",2007-03-19,413205,2012-11-16,510000,96795,2069,46.78347027549541
"161 EAST 110 STREET, 3B",2009-05-27,666953,2014-07-23,755000,88047,1883,46.75889537971322
"15 WILLIAM STREET, 25F",2009-02-25,1050000,2013-07-18,1125000,75000,1604,46.758104738154614
"2000 BROADWAY, 9H",2004-06-29,745000,2010-01-22,840000,95000,2033,46.728971962616825
"20 WEST STREET, 31F",2006-06-13,395000,2017-08-03,585000,190000,4069,46.69451953797002
"215 WEST 95TH STREET, 16C",2007-02-01,730000,2015-11-20,880000,150000,3214,46.670815183571875
"100 UNITED NATIONS PLAZA, 17D",2005-05-18,720000,2017-02-10,920000,200000,4286,46.66355576294914
"13 EAST 131ST STREET, 4B",2010-08-17,385000,2014-07-03,451000,66000,1416,46.610169491525426
"100 RIVERSIDE BOULEVARD, 9E",2008-04-02,834965,2016-05-23,973500,138535,2973,46.59771274806592
"157 EAST 32ND STREET, 12A",2006-04-28,588000,2013-07-02,710000,122000,2622,46.52936689549962
"80 RIVERSIDE BOULEVARD, 6K",2009-05-08,992793,2014-03-12,1075000,82207,1769,46.47088750706614
"514 WEST 110TH STREET, 8B",2007-06-18,592000,2015-06-03,727000,135000,2907,46.43962848297214
"20 PINE STREET, 1216",2011-12-09,835000,2016-12-14,920000,85000,1832,46.39737991266376
"225 EAST 34TH STREET, 16B",2007-12-14,1720842,2018-04-26,1896500,175658,3786,46.39672477548864
"88 GREENWICH STREET, 810",2013-05-03,558750,2015-04-20,592000,33250,717,46.373779637377964
"450 EAST 83RD STREET, 5K",2006-06-19,773870,2017-10-06,965000,191130,4127,46.31209110734189
"15 BROAD STREET, 2622",2006-08-30,719000,2018-02-01,912000,193000,4173,46.24970045530793
"231 EAST 55TH   STREET, 33C",2007-03-29,1054907,2014-12-11,1185000,130093,2814,46.230632551528075
"88 GREENWICH STREET, 306",2010-06-22,496000,2017-03-23,610000,114000,2466,46.228710462287104
"237 EAST 88TH STREET, 502",2007-09-12,390390,2016-06-13,538000,147610,3197,46.171410697528934
"635 WEST 42ND   STREET, 6D",2007-11-20,768778,2017-10-18,935752,166974,3620,46.12541436464088
"10 WEST END AVENUE, 6G",2007-07-11,872914,2010-03-15,918000,45086,978,46.100204498977504
"120 RIVERSIDE BOULEVARD, 4J",2006-05-03,765000,2017-05-01,950000,185000,4016,46.06573705179283
"120 RIVERSIDE BOULEVARD, 10C",2006-01-30,554946,2016-10-13,735000,180054,3909,46.06139677666923
"350 WEST 42ND   STREET, 4H",2006-12-15,471510,2013-05-28,580000,108490,2356,46.04838709677419
"77 PARK AVENUE, 6H",2011-09-28,895000,2014-02-13,935000,40000,869,46.029919447640964
"205 EAST 85TH   STREET, 3E",2009-11-04,1017434,2017-09-25,1150000,132566,2882,45.99791811242193
"111 FULTON STREET, 719",2008-12-29,1201535,2013-05-15,1275000,73465,1598,45.97309136420526
"56 PINE STREET, 4D",2005-12-21,773870,2017-12-20,975000,201130,4382,45.89913281606572
"660 RIVERSIDE DRIVE, 4C",2008-01-30,182900,2013-09-11,277000,94100,2051,45.880058508044854
"350 EAST 62ND STREET, 2J",2004-09-15,310000,2015-04-10,487000,177000,3859,45.86680487172843
"199 BOWERY, 12C",2006-05-11,456300,2016-06-07,625000,168700,3680,45.84239130434783
"300 RECTOR PLACE, 3I",2005-06-07,412000,2017-11-09,620000,208000,4538,45.835169678272365
"304 WEST 115 STREET, PH8A",2006-01-24,860421,2012-11-28,975000,114579,2500,45.8316
"167 WEST 136 STREET, 5",2009-01-28,427000,2015-11-02,540000,113000,2469,45.76751721344674
"219 WEST 81ST STREET, 7H",2008-06-10,1237173,2017-08-07,1390000,152827,3345,45.6881913303438
"10 WEST END AVENUE, 3E",2007-07-02,824782,2011-05-31,890000,65218,1429,45.63890832750175
"302 BROOME STREET, 5A",2007-03-12,615000,2015-08-05,755000,140000,3068,45.63233376792699
"2141 2 AVENUE, 3B",2003-10-15,215000,2015-10-16,415000,200000,4384,45.62043795620438
"350 WEST 50TH STREET, 5D",2004-11-05,407000,2010-02-16,495000,88000,1929,45.619491964748576
"660 RIVERSIDE DRIVE, 2H",2008-01-18,258570,2016-11-01,405000,146430,3210,45.61682242990654
"245 WEST 115TH ST, 19",2007-02-16,277800,2016-04-07,430000,152200,3338,45.59616536848412
"200 WEST END AVENUE, 5K",2007-12-20,666953,2012-08-27,745000,78047,1712,45.58820093457944
"380 RECTOR PLACE, 19D",2006-05-19,649000,2015-02-24,795000,146000,3203,45.582266625039026
"16 WEST 19TH   STREET, 6-D",2007-11-13,570220,2014-06-18,680000,109780,2409,45.57077625570776
"350 WEST 53RD   STREET, 4F",2014-08-22,627000,2017-07-11,675000,48000,1054,45.54079696394687
"99 READE STREET, 5F",2006-04-03,1130000,2014-01-27,1260000,130000,2856,45.51820728291317
"160 WADSWORTH AVENUE, 310",2003-09-29,192660,2013-10-23,360000,167340,3677,45.50992657057384
"120 RIVERSIDE BOULEVARD, 9C",2006-01-24,605858,2014-09-29,750000,144142,3170,45.47066246056782
"555 WEST 59TH   STREET, TH-3A",2008-10-28,4093365,2018-04-10,4250000,156635,3451,45.38829324833382
"555 WEST 23RD   STREET, N8B",2007-06-08,775000,2013-06-21,875000,100000,2205,45.35147392290249
"445 WEST 19TH STREET, 8H",2005-06-14,540000,2007-07-26,575000,35000,772,45.33678756476684
"20 WEST STREET, 12B",2006-11-07,432269,2015-06-23,575000,142731,3150,45.31142857142857
"220 RIVERSIDE BOULEVARD, 14R",2006-06-26,930000,2014-05-07,1060000,130000,2872,45.26462395543175
"170 WEST 23 STREET, 4K",2006-11-02,432000,2013-05-16,540000,108000,2387,45.24507750314202
"300 WEST 135TH STREET, 5A",2005-07-20,198424,2012-10-16,318000,119576,2645,45.208317580340264
"230 RIVERSIDE DRIVE, 3K",2007-02-07,707683,2017-03-28,875000,167317,3702,45.19638033495408
"160 WADSWORTH AVENUE, 503",2004-06-24,230000,2015-09-10,415000,185000,4095,45.17704517704518
"20 WEST STREET, 15L",2006-07-19,497874,2007-06-19,513000,15126,335,45.15223880597015
"56 PINE STREET, 6C",2005-10-24,299130,2014-11-26,449000,149870,3320,45.14156626506024
"327 CENTRAL PARK WEST, 8E",2005-08-24,811000,2015-08-07,975000,164000,3635,45.11691884456671
"200 EAST 69TH STREET, 6P",2006-02-16,880000,2013-05-30,999999,119999,2660,45.11240601503759
"315 SEVENTH AVENUE, 18E",2007-02-23,440638,2013-03-06,540000,99362,2203,45.10304130730822
"330 EAST 38TH STREET, 16B",2005-03-23,955000,2017-01-23,1150000,195000,4324,45.09713228492137
"322 WEST 57TH STREET, 21G",2007-09-24,999921,2012-04-16,1075000,75079,1666,45.065426170468186
"3 WEST 122 STREET, 2B",2005-11-14,375000,2014-12-29,525000,150000,3332,45.01800720288115
"75 WALL STREET, 24L",2008-12-16,618150,2016-05-04,739500,121350,2696,45.01112759643917
"350 EAST 54TH STREET, 3A",2006-02-07,390000,2010-12-21,470000,80000,1778,44.99437570303712
"300 RECTOR PLACE, 4G",2006-07-20,523000,2017-05-01,700000,177000,3938,44.94667343829355
"135 EAST 54 STREET, 9J",2004-05-18,345000,2012-11-28,485000,140000,3116,44.929396662387674
"393 WEST 49TH STREET, 4D",2006-09-29,558001,2015-05-27,700000,141999,3162,44.90796963946869
"220 WEST 15TH   STREET, 2-B",2007-07-06,450000,2014-03-21,560000,110000,2450,44.89795918367347
"150 WEST 51 STREET, 16-22",2003-05-02,364541,2005-06-30,400000,35459,790,44.88481012658228
"1420 YORK AVENUE, 3H",2004-10-26,265000,2018-03-29,485000,220000,4902,44.879640962872294
"35 EAST 38TH STREET, 7-B",2007-11-28,500000,2018-04-13,670000,170000,3789,44.86671945104249
"220 RIVERSIDE BOULEVARD, 5A",2005-04-22,979000,2015-02-18,1140000,161000,3589,44.85929228197269
"75 WALL STREET, 32K",2012-01-06,1153168,2015-06-26,1210000,56832,1267,44.85556432517758
"372 CENTRAL PARK WEST, 14K",2003-11-25,550000,2013-04-12,703500,153500,3426,44.804436660828955
"635 WEST 42ND   STREET, 41F",2007-07-23,1287000,2010-03-09,1330000,43000,960,44.791666666666664
"20 WEST STREET, 40A",2006-12-08,623169,2016-08-23,782000,158831,3546,44.79159616469261
"65 COOPER SQUARE, 6G",2005-02-23,650000,2012-10-15,775000,125000,2791,44.78681476173414
"200 WEST END AVENUE, 8N",2008-03-18,794235,2018-03-12,957500,163265,3646,44.77921009325288
"211 MADISON AVENUE, 12B",2008-05-07,1100000,2017-03-06,1244375,144375,3225,44.76744186046512
"630 1 AVENUE, 33S",2005-09-07,625000,2014-07-24,770000,145000,3242,44.72547809993831
"40 WEST 116 STREET, B509",2008-10-15,622480,2012-06-18,682500,60020,1342,44.724292101341284
"455 CENTRAL PARK WEST, 3",2005-11-21,430950,2015-01-06,580000,149050,3333,44.71947194719472
"167 WEST 136TH STREET, 4",2005-07-29,380250,2015-12-22,550000,169750,3798,44.69457609268036
"120 GREENWICH STREET, 6C",2006-08-24,753557,2017-02-28,925000,171443,3841,44.63499088778964
"248 EAST 31ST   STREET, 3D",2007-09-18,875000,2012-08-15,955000,80000,1793,44.617958728388174
"635 WEST 42ND STREET, 27A",2007-07-09,992793,2014-09-22,1110000,117207,2632,44.53153495440729
"111 FULTON STREET, 420",2008-12-08,600767,2014-09-02,694000,93233,2094,44.52387774594078
"230 RIVERSIDE DRIVE, 1K",2007-09-07,672045,2016-10-13,820000,147955,3324,44.51113116726835
"392 CENTRAL PARK WEST, 5V",2006-06-08,580500,2017-09-15,763687,183187,4117,44.49526354141365
"310 WEST 52ND   STREET, 12H",2007-04-04,1094618,2010-09-01,1150000,55382,1246,44.44783306581059
"660 RIVERSIDE DRIVE, 6H",2008-01-24,356000,2017-11-10,515000,159000,3578,44.438233650083845
"845 UNITED NATIONS PLAZA, 9H",2005-03-30,1212000,2010-09-01,1300000,88000,1981,44.42200908632004
"68 BRADHURST AVENUE, 6-F",2007-07-27,455034,2010-05-07,500000,44966,1015,44.30147783251231
"100 UNITED NATIONS PLAZA, 23D",2006-12-15,799000,2016-04-15,950000,151000,3409,44.29451452038721
"224 WEST 18TH STREET, 5C",2005-09-12,800000,2013-06-12,925000,125000,2830,44.169611307420496
"75 WALL STREET, 23M",2009-01-22,1486645,2015-10-14,1595000,108355,2456,44.11848534201955
"230 RIVERSIDE DRIVE, 2N",2006-12-12,464919,2013-06-21,570000,105081,2383,44.0960973562736
"360 WEST 28TH STREET, 2A",2004-05-18,243360,2010-05-19,340000,96640,2192,44.08759124087591
"111 FULTON STREET, 805",2008-11-20,646588,2016-07-21,770000,123412,2800,44.075714285714284
"595 WEST END AVENUE, 6C",2007-09-07,1496827,2012-07-16,1575000,78173,1774,44.06595264937993
"206 EAST 124TH STREET, 5A",2008-05-16,396758,2016-05-06,525000,128242,2912,44.03914835164835
"230 RIVERSIDE DRIVE, 17G",2007-05-16,471510,2014-10-03,590000,118490,2697,43.9340007415647
"43 EAST 25TH   STREET, 22C",2007-05-22,790000,2013-04-23,885000,95000,2163,43.9204808136847
"2 SOUTH END AVENUE, 5P",2008-12-17,847000,2017-07-31,985000,138000,3148,43.83735705209657
"155 EAST 38TH STREET, 4F",2004-12-13,500000,2016-03-17,680000,180000,4112,43.77431906614786
"230 RIVERSIDE DRIVE, 2F",2007-02-20,380250,2014-08-19,500000,119750,2737,43.75228352210449
"58 WEST 58TH STREET, 12D",2008-04-03,560000,2017-01-06,700000,140000,3200,43.75
"150 WEST 56TH STREET, 3509",2006-12-04,550000,2012-11-14,645000,95000,2172,43.73848987108656
"333 EAST 34TH   STREET, 17L",2007-03-19,717866,2016-02-10,860000,142134,3250,43.73353846153846
"101 WARREN STREET, 2530",2008-07-31,2324244,2011-07-15,2371403,47159,1079,43.7062094531974
"319 EAST 105 STREET, 1D",2003-01-16,219000,2015-08-21,420000,201000,4600,43.69565217391305
"20 WEST 64TH STREET, 26S",2006-06-21,800000,2010-11-09,870000,70000,1602,43.69538077403246
"101 WARREN STREET, 2430",2008-07-31,2294366,2011-07-15,2341503,47137,1079,43.68582020389249
"247 WEST 46TH   STREET, 1702",2008-10-17,1410276,2014-06-03,1500000,89724,2055,43.66131386861314
"211 EAST 46TH   STREET, PHH",2009-01-20,848548,2016-12-28,975000,126452,2899,43.61917902725077
"18 WEST 48TH   STREET, 33C",2007-09-13,1227194,2010-09-15,1275000,47806,1098,43.5391621129326
"340 EAST 64TH   STREET, 4M",2007-09-27,1235000,2016-11-09,1380000,145000,3331,43.530471329930954
"80 PARK AVENUE, 4A",2008-03-10,455000,2013-07-18,540000,85000,1956,43.4560327198364
"393 WEST 49TH STREET, 2II",2005-05-20,575000,2010-09-28,660000,85000,1957,43.43382728666326
"210 EAST 47TH   STREET, 11B",2007-04-20,820000,2017-12-14,989000,169000,3891,43.43356463634027
"301 CATHEDRAL PARKWAY, 19J",2006-10-04,645000,2015-09-28,787500,142500,3281,43.431880524230415
"300 RECTOR PLACE, 4I",2004-12-22,385000,2017-08-02,585000,200000,4606,43.421623968736434
"20 WEST STREET, 17K",2006-08-30,466440,2017-04-20,635000,168560,3886,43.376222336592896
"119 FULTON STREET, 4B",2006-12-27,809508,2014-05-28,927000,117492,2709,43.370985603543744
"200 RECTOR PLACE, 11D",2006-03-09,567500,2015-07-02,715000,147500,3402,43.356848912404466
"51 EAST 128TH STREET, 3B",2010-11-30,425000,2017-08-10,531000,106000,2445,43.353783231083845
"21 SOUTH WILLIAM STREET, 7B",2006-05-16,594658,2016-10-24,760000,165342,3814,43.351337178814894
"75 WALL STREET, 21G",2008-11-20,906242,2015-11-19,1017000,110758,2555,43.349510763209395
"111 FULTON STREET, 416",2009-01-08,717866,2013-08-01,790000,72134,1666,43.29771908763505
"753 EAST 5TH STREET, 3B",2005-07-07,605858,2017-10-18,800000,194142,4486,43.27730717788676
"120 RIVERSIDE BOULEVARD, 3C",2005-11-17,500834,2012-06-21,605000,104166,2408,43.25830564784053
"80 JOHN STREET, 3H",2007-01-24,420810,2017-02-20,580000,159190,3680,43.25815217391305
"75 WALL STREET, 19H",2009-02-09,554946,2017-08-31,690000,135054,3125,43.21728
"350 WEST 42ND   STREET, 60C",2006-12-28,1145000,2010-06-23,1200000,55000,1273,43.20502749410841
"382 CENTRAL PARK WEST, 1A",2005-08-26,655000,2013-11-21,785000,130000,3009,43.20372216683283
"2 SOUTH END AVENUE, 8H",2009-09-14,419000,2016-09-27,530000,111000,2570,43.190661478599225
"261 WEST 28TH STREET, 7A",2007-11-21,1807393,2013-06-11,1895000,87607,2029,43.177427304090685
"170 WEST 23RD STREET, 6F",2007-06-01,702000,2017-02-13,855000,153000,3545,43.15937940761636
"1420 YORK AVENUE, 6F",2004-07-23,300000,2018-03-15,515000,215000,4983,43.14669877583785
"415 EAST 37TH   STREET, 9G",2008-03-24,999000,2014-08-21,1100000,101000,2341,43.1439555745408
"80 JOHN STREET, 10I",2007-03-20,760836,2012-07-23,845000,84164,1952,43.11680327868852
"111 FULTON STREET, 310",2008-12-04,748413,2015-09-15,855000,106587,2476,43.04806138933764
"2 SOUTH END AVENUE, 5R",2005-01-27,565000,2011-06-08,665000,100000,2323,43.04778303917348
"400 EAST 90TH   STREET, 9A",2008-06-12,610950,2016-12-21,745000,134050,3114,43.04752729608221
"2250 BROADWAY, 8B",2006-01-03,1390000,2012-05-15,1490000,100000,2324,43.029259896729776
"425 FIFTH AVENUE, 43D",2004-10-15,1069162,2011-07-11,1175000,105838,2460,43.02357723577236
"20 WEST STREET, 43C",2007-08-03,598221,2018-02-12,763687,165466,3846,43.02288091523661
"2 SOUTH END AVENUE, 5T",2007-04-27,425000,2016-06-27,569000,144000,3349,42.99790982382801
"555 WEST 23RD STREET, S11P",2006-09-12,620000,2015-12-07,765000,145000,3373,42.98843759264749
"2 COLUMBUS AVENUE, 12D",2005-06-20,987500,2017-05-31,1175000,187500,4363,42.975017190006874
"350 WEST 53RD   STREET, 3J",2008-11-21,1125000,2013-12-27,1205000,80000,1862,42.964554242749735
"555 WEST 23RD   STREET, S15D",2007-01-04,1583378,2013-04-16,1681875,98497,2294,42.93679163034002
"76 MADISON AVENUE, 2C",2007-04-26,999996,2013-09-11,1100000,100004,2330,42.920171673819745
"455 MAIN STREET, 14A",2006-04-25,580402,2013-12-12,700000,119598,2788,42.8974175035868
"200 EAST 58TH STREET, 12G",2004-10-14,386000,2018-06-13,600000,214000,4990,42.88577154308617
"20 WEST STREET, 12G",2008-06-16,621132,2017-12-21,770000,148868,3475,42.83971223021583
"2 SOUTH END AVENUE, 6G",2004-08-30,365000,2017-06-12,565000,200000,4669,42.83572499464553
"111 FULTON STREET, 421",2008-12-09,590585,2018-08-14,742000,151415,3535,42.83309759547383
"300 CATHEDRAL PARKWAY, 1G",2005-06-16,379000,2014-12-10,527000,148000,3464,42.725173210161664
"120 RIVERSIDE BOULEVARD, 14C",2006-02-08,605858,2016-08-22,770250,164392,3848,42.72141372141372
"310 WEST 52ND   STREET, 20A",2007-03-23,956136,2011-12-16,1030000,73864,1729,42.72064777327935
"236 EAST 47TH STREET, 26F",2013-07-09,1285000,2017-03-20,1342500,57500,1350,42.592592592592595
"2109 BROADWAY, 12142",2013-06-28,475000,2014-08-13,492500,17500,411,42.579075425790755
"2 SOUTH END AVENUE, 5S",2004-03-15,342000,2016-12-08,540000,198000,4651,42.57149000215008
"20 WEST STREET, 37E",2006-11-21,549855,2015-04-06,680000,130145,3058,42.55886200130804
"1420 YORK AVENUE, 4J",2003-01-17,185000,2012-05-17,330000,145000,3408,42.54694835680751
"71 NASSAU STREET, 2D",2006-08-03,773870,2018-07-30,960000,186130,4379,42.50513815939712
"382 CENTRAL PARK WEST, 10A",2004-10-13,640000,2011-11-18,750000,110000,2592,42.43827160493827
"80 JOHN STREET, 11H",2007-03-29,451230,2016-11-02,600000,148770,3506,42.43297204791786
"464 WEST 44TH   STREET, 4H",2008-01-25,575301,2017-05-23,719800,144499,3406,42.42483852025837
"313 WEST 119 STREET, 1B",2014-04-29,632548,2016-06-02,665000,32452,765,42.42091503267974
"311 EAST 38TH STREET, 2D",2006-06-09,483000,2015-04-14,620000,137000,3231,42.40173320953265
"56 PINE STREET, 12A",2005-12-15,595676,2014-01-31,721500,125824,2969,42.37925227349276
"415 GREENWICH STREET, PH-C",2014-10-21,9500000,2018-05-11,9555000,55000,1298,42.3728813559322
"230 EAST 52ND STREET, 5D",2007-12-06,605000,2012-02-17,670000,65000,1534,42.3728813559322
"220 RIVERSIDE BOULEVARD, 22B",2004-06-21,660000,2012-11-15,790000,130000,3069,42.359074617139136
"120 RIVERSIDE BOULEVARD, 10N",2006-02-06,987702,2013-08-14,1104000,116298,2746,42.35178441369264
"15 BROAD STREET, 1016",2008-01-15,1595000,2013-03-18,1675000,80000,1889,42.35044997353097
"119 CHAMBERS STREET, 2",2008-04-10,3049658,2017-12-29,3200000,150342,3550,42.349859154929575
"325 FIFTH AVENUE, 39E",2007-02-28,1221900,2010-08-05,1275000,53100,1254,42.344497607655505
"310 EAST HOUSTON STREET, PHF",2007-06-27,784052,2016-08-09,925000,140948,3331,42.314019813869706
"635 WEST 42ND STREET, 12J",2007-05-24,641497,2017-08-02,799000,157503,3723,42.30539887187752
"250 WEST 88TH   STREET, 209",2008-10-02,730000,2017-03-02,860000,130000,3073,42.30393752033843
"80 JOHN STREET, 12C",2008-05-14,1440315,2013-11-07,1525000,84685,2003,42.2790813779331
"56 PINE STREET, 3A",2006-01-13,524398,2014-06-30,655000,130602,3090,42.266019417475725
"40 SUTTON PLACE, 3F",2005-03-31,429000,2015-08-12,589000,160000,3786,42.26096143687269
"450 EAST 83RD STREET, 6C",2006-07-25,1176078,2016-03-18,1325000,148922,3524,42.259364358683314
"107 EAST 31ST STREET, 4A",2008-06-18,679172,2014-12-30,780000,100828,2386,42.25817267393126
"125 EAST 12TH   STREET, 1-D",2008-09-04,2220000,2012-03-29,2275000,55000,1302,42.242703533026116
"377 RECTOR PLACE, 12A",2006-07-20,738000,2016-09-22,895000,157000,3717,42.23836427226258
"211 EAST 46TH   STREET, 18E",2008-10-20,768157,2014-01-16,849000,80843,1914,42.23772204806688
"235 WEST 137TH STREET, 4R",2008-04-08,352450,2015-07-28,465000,112550,2667,42.20097487814023
"300 CATHEDRAL PARKWAY, 12G",2005-03-08,350000,2010-01-19,425000,75000,1778,42.1822272215973
"2250 BROADWAY, 5L",2004-08-27,445000,2014-05-30,595000,150000,3563,42.09935447656469
"300 WEST 135TH STREET, 7K",2005-05-20,434356,2012-04-03,540000,105644,2510,42.08924302788844
"184 THOMPSON STREET, 2J",2007-04-26,461370,2012-06-07,540000,78630,1869,42.07062600321027
"1600 BROADWAY, 18E",2006-06-22,941881,2016-10-06,1100000,158119,3759,42.06411279595637
"418 CENTRAL PARK WEST, 50",2003-07-30,335000,2012-11-08,477500,142500,3389,42.0478017114193
"1600 BROADWAY, 14F",2006-12-13,585493,2012-10-12,675000,89507,2130,42.022065727699534
"2148 BROADWAY, 14A",2012-09-20,8800000,2016-08-19,8860000,60000,1429,41.98740377886634
"299 WEST 12TH STREET, 7B",2006-10-19,675000,2016-10-06,827739,152739,3640,41.96126373626374
"20 WEST STREET, 33F",2006-04-28,407426,2015-07-29,549000,141574,3379,41.89819473216928
"20 WEST STREET, 15A",2007-04-09,390390,2013-05-22,484000,93610,2235,41.883668903803134
"300 ALBANY STREET, 5A",2003-02-26,231000,2013-04-18,386000,155000,3704,41.84665226781858
"80 JOHN STREET, 6A",2008-01-24,616042,2014-11-14,720000,103958,2486,41.81737731295254
"120 RIVERSIDE BOULEVARD, 9H",2006-01-12,877731,2013-09-18,995000,117269,2806,41.79223093371347
"595 WEST END AVENUE, 2A",2007-09-06,2673498,2011-05-20,2730000,56502,1352,41.7914201183432
"250 EAST 54TH STREET, 8B",2006-12-01,440000,2017-05-30,600000,160000,3833,41.74276024002087
"71 NASSAU STREET, 13C",2006-12-19,1221900,2014-01-21,1330000,108100,2590,41.737451737451735
"111 EAST 88TH STREET, 10C",2005-06-03,703000,2014-05-30,840000,137000,3283,41.730124885775204
"455 MAIN STREET, PH1B",2006-05-22,819691,2014-08-12,945000,125309,3004,41.71404793608522
"350 EAST 62ND   STREET, 4C",2013-09-30,500000,2016-12-19,549000,49000,1176,41.666666666666664
"106 CENTRAL PARK SOUTH, 8J",2007-01-25,440000,2017-11-28,605000,165000,3960,41.666666666666664
"330 EAST 33RD   STREET, 15-L",2006-12-04,840000,2017-06-09,999999,159999,3840,41.66640625
"725 RIVERSIDE DRIVE, 11G",2007-10-12,400530,2014-08-26,505000,104470,2510,41.62151394422311
"420 WEST 25TH   STREET, 2B",2008-01-17,967337,2013-10-24,1055000,87663,2107,41.605600379686756
"350 WEST 50TH STREET, 35H",2009-01-26,745000,2015-04-29,840000,95000,2284,41.59369527145359
"200 WEST 109 STREET, UNIT2",2005-12-12,330000,2011-11-21,420000,90000,2170,41.474654377880185
"56 PINE STREET, 7E",2005-10-27,304200,2014-06-17,435000,130800,3155,41.45800316957211
"211 WEST 88TH   STREET, 3A",2009-12-17,471510,2012-07-03,510000,38490,929,41.431646932185146
"300 CATHEDRAL PARKWAY, 16G",2005-06-23,491000,2007-04-30,519000,28000,676,41.42011834319526
"110 MANHATTAN AVENUE, 45",2004-08-27,749000,2010-05-05,835000,86000,2077,41.40587385652383
"200 RECTOR PLACE, 5S",2004-12-02,388000,2014-04-24,530000,142000,3430,41.39941690962099
"123 WASHINGTON STREET, 48F",2014-07-23,2214693,2018-07-19,2275000,60307,1457,41.39121482498284
"333 EAST 34TH   STREET, 2O",2007-04-20,555000,2015-03-30,675000,120000,2901,41.36504653567735
"300 ALBANY STREET, 7G",2003-07-23,242000,2017-05-23,451000,209000,5053,41.36156738571146
"100 RIVERSIDE BOULEVARD, 3H",2007-12-27,753505,2018-05-08,910000,156495,3785,41.34610303830912
"120 RIVERSIDE BOULEVARD, 11C",2006-01-25,496454,2010-08-11,565000,68546,1659,41.317661241711875
"303 GREENWICH STREET, 7D",2008-01-11,1187500,2013-07-01,1270000,82500,1998,41.291291291291294
"220 RIVERSIDE BOULEVARD, 3P",2004-11-03,705000,2017-09-15,899000,194000,4699,41.285379868057035
"392 CENTRAL PARK WEST, 5T",2008-06-02,550000,2014-05-23,640000,90000,2181,41.26547455295736
"865 FIRST AVENUE, 14B",2007-10-26,560000,2015-06-16,675000,115000,2790,41.21863799283154
"23 EAST 128 STREET, 1F",2006-05-19,441090,2016-11-03,598500,157410,3821,41.19602198377388
"150 NASSAU STREET, 16C",2004-03-11,1571160,2012-10-03,1700000,128840,3128,41.18925831202046
"247 WEST 46TH   STREET, 3301",2009-02-06,1570472,2014-05-22,1650000,79528,1931,41.18487830139824
"10 WEST END AVENUE, 11J",2007-08-01,699334,2013-07-19,789000,89666,2179,41.15006883891694
"245 WEST 115 STREET, 2",2008-03-20,290000,2018-03-16,440000,150000,3648,41.11842105263158
"99 BATTERY PLACE, 26-A",2015-06-11,642000,2018-08-22,690000,48000,1168,41.0958904109589
"1965 BROADWAY, 18E",2004-08-31,1800000,2011-05-03,1900000,100000,2436,41.050903119868636
"400 CENTRAL PARK WEST, 2F",2004-08-18,349000,2012-09-14,470000,121000,2949,41.030857917938285
"20 WEST STREET, 14G",2007-09-05,655931,2017-02-28,798000,142069,3464,41.01299076212471
"635 WEST 42ND   STREET, 14M",2007-05-23,776519,2016-12-20,920000,143481,3499,41.00628751071735
"20 WEST STREET, 34H",2006-10-16,430950,2016-09-30,580000,149050,3637,40.981578223810835
"107 EAST 31ST STREET, 5B",2008-06-30,578366,2015-04-17,680000,101634,2482,40.94842868654311
"425 FIFTH AVENUE, 60A",2005-06-16,1387365,2015-04-27,1534675,147310,3602,40.89672404219878
"736 WEST 187 STREET, 207",2005-11-16,496860,2014-06-16,625000,128140,3134,40.887045309508615
"350 WEST 42ND   STREET, 33A",2014-07-25,1440000,2017-11-29,1490000,50000,1223,40.88307440719542
"177 EAST 77TH STREET, 1C",2005-04-22,707683,2008-01-29,749000,41317,1012,40.82707509881423
"350 WEST 57TH STREET, 7E",2007-06-12,545000,2011-06-21,605000,60000,1470,40.816326530612244
"144 COLUMBUS AVENUE, 7E",2004-09-23,780000,2010-02-04,860000,80000,1960,40.816326530612244
"504 WEST 136TH STREET, 3D",2008-06-12,662500,2018-04-26,809500,147000,3605,40.77669902912621
"324 PEARL STREET, 2G",2006-09-29,585000,2013-06-17,685000,100000,2453,40.766408479412966
"99 JOHN STREET, 902",2011-11-02,482500,2015-05-13,535000,52500,1288,40.76086956521739
"2 SOUTH END AVENUE, 5K",2003-01-29,300000,2014-02-28,465000,165000,4048,40.76086956521739
"317 WEST 89TH STREET, 2W2",2007-05-09,278850,2013-10-24,375000,96150,2360,40.74152542372882
"119 FULTON STREET, 5B",2007-01-24,758596,2013-11-19,860000,101404,2491,40.70814933761542
"350 EAST 62ND STREET, 4K",2008-02-07,495000,2015-02-05,599000,104000,2555,40.70450097847358
"150 NASSAU STREET, 20D",2003-05-29,1308418,2007-11-21,1375000,66582,1637,40.673182651191205
"45 PARK AVENUE, 804",2008-02-06,1232082,2017-05-24,1370000,137918,3395,40.62385861561119
"184 THOMPSON STREET, 5G",2007-04-30,804417,2013-06-13,895000,90583,2236,40.51118067978533
"236 EAST 47TH STREET, 22D",2005-05-26,392500,2012-08-22,499500,107000,2645,40.45368620037807
"227 EAST 111 STREET, 2D",2005-04-05,276799,2015-12-23,435000,158201,3914,40.41926417986714
"1991 BROADWAY, 7B",2005-06-16,710000,2011-07-22,800000,90000,2227,40.41311180960934
"21 SOUTH END AVENUE, 334",2004-10-22,430000,2016-05-02,600000,170000,4210,40.38004750593824
"82 BEAVER STREET, PH03",2007-04-10,429936,2016-02-03,560000,130064,3221,40.38000620925178
"24 WEST 45 STREET, 7",2003-09-17,820000,2010-07-01,920000,100000,2479,40.338846308995564
"408 EAST 79TH STREET, 14B",2005-12-15,2517723,2013-03-28,2625000,107277,2660,40.3296992481203
"69 WEST 106 STREET, 4A",2004-02-06,415000,2012-08-02,540000,125000,3100,40.32258064516129
"660 RIVERSIDE DRIVE, 2E",2008-01-30,182500,2013-05-06,260000,77500,1923,40.301612064482576
"425 5 AVENUE, 41A",2004-06-30,814600,2015-09-28,980000,165400,4107,40.27270513757
"1600 BROADWAY, 5A",2006-08-22,890968,2018-02-21,1060000,169032,4201,40.23613425374911
"325 EAST 9TH STREET, 3",2006-06-30,625000,2018-05-31,800000,175000,4353,40.202159430277966
"1420 YORK AVENUE, 3D",2013-03-13,330000,2014-11-25,355000,25000,622,40.19292604501608
"315 SEVENTH AVENUE, 15D",2007-02-28,380430,2013-05-01,471000,90570,2254,40.18189884649512
"350 EAST 82ND STREET, 5T",2006-10-10,501930,2016-07-11,645000,143070,3562,40.16563728242561
"10 WEST END AVENUE, 11E",2007-08-13,851623,2013-08-22,940000,88377,2201,40.1531122217174
"20 WEST STREET, 42A",2006-11-21,636406,2015-04-27,760000,123594,3079,40.14095485547256
"13 EAST 131 STREET, 5A",2004-02-12,354900,2014-09-12,510000,155100,3865,40.129366106080205
"15 BROAD STREET, 3214",2006-10-13,979556,2012-12-14,1070000,90444,2254,40.12599822537711
"350 EAST 54TH STREET, 1J",2007-12-18,635000,2015-02-17,740000,105000,2618,40.106951871657756
"230 RIVERSIDE DRIVE, 2C",2008-06-30,237000,2013-06-27,310000,73000,1823,40.04388370817334
"443 WEST 151 STREET, 3C",2003-11-17,135000,2009-12-21,224000,89000,2226,39.98203054806828
"100 RIVERSIDE BOULEVARD, 6T",2008-02-06,845147,2016-12-29,975000,129853,3249,39.96706678978147
"237 EAST 88TH STREET, 404",2007-09-17,344760,2017-08-29,490000,145240,3634,39.96697853604843
"15 EAST 69TH   STREET, 10D",2010-01-15,5098000,2017-01-11,5200000,102000,2553,39.952996474735606
"140 EAST 63RD   STREET, 6F",2007-11-13,1272812,2016-08-02,1400000,127188,3185,39.93343799058085
"300 RECTOR PLACE, 1G",2009-12-16,372000,2015-04-23,450000,78000,1954,39.91811668372569
"300 ALBANY STREET, 3O",2007-05-16,312500,2017-02-23,455000,142500,3571,39.90478857462895
"176 WEST 86TH STREET, 2B",2007-03-14,349000,2016-09-02,487000,138000,3460,39.884393063583815
"275 GREENWICH STREET, 5PS",2005-08-17,409000,2013-08-08,525000,116000,2913,39.82148987298318
"184 THOMPSON STREET, 5B",2007-06-28,731615,2012-11-21,810000,78385,1973,39.72883933096807
"1760 2 AVENUE, 18B",2005-01-31,815000,2011-05-11,906000,91000,2291,39.72064600611087
"350 WEST 50TH   STREET, 3N",2007-02-01,445000,2016-11-30,587500,142500,3590,39.693593314763234
"220 EAST 65TH STREET, 2K",2005-07-12,660000,2016-07-25,820000,160000,4031,39.69238402381543
"201 WEST 74TH STREET, 9J",2008-03-28,875000,2013-05-31,950000,75000,1890,39.682539682539684
"306 MOTT STREET, 7A",2007-04-10,1492754,2012-12-12,1575000,82246,2073,39.6748673420164
"333 EAST 30TH STREET, 14-E",2014-08-20,520000,2018-07-02,576000,56000,1412,39.6600566572238
"225 EAST 46 STREET, 8E",2005-01-31,330000,2009-09-30,397500,67500,1703,39.635936582501465
"310 EAST 53RD STREET, 17C",2006-10-23,3840686,2017-10-27,4000000,159314,4022,39.61064147190452
"120 WEST 58TH STREET, 6B",2004-12-06,536000,2012-02-17,640000,104000,2629,39.55876759224039
"425 MAIN STREET, 9K",2007-07-16,403000,2013-12-02,495000,92000,2331,39.46803946803947
"120 GREENWICH STREET, 9J",2006-07-20,575311,2016-12-09,725000,149689,3795,39.443741765480894
"5 EAST 44TH   STREET, 2A",2010-07-09,914000,2016-06-30,999999,85999,2183,39.39486944571691
"200 CHAMBERS STREET, 2N",2007-03-06,821727,2013-04-24,910000,88273,2241,39.39000446229362
"49 EAST 21ST   STREET, 5C",2013-03-15,2160000,2018-01-30,2230000,70000,1782,39.28170594837262
"150 EAST 85TH STREET, 3E",2007-06-26,600000,2014-06-16,700000,100000,2547,39.2618767177071
"2628 BROADWAY, 7C",2007-10-16,2133233,2011-08-11,2188000,54767,1395,39.25949820788531
"75 WALL STREET, 28P",2009-03-05,1380535,2017-09-21,1503000,122465,3122,39.22645739910314
"230 RIVERSIDE DRIVE, 17J",2007-04-06,446160,2014-07-09,550000,103840,2651,39.170124481327804
"148 MADISON STREET, 7B",2003-11-13,277646,2018-01-05,480000,202354,5167,39.16276369266499
"211 EAST 46TH   STREET, 33E",2008-11-10,855513,2017-12-01,985000,129487,3308,39.14359129383313
"100 RIVERSIDE BOULEVARD, 6E",2008-04-04,841583,2017-12-11,980000,138417,3538,39.122950819672134
"340 EAST 23RD STREET, 6K",2008-02-25,814600,2014-01-22,899000,84400,2158,39.110287303058385
"88 GREENWICH STREET, 401",2011-05-02,521344,2018-03-29,620000,98656,2523,39.10265556876734
"114 EAST 13TH STREET, 7D",2004-11-04,895000,2010-04-12,972500,77500,1985,39.042821158690174
"1619 THIRD AVENUE, 23H",2007-12-10,1160000,2014-12-15,1260000,100000,2562,39.032006245120996
"220 WEST 93RD STREET, 5C",2007-07-09,911333,2013-05-22,995000,83667,2144,39.023787313432834
"393 WEST 49TH STREET, 5JJ",2005-08-16,706173,2015-01-06,840000,133827,3430,39.01661807580175
"20 WEST STREET, 28E",2007-04-03,441090,2018-04-10,598000,156910,4025,38.98385093167702
"630 1 AVENUE, 17P",2005-06-23,700000,2018-04-18,882500,182500,4682,38.97906877402819
"310 WEST 52ND   STREET, 16C",2007-06-18,847693,2009-09-24,880000,32307,829,38.97104945717732
"166 EAST 63RD   STREET, 6E",2007-07-30,885000,2015-06-15,997000,112000,2877,38.929440389294406
"200 EAST 89TH   STREET, 26A",2007-07-19,666000,2015-12-01,785000,119000,3057,38.92705266601243
"186 WEST 80TH   STREET, 3K",2005-10-03,559000,2014-12-23,690000,131000,3368,38.895486935866984
"158 HESTER STREET, 3D",2006-08-24,1425550,2013-08-26,1525000,99450,2559,38.86283704572099
"100 WEST 89TH   STREET, 8G",2007-06-08,1300000,2012-05-14,1370000,70000,1802,38.8457269700333
"100 READE STREET, 6-C",2008-07-29,901600,2011-12-27,950000,48400,1246,38.84430176565008
"15 WILLIAM STREET, 30F",2009-03-02,1143577,2015-12-21,1240000,96423,2485,38.80201207243461
"736 WEST 187 STREET, 602",2005-10-17,544763,2008-08-19,585000,40237,1037,38.80135004821601
"300 RECTOR PLACE, 8T",2004-06-18,320000,2013-12-30,455000,135000,3482,38.77082136703044
"227 EAST 111 STREET, 3D",2005-04-12,276799,2015-09-30,425000,148201,3823,38.765629087104365
"200 WEST 109 STREET, A5",2006-06-28,850000,2013-06-26,949000,99000,2555,38.74755381604697
"660 RIVERSIDE DRIVE, 4D",2008-10-14,224094,2010-06-23,248000,23906,617,38.74554294975689
"311 GREENWICH STREET, 6E",2005-07-25,1665000,2012-04-12,1760000,95000,2453,38.72808805544231
"530 EAST 76TH   STREET, 10A",2007-07-05,749000,2013-03-27,830000,81000,2092,38.718929254302104
"155 WEST 71ST   STREET, 2D",2007-06-29,1265000,2014-08-20,1366000,101000,2609,38.7121502491376
"20 WEST STREET, 33G",2007-01-24,436020,2014-08-26,543200,107180,2771,38.679177192349336
"176 WEST 86TH STREET, 9A",2005-05-13,682000,2016-07-20,840000,158000,4086,38.66862457170827
"120 GREENWICH STREET, 8C",2006-12-15,742000,2016-09-23,880000,138000,3570,38.65546218487395
"1619 3 AVENUE, 14F",2003-02-20,384712,2014-11-06,550000,165288,4277,38.64577975216273
"56 PINE STREET, 8C",2005-10-19,319410,2013-04-30,425650,106240,2750,38.63272727272727
"120 RIVERSIDE BOULEVARD, 4U",2006-10-04,599000,2016-10-07,740000,141000,3656,38.566739606126916
"300 WEST 135TH STREET, 11D",2005-08-30,337546,2015-06-23,475710,138164,3584,38.550223214285715
"340 CABRINI BOULEVARD, 101",2005-05-10,415740,2014-07-18,545000,129260,3356,38.5160905840286
"736 WEST 187TH STREET, 609",2005-11-07,692410,2015-12-28,835000,142590,3703,38.506616257088844
"377 RECTOR PLACE, 24F",2006-12-27,660000,2014-10-23,770000,110000,2857,38.501925096254816
"635 WEST 42ND   STREET, 3H",2008-04-04,763687,2017-12-15,900000,136313,3542,38.484754376058724
"340 EAST 23RD STREET, 5B",2008-01-25,580402,2016-07-29,700000,119598,3108,38.48069498069498
"202 WEST 140 STREET, 5B",2007-11-21,506898,2014-06-11,599000,92102,2394,38.47201336675021
"123 WASHINGTON STREET, 38F",2012-03-28,1374637,2017-08-09,1450000,75363,1960,38.45051020408163
"148 MADISON STREET, 8F",2003-06-18,322452,2013-10-31,468000,145548,3788,38.4234424498416
"845 UNITED NATIONS PLAZA, 18F",2004-07-01,560000,2011-08-17,660000,100000,2603,38.417210910487896
"350 EAST 82ND   STREET, 10E",2007-04-03,565128,2018-04-20,720000,154872,4035,38.382156133829
"835 RIVERSIDE DRIVE, 3F",2009-12-23,294060,2014-09-12,360000,65940,1724,38.24825986078886
"100 WEST 58TH   STREET, 5H",2008-07-16,845000,2014-07-22,929000,84000,2197,38.23395539371871
"635 WEST 42ND   STREET, 9L",2008-07-23,738231,2015-11-09,840000,101769,2665,38.18724202626642
"230 RIVERSIDE DRIVE, 14H",2007-01-30,855330,2016-01-12,980000,124670,3269,38.13704496788009
"225 EAST 86TH STREET, 601",2004-08-09,500000,2018-02-08,688000,188000,4931,38.12614074224295
"225 RECTOR PLACE, 15E",2008-05-20,773870,2018-03-01,910000,136130,3572,38.11030235162374
"300 EAST 90TH STREET, 8B",2008-07-01,610000,2017-02-15,730000,120000,3151,38.08314820691844
"15 BROAD STREET, 3900",2007-07-27,2790005,2012-12-17,2865000,74995,1970,38.068527918781726
"393 WEST 49TH STREET, 2K",2006-04-19,379000,2014-08-29,495000,116000,3054,37.98297314996726
"255 EAST 49TH STREET, 27B",2005-10-04,865000,2013-09-10,975000,110000,2898,37.95721187025535
"340 EAST 23RD   STREET, 5F",2008-08-21,825000,2013-11-15,897500,72500,1912,37.91841004184101
"317 WEST 95TH   STREET, C5",2007-03-05,640000,2013-09-03,730000,90000,2374,37.91069924178601
"65 COOPER SQUARE, 2B",2006-01-04,805000,2018-04-19,975000,170000,4488,37.878787878787875
"275 GREENWICH STREET, 4FS",2004-12-06,521000,2012-06-14,625000,104000,2747,37.859483072442664
"871 8 AVENUE, 4A",2006-04-10,465000,2015-09-04,595000,130000,3434,37.85672684915551
"116 CENTRAL PARK SOUTH, 3A",2005-07-08,925000,2017-10-26,1095000,170000,4493,37.8366347651903
"302 WEST 12TH   STREET, 3C",2007-03-08,1125000,2011-03-04,1180000,55000,1457,37.74879890185312
"300 RECTOR PLACE, 5L",2005-08-03,415000,2015-09-30,555000,140000,3710,37.735849056603776
"393 WEST 49TH   STREET, 3CC",2007-12-17,500000,2016-04-22,615000,115000,3049,37.7172843555264
"225 WEST 83RD   STREET, 16G",2009-11-24,720000,2013-06-10,768778,48778,1294,37.695517774343124
"377 RECTOR PLACE, 3J",2005-08-01,628000,2016-06-06,777000,149000,3962,37.60726905603231
"2 SOUTH END AVENUE, 8P",2005-05-31,525000,2012-04-04,619000,94000,2500,37.6
"130 WEST 19TH STREET, 7A",2006-10-11,1705568,2010-01-05,1750000,44432,1182,37.59052453468697
"350 EAST 82ND STREET, 9C",2006-10-13,743322,2016-09-28,880000,136678,3638,37.5695437053326
"20 WEST STREET, 14C",2006-06-30,387348,2013-06-06,482500,95152,2533,37.564942755625744
"333 WEST 56TH   STREET, 5H",2008-10-02,625000,2017-10-16,749000,124000,3301,37.56437443199031
"20 WEST STREET, 16C",2006-05-26,405600,2018-05-25,570000,164400,4382,37.51711547238704
"231 EAST 55TH   STREET, 44B",2008-07-16,1226991,2013-11-14,1300000,73009,1947,37.49820236260914
"400 EAST 90TH   STREET, 8D",2007-06-19,898096,2013-01-30,975000,76904,2052,37.4775828460039
"635 WEST 42ND   STREET, 4B",2007-12-28,749432,2018-04-05,890000,140568,3751,37.47480671820848
"306 MOTT STREET, 3B",2004-07-02,288990,2012-06-22,398000,109010,2912,37.434752747252745
"380 RECTOR PLACE, 4N",2007-05-31,735250,2015-06-10,845000,109750,2932,37.431787175989086
"175 PAYSON AVENUE, 6B",2009-02-11,380000,2014-12-23,460000,80000,2141,37.365716954694065
"275 GREENWICH STREET, 11DS",2004-09-08,659000,2011-04-14,749000,90000,2409,37.359900373599004
"120 GREENWICH STREET, 3H",2006-07-18,599749,2015-10-20,726000,126251,3381,37.341319136350194
"516 WEST 47TH STREET, S7L",2006-05-02,594861,2013-10-03,696000,101139,2711,37.3068978236813
"150 WEST 56TH STREET, 4311",2005-05-24,550000,2010-03-02,615000,65000,1743,37.29202524383247
"350 EAST 82ND STREET, 11F",2006-10-06,492804,2011-09-13,560037,67233,1803,37.28951747088186
"340 CABRINI BOULEVARD, 102",2004-07-29,534581,2015-12-01,689000,154419,4142,37.281265089328826
"145 EAST 48TH STREET, 19A",2005-10-31,690000,2018-03-05,858000,168000,4508,37.267080745341616
"517 WEST 46TH   STREET, 503",2008-02-08,722957,2013-09-10,799000,76043,2041,37.257716805487505
"20 WEST STREET, 41A",2006-06-16,626223,2015-12-04,755000,128777,3458,37.24031231925969
"520 EAST 81ST   STREET, 2J",2015-08-19,520000,2017-11-03,550000,30000,807,37.174721189591075
"516 WEST 47TH STREET, S2K",2006-05-01,334620,2012-08-14,420000,85380,2297,37.17022202873313
"1600 BROADWAY, 10A",2006-07-25,875712,2011-09-02,945000,69288,1865,37.15174262734585
"350 WEST 50TH   STREET, 35A",2008-12-11,410000,2017-02-16,521000,111000,2989,37.13616594178655
"20 WEST STREET, 16D",2006-08-25,446160,2017-12-28,600000,153840,4143,37.132512671976826
"220 RIVERSIDE BOULEVARD, 20W",2004-08-24,550000,2017-07-20,725000,175000,4713,37.13133884998939
"4260 BROADWAY, 107",2005-09-29,250000,2016-06-10,395000,145000,3907,37.112874328129
"154 ATTORNEY STREET, 604",2006-11-22,575386,2015-05-08,690000,114614,3089,37.10391712528326
"201 EAST 36TH STREET, 9F",2007-06-25,749000,2015-04-24,855000,106000,2860,37.06293706293706
"340 CABRINI BOULEVARD, 601",2004-06-21,529490,2014-07-02,665000,135510,3663,36.994266994266994
"68 BRADHURST AVENUE, 7-E",2007-07-24,687740,2015-09-17,797800,110060,2977,36.97010413167619
"353 WEST 56TH   STREET, 2A",2007-06-18,905000,2013-10-04,990000,85000,2300,36.95652173913044
"400 EAST 70TH   STREET, 3403",2007-10-22,1250000,2012-08-15,1315000,65000,1759,36.95281409891984
"15 WILLIAM STREET, 42C",2014-12-04,1277903,2017-04-21,1310000,32097,869,36.9355581127733
"100 RIVERSIDE BOULEVARD, 9T",2008-04-01,880786,2016-09-20,995000,114214,3094,36.914673561732386
"635 WEST 42ND   STREET, 29B",2008-02-22,916425,2015-08-28,1017500,101075,2744,36.83491253644315
"310 EAST HOUSTON STREET, PHB",2007-07-25,789143,2013-07-29,870000,80857,2196,36.82012750455373
"15 BROAD STREET, 2806",2006-08-24,1135348,2011-06-16,1200000,64652,1757,36.79681274900398
"80 RIVERSIDE BOULEVARD, 7F",2009-07-31,641497,2016-11-29,740000,98503,2678,36.782300224047795
"635 WEST 42ND   STREET, 7E",2008-09-03,748000,2014-05-29,825000,77000,2094,36.77172874880611
"455 EAST 86TH STREET, 15B",2005-12-08,825000,2013-11-06,931250,106250,2890,36.76470588235294
"230 RIVERSIDE DRIVE, 4B",2007-03-30,666953,2014-12-04,770000,103047,2806,36.72380612972202
"117 EAST 57TH STREET, 40D",2006-09-20,1872500,2008-10-08,1900000,27500,749,36.71562082777036
"455 MAIN STREET, 4P",2007-09-17,426625,2014-10-30,522000,95375,2600,36.68269230769231
"421 EAST 13TH   STREET, 4E",2008-01-14,656771,2017-08-11,785000,128229,3497,36.66828710323134
"350 WEST 42ND STREET, 41G",2006-09-14,1535072,2012-04-19,1610000,74928,2044,36.657534246575345
"200 WEST END AVENUE, 6K",2008-05-20,753505,2013-09-23,825000,71495,1952,36.626536885245905
"295 GREENWICH STREET, 4KN",2007-01-11,645000,2010-03-03,687000,42000,1147,36.61726242371404
"236 EAST 47TH STREET, 28F",2004-07-14,929000,2009-11-05,999999,70999,1940,36.59742268041237
"20 WEST STREET, 44E",2007-02-16,390390,2015-05-28,501000,110610,3023,36.58948064836255
"199 BOWERY, 6E",2006-10-10,425880,2014-03-11,525000,99120,2709,36.58914728682171
"2000 BROADWAY, 7A",2005-12-20,530000,2011-02-18,599000,69000,1886,36.58536585365854
"15 WILLIAM STREET, 19C",2009-09-11,1080770,2014-12-15,1151000,70230,1921,36.559083810515354
"581 ACADEMY STREET, 4H",2005-04-22,150000,2012-01-18,240000,90000,2462,36.555645816409424
"230 RIVERSIDE DRIVE, 8G",2006-12-05,441090,2016-03-17,565000,123910,3390,36.551622418879056
"43 WEST 61ST STREET, 18J",2008-04-03,899000,2015-09-30,999000,100000,2736,36.54970760233918
"301 CATHEDRAL PARKWAY, 10C",2008-01-09,522000,2015-04-17,619000,97000,2655,36.534839924670436
"314 WEST 94TH STREET, 3A",2007-07-06,999925,2012-05-23,1065000,65075,1783,36.49747616376893
"300 RECTOR PLACE, 5T",2004-04-15,325000,2014-05-09,459000,134000,3676,36.452665941240475
"2 SOUTH END AVENUE, 6F",2004-02-09,325000,2013-11-15,455000,130000,3567,36.44519203812728
"350 WEST 42ND   STREET, 24J",2008-12-02,650000,2017-12-08,770000,120000,3293,36.440935317339815
"75 WALL STREET, 23F",2009-01-23,1237173,2014-07-17,1310000,72827,2001,36.39530234882559
"1600 BROADWAY, 11F",2006-06-20,753505,2014-06-25,860000,106495,2927,36.38366928595832
"80 JOHN STREET, 15D",2007-11-08,395460,2016-11-07,515000,119540,3287,36.36750836629145
"68 BRADHURST AVENUE, 8-B",2007-07-05,453222,2013-07-16,533000,79778,2203,36.213345438039035
"241 ELDRIDGE STREET, 6R",2005-08-11,860000,2013-03-08,960000,100000,2766,36.153289949385396
"425 EAST 13TH   STREET, 3H",2008-01-30,778961,2011-07-27,825000,46039,1274,36.137362637362635
"11 WEST 131 STREET, C3",2006-08-10,689050,2013-11-18,785000,95950,2657,36.1121565675574
"20 WEST STREET, 19K",2006-08-07,588753,2015-01-13,700000,111247,3081,36.10743265173645
"340 EAST 23RD STREET, 7K",2008-03-03,809508,2018-08-21,947500,137992,3823,36.09521318336385
"130 BEEKMAN STREET, 4C",2007-10-24,1095000,2017-04-18,1220000,125000,3464,36.08545034642032
"258 ST NICHOLAS AVENUE, 2C",2008-06-06,733140,2013-08-02,801000,67860,1883,36.03823685608072
"10 WEST END AVENUE, 8A",2007-08-09,1306109,2010-12-09,1350000,43891,1218,36.03530377668309
"68 BRADHURST AVENUE, 8-M",2008-03-11,768060,2014-06-02,850000,81940,2274,36.033421284080916
"20 WEST STREET, 15M",2007-06-25,570220,2015-06-12,675000,104780,2909,36.0192506015813
"45 PARK AVENUE, 1206",2007-12-04,1176078,2013-07-23,1250000,73922,2058,35.91933916423712
"224 EAST 60TH   STREET, 5A",2008-11-05,435000,2016-09-16,538078,103078,2872,35.89066852367688
"245 7 AVENUE, 3C",2003-06-03,725000,2009-02-23,800000,75000,2092,35.85086042065009
"77 PARK AVENUE, 11B",2008-07-16,935000,2018-06-22,1065000,130000,3628,35.83241455347299
"29 WEST 65TH   STREET, 6E",2008-09-09,499000,2014-11-21,580000,81000,2264,35.7773851590106
"300 CATHEDRAL PARKWAY, 4K",2008-04-29,467000,2015-10-30,565000,98000,2740,35.76642335766423
"120 GREENWICH STREET, 10A",2006-11-22,609931,2017-08-17,750000,140069,3921,35.72277480234634
"630 1 AVENUE, 22H",2004-06-28,535000,2009-06-22,600000,65000,1820,35.714285714285715
"40 SUTTON PLACE, 6A",2004-06-02,325000,2015-06-05,468300,143300,4020,35.646766169154226
"635 WEST 42ND   STREET, 26G",2008-07-25,852275,2014-07-16,930000,77725,2182,35.620989917506876
"75 WALL STREET, 33G",2009-10-30,997885,2015-10-06,1075000,77115,2167,35.586063682510385
"151 EAST 20 STREET, 2A",2004-03-02,325000,2015-11-03,476580,151580,4263,35.55711939948393
"327 CENTRAL PARK WEST, 3BB",2004-11-18,790000,2012-12-21,895000,105000,2955,35.53299492385787
"400 EAST 90TH STREET, 9E",2008-01-09,636406,2016-10-11,750000,113594,3198,35.520325203252035
"18 WEST 48TH   STREET, 20B",2007-06-27,1133517,2012-03-23,1195000,61483,1731,35.51877527440786
"1420 YORK AVENUE, 5M",2003-11-24,214350,2012-10-24,330000,115650,3257,35.5081363217685
"340 EAST 23RD STREET, 12K",2008-05-01,885877,2013-04-11,950000,64123,1806,35.50553709856035
"59 JOHN STREET, 8B",2007-06-27,911333,2018-07-27,1055000,143667,4048,35.49085968379447
"10 WEST END AVENUE, 19B",2007-08-08,1627799,2013-03-08,1700000,72201,2039,35.41000490436488
"120 GREENWICH STREET, PHD",2007-03-02,585493,2016-09-15,708800,123307,3485,35.382209469153516
"250 EAST 54TH   STREET, 30B",2008-09-10,1500000,2012-07-25,1550000,50000,1414,35.36067892503536
"75 WALL STREET, 27I",2009-01-07,575311,2014-06-05,645000,69689,1975,35.28556962025316
"11 EAST 36TH   STREET, 705",2007-08-01,1216808,2018-04-23,1355000,138192,3918,35.27105666156202
"801 RIVERSIDE DRIVE, 2C",2008-06-02,278850,2015-02-09,365000,86150,2443,35.264019647973804
"120 RIVERSIDE BOULEVARD, 3N",2006-05-05,1070000,2016-06-08,1200000,130000,3687,35.25901817195552
"312-320 WEST 23RD STREET, 2M",2006-08-15,390000,2008-06-26,414000,24000,681,35.242290748898675
"393 WEST 49TH STREET, 5LL",2007-02-08,949000,2008-09-26,970000,21000,596,35.23489932885906
"504 WEST 136 STREET, 4C",2006-10-27,385320,2016-07-05,510000,124680,3539,35.23029104266742
"20 WEST STREET, 43F",2007-03-02,403065,2014-04-29,495000,91935,2615,35.15678776290631
"321 EAST 48TH   STREET, 4K",2008-05-23,442000,2017-08-04,560066,118066,3360,35.138690476190476
"220 RIVERSIDE BOULEVARD, 14W",2006-04-26,630000,2015-04-14,745000,115000,3275,35.11450381679389
"220 RIVERSIDE BOULEVARD, 11A",2004-07-19,837000,2012-07-31,940000,103000,2934,35.10565780504431
"425 MAIN STREET, 6C",2007-06-21,538000,2008-07-01,551196,13196,376,35.09574468085106
"555 WEST 23RD STREET, S4N",2008-09-04,663000,2017-10-25,780000,117000,3338,35.050928699820254
"20 WEST STREET, 14F",2007-02-28,575311,2014-07-23,670000,94689,2702,35.0440414507772
"467 CENTRAL PARK WEST, 11A",2006-08-15,1374637,2012-07-06,1450000,75363,2152,35.0199814126394
"150 WEST 26TH STREET, 802",2004-07-15,1700000,2008-06-13,1750000,50000,1429,34.98950314905528
"310 WEST 52ND   STREET, 4G",2007-09-04,733140,2010-04-30,767000,33860,969,34.94324045407637
"92 LAIGHT STREET, 6B",2014-02-21,4350000,2018-01-24,4400000,50000,1433,34.89183531053733
"239 WEST 135 STREET, 2B",2011-10-18,351000,2013-06-11,372000,21000,602,34.883720930232556
"350 WEST 50TH STREET, 5PP",2008-01-07,945000,2011-07-21,990000,45000,1291,34.856700232378
"145 EAST 48TH STREET, 20G",2007-11-15,749000,2014-08-18,835000,86000,2468,34.84602917341977
"227 EAST 111 STREET, 4A",2005-03-21,268912,2013-02-01,369000,100088,2874,34.82533054975644
"300 RECTOR PLACE, 6M",2003-01-10,330000,2014-10-31,480000,150000,4312,34.78664192949907
"236 EAST 47TH STREET, 32C",2007-05-21,690000,2018-03-22,827500,137500,3958,34.73976755937342
"571 ACADEMY STREET, 3B",2006-05-15,265000,2017-11-16,411000,146000,4203,34.73709255293838
"210 EAST 47TH STREET, 4H",2015-09-18,770000,2016-11-23,785000,15000,432,34.72222222222222
"75 WALL STREET, 35G",2009-09-03,1323725,2017-08-30,1425000,101275,2918,34.70699108978753
"117 EAST 102ND STREET, 3A",2007-12-14,471754,2018-06-22,605000,133246,3843,34.67239136091595
"275 WEST 96TH   STREET, 5C",2008-01-30,665000,2014-05-27,745000,80000,2309,34.6470333477696
"200 WEST 109 STREET, B8",2003-02-10,270000,2012-03-15,385000,115000,3321,34.62812405901837
"415 EAST 37TH STREET, 29H",2005-08-04,690000,2015-06-23,815000,125000,3610,34.62603878116344
"220 MANHATTAN AVENUE, 1U",2006-09-29,602000,2014-07-31,701000,99000,2862,34.59119496855346
"235 WEST END AVENUE, 8A",2007-01-30,725000,2017-10-12,860000,135000,3908,34.54452405322416
"76 MADISON AVENUE, 3C",2007-04-17,967337,2012-08-29,1035000,67663,1961,34.504334523202445
"100 RIVERSIDE BOULEVARD, 11A",2008-05-06,1058980,2013-08-06,1125000,66020,1918,34.42127215849844
"43 WEST 61ST   STREET, 14B",2008-08-19,930000,2013-10-24,995000,65000,1892,34.35517970401691
"15 WILLIAM STREET, 22B",2009-01-09,1064071,2015-01-29,1140000,75929,2211,34.34147444595206
"635 WEST 42ND   STREET, 21H",2007-04-20,812563,2008-09-10,830000,17437,509,34.2573673870334
"15 BROAD STREET, 2402",2006-06-23,967337,2008-09-10,995000,27663,810,34.15185185185185
"311 GREENWICH STREET, 10B",2008-09-26,827056,2012-08-02,875000,47944,1406,34.099573257467995
"668 RIVERSIDE DRIVE, 2H",2010-04-20,197730,2018-07-12,300000,102270,3005,34.03327787021631
"230 RIVERSIDE DRIVE, 9L",2008-06-30,268000,2013-06-27,330000,62000,1823,34.009873834339004
"255 HUDSON STREET, 8A",2006-10-05,1985587,2011-07-19,2045000,59413,1748,33.98913043478261
"392 CENTRAL PARK WEST, 2N",2005-04-29,647000,2013-03-27,745000,98000,2889,33.92177223952925
"121 EDGECOMBE AVENUE, 1",2009-12-18,400530,2014-09-09,459000,58470,1726,33.87601390498262
"2101 BROADWAY, 9-161",2004-09-07,300000,2008-04-28,345000,45000,1329,33.86004514672686
"50 PINE STREET, 3N",2006-04-17,1142476,2013-05-16,1230000,87524,2586,33.84532095901005
"75 WALL STREET, 23B",2009-01-15,885877,2013-04-05,938000,52123,1541,33.82414016872161
"280 RECTOR PLACE, 7H",2007-07-24,449000,2015-12-10,552500,103500,3061,33.812479581836
"2056 FIFTH AVENUE, 6-A",2008-10-16,670000,2017-09-15,780000,110000,3256,33.78378378378378
"230 RIVERSIDE DRIVE, 12J",2007-06-05,456300,2014-08-13,545000,88700,2626,33.777608530083775
"150 NASSAU STREET, 9I",2003-03-26,212307,2012-02-16,322000,109693,3249,33.762080640196984
"414 WEST 54TH STREET, 3C",2005-06-23,625000,2013-12-30,730000,105000,3112,33.74035989717223
"20 WEST STREET, 39E",2007-01-22,446160,2013-06-17,525000,78840,2338,33.72112917023097
"630 FIRST AVENUE, 27F",2007-03-30,715000,2018-03-16,850000,135000,4004,33.71628371628372
"215 EAST 81ST   STREET, 6G",2009-09-24,701000,2015-10-02,775000,74000,2199,33.651659845384266
"20 WEST STREET, 16J",2007-06-20,655000,2017-08-22,780000,125000,3716,33.63832077502691
"200 RIVERSIDE BOULEVARD, 3G",2007-05-23,810000,2013-09-12,887500,77500,2304,33.63715277777778
"319 EAST 105 STREET, 2C",2004-08-25,250000,2017-04-26,405528,155528,4627,33.61314026366976
"400 EAST 90TH STREET, 2F",2007-12-05,738231,2016-08-17,845000,106769,3178,33.596286972938955
"120 RIVERSIDE BOULEVARD, 4H",2006-04-17,1040000,2014-01-16,1135000,95000,2831,33.557046979865774
"20 WEST STREET, 44D",2007-01-16,410670,2013-12-04,495000,84330,2514,33.54415274463007
"845 WEST END AVENUE, 14A",2011-12-09,3800000,2012-11-16,3811500,11500,343,33.52769679300292
"67 HUDSON STREET, 2C",2007-02-01,710000,2011-05-18,762500,52500,1567,33.503509891512444
"237 EAST 88TH STREET, 501",2007-08-20,380250,2010-06-25,415000,34750,1040,33.41346153846154
"635 WEST 42ND   STREET, 9A",2008-09-02,906242,2016-04-11,999000,92758,2778,33.39020878329734
"2019 1 AVENUE, 7C",2008-12-05,390390,2015-07-27,471350,80960,2425,33.38556701030928
"529 WEST 147 STREET, 6A",2006-01-11,484692,2014-04-04,585000,100308,3005,33.38036605657238
"350 EAST 82ND   STREET, 3L",2008-12-18,664714,2013-07-02,720000,55286,1657,33.36511768255884
"455 CENTRAL PARK WEST, 20B",2005-07-21,1807393,2013-12-23,1910000,102607,3077,33.34644133896653
"80 JOHN STREET, 14E",2007-07-24,1110554,2014-01-31,1190000,79446,2383,33.33864876206462
"220 RIVERSIDE BOULEVARD, 32C",2005-04-14,2099000,2017-09-08,2250000,151000,4530,33.333333333333336
"200 RECTOR PLACE, 33L",2005-09-01,585000,2015-07-13,705000,120000,3602,33.31482509716824
"2 SOUTH END AVENUE, 5U",2004-12-06,419000,2016-06-10,559000,140000,4204,33.30161750713606
"225 RECTOR PLACE, 6F",2008-07-29,575312,2014-04-22,645000,69688,2093,33.29574773053034
"7 WEST 131 STREET, A2",2006-05-04,288792,2014-08-18,389500,100708,3028,33.25891677675033
"99 BATTERY PLACE, 5-D",2003-09-04,795000,2010-09-03,880000,85000,2556,33.25508607198748
"1420 YORK AVENUE, 5D",2004-10-21,260000,2009-09-30,320000,60000,1805,33.2409972299169
"865 1 AVENUE, 13C",2008-01-07,991000,2018-03-29,1115000,124000,3734,33.208355650776646
"1800 ADAM C POWELL BLVD, 9C",2004-10-20,449000,2015-05-13,577000,128000,3857,33.18641431164117
"56 PINE STREET, 5C",2005-12-01,359970,2016-08-24,490000,130030,3919,33.179382495534576
"300 EAST 93RD STREET, 16F",2005-01-24,460550,2013-04-16,560000,99450,3004,33.10585885486019
"515 EAST 72ND STREET, 29A",2007-12-13,987702,2017-03-28,1100000,112298,3393,33.096964338343646
"300 RECTOR PLACE, 4E",2005-04-22,445000,2007-10-16,475000,30000,907,33.0760749724366
"255 EAST 74TH STREET, 22B",2009-01-06,4475208,2011-01-26,4500000,24792,750,33.056
"725 RIVERSIDE DRIVE, 4G",2007-08-16,174300,2013-06-26,245000,70700,2141,33.021952358710884
"255 HUDSON STREET, 3F",2006-09-21,890968,2012-06-15,960000,69032,2094,32.96657115568291
"100 RIVERSIDE BOULEVARD, 18E",2008-06-16,1496827,2012-11-15,1550000,53173,1613,32.96528208307502
"350 WEST 50TH STREET, 6R",2005-12-06,473486,2016-06-09,600000,126514,3838,32.96352266805628
"421 HUDSON STREET, 715",2006-06-05,930000,2012-03-01,999000,69000,2096,32.91984732824427
"10 WEST END AVENUE, 3F",2007-07-02,819691,2011-09-09,870000,50309,1530,32.88169934640523
"148 MADISON STREET, 3B",2003-08-06,281892,2016-10-07,440000,158108,4811,32.86385366867595
"2132 SECOND AVENUE, 2A",2006-11-22,448948,2016-12-28,570000,121052,3689,32.81431282190295
"148 EAST 24TH   STREET, 3E",2012-03-05,655000,2017-04-07,716000,61000,1859,32.8133405056482
"159 WEST 53RD   STREET, 20G",2007-05-07,620000,2014-01-14,700000,80000,2444,32.733224222585925
"200 CHAMBERS STREET, 7U",2007-04-10,906242,2013-06-11,980000,73758,2254,32.72315882874889
"400 EAST 67TH STREET, 22C",2012-12-27,2979500,2017-08-21,3035000,55500,1698,32.685512367491164
"5 EAST 22ND   STREET, 8-D",2007-04-05,1590000,2012-04-17,1650000,60000,1839,32.62642740619902
"225 FIFTH AVENUE, 2G",2008-05-12,1690295,2010-07-28,1716600,26305,807,32.59603469640644
"2 SOUTH END AVENUE, 7V",2007-03-02,440000,2015-06-26,539000,99000,3038,32.587228439763
"120 GREENWICH STREET, 5C",2007-03-01,750450,2018-04-05,882500,132050,4053,32.58080434246237
"635 WEST 42ND   STREET, 23A",2007-07-11,918970,2013-04-29,988000,69030,2119,32.576687116564415
"200 RIVERSIDE BOULEVARD, 307",2004-12-08,638000,2011-10-31,720000,82000,2518,32.56552819698173
"300 RECTOR PLACE, 4B",2004-05-27,370000,2009-11-13,435000,65000,1996,32.565130260521045
"120 GREENWICH STREET, 10B",2006-08-29,538654,2018-07-20,680000,141346,4343,32.54570573336403
"360 EAST 88TH STREET, 20C",2008-06-03,2100000,2015-12-31,2190000,90000,2767,32.526201662450305
"220 MANHATTAN AVENUE, 5F",2004-08-12,341000,2012-07-13,435000,94000,2892,32.50345781466113
"20 WEST STREET, 36D",2007-03-20,677136,2017-07-26,800000,122864,3781,32.49510711451997
"225 RECTOR PLACE, 8E",2008-07-30,575312,2015-04-27,655000,79688,2462,32.367181153533714
"301 CATHEDRAL PARKWAY, 7H",2004-11-30,630000,2013-12-20,737000,107000,3307,32.35560931357726
"145 EAST 48TH   STREET, 15G",2007-01-19,500000,2014-01-16,582500,82500,2554,32.30227094753328
"350 EAST 82ND   STREET, 4V",2007-05-01,1120075,2014-02-10,1200000,79925,2477,32.26685506661284
"300 ALBANY STREET, 3K",2005-06-02,330000,2014-08-07,438000,108000,3353,32.20996122875037
"300 ALBANY STREET, 4C",2003-05-21,250000,2010-08-11,335000,85000,2639,32.20917014020462
"75 ALLEN STREET, 6A",2005-04-07,168000,2013-04-10,262000,94000,2925,32.136752136752136
"21 SOUTH WILLIAM STREET, 3C",2008-09-15,565000,2018-01-29,675000,110000,3423,32.13555360794624
"200 WEST END AVENUE, 11K",2008-08-27,773360,2014-05-02,840000,66640,2074,32.131147540983605
"29 ADRIAN AVENUE, E6",2003-10-31,167000,2013-12-23,286000,119000,3706,32.11009174311926
"350 EAST 82ND   STREET, 5C",2008-06-12,712775,2017-03-03,815000,102225,3186,32.08568738229755
"2628 BROADWAY, 12B",2007-11-08,2445000,2012-07-20,2500000,55000,1716,32.05128205128205
"250 SOUTH END AVENUE, 5F",2005-11-15,346000,2016-01-19,465000,119000,3717,32.015065913371
"467 CENTRAL PARK WEST, 5C",2006-09-11,605858,2013-06-27,685000,79142,2481,31.899234179766225
"200 EAST 69TH   STREET, 8E",2007-08-22,520000,2017-01-31,630000,110000,3450,31.884057971014492
"372 CENTRAL PARK WEST, 1Y",2005-04-21,726000,2013-05-21,820000,94000,2952,31.84281842818428
"43 EAST 25TH   STREET, 20D",2005-10-27,795000,2013-02-21,880000,85000,2674,31.787584143605088
"350 WEST 50 STREET, 8D",2003-05-08,427500,2003-12-30,435000,7500,236,31.779661016949152
"80 JOHN STREET, 21B",2007-06-11,1179948,2014-05-05,1260000,80052,2520,31.766666666666666
"15 BROAD STREET, 3010",2006-08-22,1680112,2012-10-02,1751000,70888,2233,31.74563367666816
"350 WEST 42ND STREET, 9H",2006-06-21,463398,2010-09-01,512000,48602,1533,31.703848662752772
"425 FIFTH AVENUE, 44D",2004-08-04,1074253,2011-07-27,1155000,80747,2548,31.690345368916798
"101 WARREN STREET, 9E",2008-07-02,1659747,2013-09-16,1720000,60253,1902,31.67875920084122
"280 RECTOR PLACE, 7E",2005-01-11,350000,2014-07-17,460000,110000,3474,31.66378814047208
"164 PEARL STREET, 10G",2004-05-28,475000,2011-12-22,562500,87500,2764,31.65701881331404
"350 WEST 42ND STREET, 17C",2006-06-21,644552,2010-11-02,695000,50448,1595,31.62884012539185
"377 RECTOR PLACE, 11E",2004-07-09,429000,2013-09-12,535000,106000,3352,31.62291169451074
"60 EAST 55TH STREET, 22A",2006-08-04,1813758,2011-11-23,1875000,61242,1937,31.6169334021683
"200 CHAMBERS STREET, 6S",2007-04-03,860421,2013-09-18,935000,74579,2360,31.601271186440677
"825 WEST END AVENUE, 7-F",2005-06-08,999000,2010-09-21,1060000,61000,1931,31.589849818746764
"100 RIVERSIDE BOULEVARD, 20F",2008-09-24,2443800,2013-08-09,2500000,56200,1780,31.573033707865168
"303 GREENWICH STREET, 5C",2007-08-07,589000,2017-03-27,700000,111000,3520,31.53409090909091
"148 MADISON STREET, 9F",2003-07-30,328536,2016-09-28,480000,151464,4809,31.495945102932
"107 EAST 31ST STREET, 4B",2008-06-24,554946,2014-02-19,620000,65054,2066,31.487899322362054
"4260 BROADWAY, 506",2005-03-22,375000,2016-07-22,505000,130000,4140,31.40096618357488
"222 RIVERSIDE DRIVE, 9E",2007-12-06,999000,2016-09-26,1100000,101000,3217,31.395710289089212
"201 WEST 74TH STREET, 7B",2007-02-15,412500,2013-08-15,487000,74500,2373,31.39485882848715
"421 EAST 13TH   STREET, 1B",2008-01-28,496860,2013-08-02,560000,63140,2013,31.366120218579233
"310 WEST 52ND   STREET, 16J",2007-04-19,1160041,2010-10-15,1200000,39959,1275,31.340392156862745
"18 WEST 48TH   STREET, 22A",2007-06-26,1002365,2011-08-24,1050000,47635,1520,31.338815789473685
"310 EAST HOUSTON STREET, 3D",2007-07-05,544763,2014-01-30,620000,75237,2401,31.335693461057893
"20 WEST STREET, 30D",2006-08-29,697501,2013-09-26,778500,80999,2585,31.33423597678917
"90 WILLIAM STREET, 4F",2008-07-22,639461,2011-06-29,673000,33539,1072,31.286380597014926
"250 SOUTH END AVENUE, 4G",2004-07-07,359000,2013-06-27,461500,102500,3277,31.278608483368934
"15 BROAD STREET, 2828",2006-12-29,565128,2011-05-31,615566,50438,1614,31.250309789343248
"1600 BROADWAY, 7B",2006-05-17,1013158,2013-07-18,1095000,81842,2619,31.24933180603284
"20 WEST STREET, 30A",2006-05-31,570220,2015-08-06,675000,104780,3354,31.24031007751938
"635 WEST 42ND   STREET, 4E",2008-08-13,753505,2017-12-15,860000,106495,3411,31.221049545587803
"1420 YORK AVENUE, 6J",2007-04-05,375000,2017-05-10,490000,115000,3688,31.182212581344903
"1845 ADAM C POWELL BLVD, A5C",2011-01-26,1246269,2013-02-27,1270000,23731,763,31.102228047182177
"15 BROAD STREET, 3522",2007-06-19,1527375,2015-08-18,1620000,92625,2982,31.061368209255534
"10 WEST END AVENUE, 4E",2007-07-05,722957,2011-03-21,765000,42043,1355,31.028044280442803
"80 JOHN STREET, 8G",2007-06-21,918206,2013-10-21,990000,71794,2314,31.025929127052724
"310 WEST 52ND   STREET, 9H",2007-01-31,1134585,2011-02-04,1180000,45415,1465,31.0
"20 WEST STREET, 35E",2006-10-03,616041,2018-08-03,750000,133959,4322,30.99467838963443
"56 PINE STREET, 12F",2006-02-17,570220,2014-07-03,665000,94780,3058,30.994113799869197
"200 WEST END AVENUE, 10M",2008-04-14,962246,2011-07-15,999000,36754,1187,30.963774220724517
"220 RIVERSIDE BOULEVARD, 15C",2005-03-28,770000,2013-03-14,860000,90000,2908,30.949105914718018
"90 WILLIAM STREET, 15D",2008-07-25,764705,2017-03-20,862500,97795,3160,30.94778481012658
"120 GREENWICH STREET, 11G",2006-08-03,650661,2017-08-03,775000,124339,4018,30.945495271279242
"48 MARKET STREET, 5D",2007-10-31,405000,2015-10-22,495000,90000,2913,30.89598352214212
"460 EAST 79TH   STREET, 3D",2007-12-05,443080,2013-08-22,507500,64420,2087,30.8672735984667
"324 EAST 112 STREET, 7B",2006-05-24,735685,2016-07-14,850000,114315,3704,30.862580993520517
"20 WEST STREET, 12L",2006-07-20,446160,2013-04-30,522500,76340,2476,30.831987075928918
"635 WEST 42ND   STREET, 11B",2007-05-24,790723,2015-04-28,880000,89277,2896,30.827693370165747
"555 WEST 23RD STREET, N5L",2006-03-03,672045,2011-06-06,731250,59205,1921,30.81988547631442
"21 SOUTH WILLIAM STREET, 5A",2006-09-26,590585,2014-02-20,673800,83215,2704,30.774778106508876
"110 WEST 90TH STREET, 3J",2007-05-04,575000,2012-03-29,630000,55000,1791,30.709101060859854
"516 WEST 47TH STREET, S4K",2006-05-01,349830,2012-08-02,420000,70170,2285,30.708971553610503
"158 HESTER STREET, 4F",2006-08-21,840056,2012-07-25,906500,66444,2165,30.690069284064666
"230 RIVERSIDE DRIVE, 9M",2007-01-10,410670,2014-12-30,500000,89330,2911,30.68704912401237
"225 RECTOR PLACE, 16F",2008-04-22,795253,2018-07-23,910000,114747,3744,30.64823717948718
"212 EAST 47TH STREET, 30B",2008-04-04,842316,2017-11-17,950000,107684,3514,30.64428002276608
"303 GREENWICH STREET, 7E",2007-08-16,560000,2014-10-10,640000,80000,2612,30.627871362940276
"15 BROAD STREET, 1630",2006-12-18,991000,2011-10-17,1045000,54000,1764,30.612244897959183
"2 SOUTH END AVENUE, 7D",2014-07-07,525000,2018-07-17,570000,45000,1471,30.591434398368456
"100 WEST 58TH STREET, 7G",2007-06-26,1323725,2013-11-14,1395000,71275,2333,30.550792970424347
"160 WADSWORTH AVENUE, 403",2004-04-29,236000,2013-05-08,336666,100666,3296,30.541868932038835
"171 EAST 84TH STREET, 8E",2004-07-15,510000,2010-05-19,575000,65000,2134,30.459231490159326
"250 EAST 40TH STREET, 8D",2006-07-27,515000,2018-07-13,648000,133000,4369,30.44174868390936
"280 RECTOR PLACE, 3A",2007-05-21,394500,2013-07-03,462500,68000,2235,30.425055928411634
"801 RIVERSIDE DRIVE, 6E",2008-09-29,475000,2016-11-08,565000,90000,2962,30.38487508440243
"200 EAST 32ND STREET, 20E",2005-07-11,1100000,2013-03-12,1185000,85000,2801,30.346304891110318
"371 WEST 117 STREET, 2C",2008-08-14,829000,2017-08-24,929000,100000,3297,30.33060357901122
"275 GREENWICH STREET, 2MS",2008-11-26,750000,2012-12-19,795000,45000,1484,30.32345013477089
"250 SOUTH END AVENUE, 4F",2004-07-01,250000,2013-12-27,355000,105000,3466,30.294287362954414
"167 WEST 136TH STREET, 1",2005-07-27,342732,2015-05-22,451300,108568,3586,30.275515895147798
"56 PINE STREET, 8E",2005-11-21,334620,2013-08-12,420000,85380,2821,30.265863169088977
"130 BARROW STREET, 416",2008-05-08,1016000,2013-09-11,1075000,59000,1952,30.225409836065573
"20 WEST STREET, 22E",2006-06-15,466440,2012-09-05,535000,68560,2274,30.149516270888302
"455 CENTRAL PARK WEST, 18B",2005-02-28,1578287,2012-08-01,1660000,81713,2711,30.14127628181483
"90 WILLIAM STREET, 6H",2009-02-09,828855,2013-10-03,880000,51145,1697,30.138479670005893
"418 CENTRAL PARK WEST, 2",2006-01-26,900000,2011-01-27,955000,55000,1827,30.103995621237
"247 WEST 46TH   STREET, 2605",2008-11-17,1150622,2017-12-04,1250000,99378,3304,30.07808716707022
"225 EAST 34TH   STREET, 15H",2008-04-07,1654656,2012-05-24,1700000,45344,1508,30.06896551724138
"158 EAST 100 STREET, 2R",2008-07-25,385000,2018-08-03,495000,110000,3661,30.04643540016389
"571 ACADEMY STREET, 5A",2005-10-07,250000,2014-11-19,350000,100000,3330,30.03003003003003
"80 JOHN STREET, 2F",2007-08-17,925131,2013-12-30,995000,69869,2327,30.025354533734422
"20 WEST STREET, 16A",2007-04-23,385320,2013-08-30,455000,69680,2321,30.02154243860405
"41 WEST 72ND   STREET, 2A",2007-12-20,1251000,2017-01-04,1350000,99000,3303,29.97275204359673
"21 SOUTH END AVENUE, PH1V",2005-06-07,620000,2013-08-27,710000,90000,3003,29.97002997002997
"200 RECTOR PLACE, 15G",2008-03-17,690000,2014-08-20,760000,70000,2347,29.825308904985086
"350 WEST 42 STREET, 20J",2006-07-12,565128,2012-12-21,635000,69872,2354,29.682242990654206
"425 MAIN STREET, 5P",2007-05-31,717000,2008-08-11,730000,13000,438,29.680365296803654
"225 EAST 34TH STREET, 6C",2007-09-25,1288086,2013-06-14,1350000,61914,2089,29.638104356151267
"310 EAST HOUSTON STREET, 5C",2007-07-02,911333,2013-05-23,975000,63667,2152,29.58503717472119
"220 RIVERSIDE BOULEVARD, 3U",2004-12-09,685000,2010-11-12,749000,64000,2164,29.57486136783734
"200 RIVERSIDE BOULEVARD, 311",2006-06-26,800000,2010-08-27,845000,45000,1523,29.546946815495733
"641 5 AVENUE, 41F",2008-01-11,2025000,2010-05-07,2050000,25000,847,29.515938606847698
"40 BROAD STREET, 22F",2009-10-27,1135348,2015-10-28,1200000,64652,2192,29.494525547445257
"111 FULTON STREET, PH204",2008-12-22,1206626,2015-05-01,1275000,68374,2321,29.458853942266266
"400 EAST 90TH   STREET, 16A",2008-05-28,661862,2015-09-02,740000,78138,2653,29.452695062193744
"350 EAST 62ND   STREET, 1B",2008-06-04,465000,2016-10-17,555000,90000,3057,29.44062806673209
"75 WALL STREET, 36H",2009-08-30,1051456,2014-03-07,1100000,48544,1650,29.42060606060606
"75 WALL STREET, 25L",2009-01-05,656771,2016-10-07,740000,83229,2832,29.388771186440678
"214 EAST 52ND   STREET, 1B",2011-04-07,2450000,2015-12-04,2500000,50000,1702,29.37720329024677
"99 JANE STREET, 6A",2006-05-17,1825000,2012-03-14,1887500,62500,2128,29.3703007518797
"114 EAST 27TH STREET, PHB",2015-03-25,1272812,2017-10-06,1300000,27188,926,29.360691144708422
"350 EAST 82ND   STREET, 11A",2007-04-17,1909218,2013-06-06,1975000,65782,2242,29.34076717216771
"306 MOTT STREET, 4C",2005-05-12,334620,2009-08-06,380000,45380,1547,29.334195216548157
"299 WEST 12TH STREET, 16B",2015-05-14,1200000,2018-08-20,1235000,35000,1194,29.31323283082077
"170 WEST 23RD   STREET, 4P",2014-12-09,750000,2017-09-28,780000,30000,1024,29.296875
"1 WALL STREET COURT, 508",2008-01-29,465000,2017-06-05,565000,100000,3415,29.282576866764277
"21 SOUTH WILLIAM STREET, 3A",2006-06-07,671026,2016-03-03,775000,103974,3557,29.230812482429013
"635 WEST 42ND   STREET, 17L",2008-09-23,760632,2013-10-28,815000,54368,1861,29.21440085975282
"124 EAST 79TH STREET, 10A",2008-05-21,835000,2012-12-07,883500,48500,1661,29.199277543648403
"225 RECTOR PLACE, 8G",2008-07-23,605859,2015-07-08,680000,74141,2541,29.17788272333727
"56 PINE STREET, 8F",2005-10-25,491790,2015-12-21,600000,108210,3709,29.17497977891615
"18 ELDRIDGE STREET, 3A",2008-12-22,570000,2016-01-06,645000,75000,2571,29.171528588098017
"4260 BROADWAY, 304",2005-01-05,278000,2013-03-07,365000,87000,2983,29.165269862554474
"230 RIVERSIDE DRIVE, 10N",2007-04-09,738231,2012-08-07,795000,56769,1947,29.157164869029277
"230 RIVERSIDE DRIVE, 7B",2007-04-04,697501,2014-12-01,779000,81499,2798,29.12759113652609
"21 SOUTH END AVENUE, 435",2008-03-12,453000,2015-07-28,531400,78400,2694,29.101707498144023
"120 RIVERSIDE BOULEVARD, 6L",2006-01-31,1522283,2012-06-15,1590000,67717,2327,29.100558659217878
"120 GREENWICH STREET, 11E",2006-11-30,661862,2017-07-25,775000,113138,3890,29.084318766066836
"350 WEST 42ND STREET, 7I",2006-04-25,454139,2009-09-10,490000,35861,1234,29.060777957860616
"421 EAST 13TH   STREET, 3F",2008-01-22,753505,2014-07-23,822475,68970,2374,29.05223251895535
"166 EAST 63RD STREET, 7B",2006-05-05,525000,2014-05-09,610000,85000,2926,29.049897470950103
"225 5 AVENUE, 7F",2007-02-20,1692840,2012-07-11,1750000,57160,1968,29.04471544715447
"660 RIVERSIDE DRIVE, 3D",2008-05-22,304200,2018-05-18,410000,105800,3648,29.00219298245614
"280 RECTOR PLACE, 3K",2008-08-13,773000,2013-07-11,825000,52000,1793,29.001673173452314
"169 EAST 102ND STREET, 3C",2008-02-15,490000,2017-07-26,590000,100000,3449,28.993911278631487
"420 EAST 58TH STREET, 3C",2007-08-29,525000,2018-07-10,640000,115000,3968,28.981854838709676
"421 EAST 13TH   STREET, 1N",2008-02-19,774888,2012-11-15,825000,50112,1731,28.949740034662046
"120 RIVERSIDE BOULEVARD, 8M",2006-01-25,672045,2011-07-22,730000,57955,2004,28.919660678642714
"230 RIVERSIDE DRIVE, 10B",2007-03-30,705000,2014-04-01,779000,74000,2559,28.917545916373584
"340 EAST 23RD STREET, 11K",2008-03-13,870603,2017-07-07,969000,98397,3403,28.9147810755216
"225 WEST 83RD STREET, 22L",2004-10-26,735000,2007-08-31,765000,30000,1039,28.873917228103945
"80 JOHN STREET, 14A",2007-08-09,878240,2013-06-17,940000,61760,2139,28.87330528284245
"40 SUTTON PLACE, 7A",2004-06-30,350000,2010-03-11,410000,60000,2080,28.846153846153847
"252 WEST 74TH STREET, 4",2006-03-08,635000,2012-05-14,700000,65000,2259,28.77379371403276
"18 ELDRIDGE STREET, 6A",2008-11-26,554946,2017-12-13,650000,95054,3304,28.769370460048425
"342 EAST 110 STREET, 1D",2009-12-04,392000,2013-07-18,430000,38000,1322,28.744326777609682
"120 GREENWICH STREET, 12B",2007-04-20,572256,2017-05-16,678000,105744,3679,28.742593095949985
"140 EAST 56TH STREET, 16C",2007-01-12,635000,2012-03-08,689000,54000,1882,28.692879914984058
"201 WEST 72ND   STREET, 4G",2008-07-28,755000,2012-10-12,799000,44000,1537,28.62719583604424
"2 SOUTH END AVENUE, 4V",2005-06-08,400000,2014-10-29,498000,98000,3430,28.571428571428573
"350 EAST 82ND STREET, 3S",2007-11-28,539672,2013-09-12,600000,60328,2115,28.52387706855792
"300 ALBANY STREET, 4G",2005-05-25,385000,2015-06-24,490000,105000,3682,28.517110266159698
"2 SOUTH END AVENUE, 4U",2005-05-04,445000,2017-10-27,575000,130000,4559,28.515025224830005
"54 WEST 74TH STREET, 307",2006-08-30,680000,2008-06-27,699000,19000,667,28.48575712143928
"80 JOHN STREET, 20A",2007-06-15,1263037,2014-11-10,1340000,76963,2705,28.452125693160813
"120 GREENWICH STREET, 12H",2007-02-13,652000,2016-07-21,750000,98000,3446,28.438769587928032
"460 EAST 79TH   STREET, 6A",2007-06-26,1230000,2014-03-28,1300000,70000,2467,28.37454398054317
"106 CENTRAL PARK SOUTH, 12O",2005-03-23,400000,2012-06-18,475000,75000,2644,28.3661119515885
"39 EAST 29TH STREET, 15E",2008-11-13,768778,2014-04-21,825000,56222,1985,28.323425692695213
"343 EAST 30TH   STREET, 2-K",2008-07-16,745000,2017-03-30,835000,90000,3179,28.310789556464297
"350 WEST 50 STREET, 5MM",2006-08-01,430000,2018-07-31,554023,124023,4382,28.302829758101325
"2 SOUTH END AVENUE, 3P",2003-10-09,355000,2013-02-26,452000,97000,3428,28.296382730455075
"360 EAST 88TH STREET, 34A",2007-07-27,1950000,2014-10-30,2025000,75000,2652,28.28054298642534
"435 EAST 117 STREET, 4",2009-02-04,737213,2014-09-10,795000,57787,2044,28.271526418786692
"164 PEARL STREET, 2A",2004-09-14,410000,2011-06-30,480000,70000,2480,28.225806451612904
"421 EAST 13TH   STREET, PHB",2008-04-02,1069162,2013-09-03,1125000,55838,1980,28.2010101010101
"230 RIVERSIDE DRIVE, 16M",2006-12-11,298116,2012-06-20,355000,56884,2018,28.18830525272547
"504 WEST 136 STREET, 3C",2006-10-20,375180,2014-01-31,450000,74820,2660,28.127819548872182
"555 WEST 59TH STREET, 6C",2008-06-17,814600,2012-05-24,855000,40400,1437,28.114126652748784
"415 EAST 37TH   STREET, 6C",2007-09-19,750000,2017-04-07,848000,98000,3488,28.09633027522936
"516 WEST 47TH STREET, S1D",2006-03-22,346485,2011-06-15,400000,53515,1911,28.003663003663004
"2279 THIRD AVENUE, 3B",2007-12-27,455286,2018-03-26,560000,104714,3742,27.983431320149652
"230 RIVERSIDE DRIVE, 17B",2008-06-30,159000,2013-06-27,210000,51000,1823,27.97586396050466
"2 SOUTH END AVENUE, 5B",2004-11-12,623000,2009-12-16,675000,52000,1860,27.956989247311828
"15 WILLIAM STREET, 44B",2009-09-15,1275000,2016-01-27,1340000,65000,2325,27.956989247311828
"100 RIVERSIDE BOULEVARD, 8J",2008-04-10,1033523,2017-09-22,1130000,96477,3452,27.948146002317497
"510 WEST 110TH STREET, 3C",2007-08-09,612500,2016-09-06,705000,92500,3316,27.895054282267793
"236 EAST 47TH STREET, 10C",2006-03-30,850000,2013-02-11,920000,70000,2510,27.888446215139442
"90 WILLIAM STREET, 8H",2008-07-23,849220,2018-06-15,950000,100780,3614,27.885998893193136
"201 EAST 36TH STREET, 7C",2005-09-13,1225000,2015-07-10,1325000,100000,3587,27.878449958182326
"433 EAST 74TH STREET, 4B",2008-09-26,589567,2012-03-20,625000,35433,1271,27.878048780487806
"206 EAST 95TH STREET, 3A",2007-09-19,456300,2015-09-30,538000,81700,2933,27.85543811796795
"425 FIFTH AVENUE, 61A",2005-07-13,1390837,2016-04-08,1500000,109163,3922,27.83350331463539
"151 EAST 20 STREET, 2E",2004-01-26,246000,2010-05-14,310000,64000,2300,27.82608695652174
"220 RIVERSIDE BOULEVARD, 20C",2005-09-23,950000,2015-07-30,1050000,100000,3597,27.80094523213789
"230 RIVERSIDE DRIVE, 10M",2007-02-01,415740,2013-02-25,477200,61460,2216,27.73465703971119
"11 EAST 36TH   STREET, 401",2007-06-15,1929583,2013-06-03,1990000,60417,2180,27.714220183486237
"300 EAST 93RD   STREET, 14D",2007-09-11,452500,2018-04-27,560000,107500,3881,27.699046637464573
"372 CENTRAL PARK WEST, 1B",2006-01-10,640000,2010-12-21,690000,50000,1806,27.685492801771872
"225 5 AVENUE, 8F",2007-01-15,1713205,2012-08-29,1770000,56795,2053,27.664393570384803
"1630 MADISON AVENUE, 4B",2003-05-01,176436,2012-02-07,265000,88564,3204,27.641697877652934
"500 WEST 43RD STREET, 8C",2007-01-11,390000,2015-10-02,478000,88000,3186,27.620841180163215
"250 WEST 90TH STREET, 5I",2007-06-11,690000,2013-08-23,752500,62500,2265,27.59381898454746
"350 EAST 62ND   STREET, 2K",2007-03-27,440000,2017-02-28,540000,100000,3626,27.578599007170435
"211 EAST 46TH   STREET, 16G",2008-08-26,1083275,2017-04-07,1170000,86725,3146,27.566751430387793
"404 EAST 66TH STREET, 5F",2007-06-28,875000,2014-12-09,950000,75000,2721,27.563395810363836
"350 WEST 42ND STREET, 16H",2006-06-30,505986,2010-11-15,550000,44014,1599,27.525953721075673
"581 ACADEMY STREET, 4E",2005-12-13,315000,2015-06-04,410000,95000,3460,27.45664739884393
"120 GREENWICH STREET, 4C",2006-10-13,733140,2014-06-18,810000,76860,2805,27.40106951871658
"80 JOHN STREET, 8D",2007-01-24,515539,2011-04-06,557500,41961,1533,27.371819960861057
"425 FIFTH AVENUE, 40C",2005-12-19,1064071,2009-07-24,1100000,35929,1313,27.364051789794363
"450 EAST 83RD   STREET, 11E",2007-10-31,2150000,2015-11-06,2230000,80000,2928,27.3224043715847
"635 WEST 42ND STREET, 10L",2007-06-08,740267,2013-12-04,805000,64733,2371,27.301982285955294
"1965 BROADWAY, 20F",2008-08-28,1425000,2017-09-08,1515000,90000,3298,27.289266221952698
"157 EAST 72ND   STREET, 10C",2007-11-08,3200000,2015-11-18,3280000,80000,2932,27.285129604365622
"305 EAST 108 STREET, 5H",2004-04-05,395460,2009-09-25,450000,54540,1999,27.283641820910454
"215 EAST 80TH STREET, 3E",2004-09-10,675000,2012-03-22,750000,75000,2750,27.272727272727273
"200 RECTOR PLACE, 27K",2007-01-26,555000,2013-08-07,620000,65000,2385,27.253668763102727
"571 ACADEMY STREET, 3C",2003-09-12,112000,2017-07-27,250000,138000,5067,27.23505032563647
"540 WEST 28TH STREET, 8F",2014-08-26,1250000,2017-03-01,1275000,25000,918,27.233115468409586
"237 EAST 88TH STREET, 104",2007-08-23,309270,2017-10-12,410000,100730,3703,27.20226843100189
"100 11TH   AVENUE, 5B",2010-06-07,2418343,2016-02-19,2475000,56657,2083,27.199711953912626
"21 SOUTH END AVENUE, 533",2004-09-28,340000,2016-10-27,460000,120000,4412,27.198549410698096
"300 ALBANY STREET, 9B",2004-10-21,285000,2013-01-25,367000,82000,3018,27.170311464546057
"467 CENTRAL PARK WEST, 3E",2006-05-31,545000,2010-10-01,588000,43000,1584,27.146464646464647
"200 RECTOR PLACE, 20M",2005-10-06,460000,2013-10-31,540000,80000,2947,27.14625042416016
"301 CATHEDRAL PARKWAY, 8V",2005-01-14,375000,2013-07-15,459000,84000,3104,27.061855670103093
"12 WEST 18TH STREET, 4W",2015-12-08,2800000,2018-06-22,2825000,25000,927,26.968716289104638
"20 WEST STREET, 16G",2007-05-25,707683,2015-04-03,785000,77317,2870,26.9397212543554
"150 NASSAU STREET, 7A",2005-07-07,640000,2007-07-20,660000,20000,743,26.917900403768506
"250 SOUTH END AVENUE, 11F",2003-10-30,257000,2015-05-05,370000,113000,4205,26.872770511296075
"25 WEST HOUSTON STREET, 3E",2015-01-30,1640000,2018-08-29,1675000,35000,1307,26.778882938026015
"250 EAST 54TH   STREET, 25B",2011-08-01,495000,2017-03-21,550000,55000,2059,26.711996114618746
"350 EAST 82ND STREET, 5B",2006-09-28,697501,2014-09-08,775000,77499,2902,26.70537560303239
"408 EAST 79TH STREET, 3D",2005-12-06,901151,2015-11-11,998000,96849,3627,26.70223325062035
"2000 BROADWAY, 4C",2005-09-01,850000,2014-11-26,940000,90000,3373,26.682478505781205
"235 EAST 40TH STREET, 29G",2005-08-03,750000,2013-04-15,825000,75000,2812,26.67140825035562
"57 READE STREET, 20A",2012-08-14,1946000,2013-01-11,1950000,4000,150,26.666666666666668
"230 RIVERSIDE DRIVE, 12M",2006-11-30,420810,2012-12-28,480000,59190,2220,26.66216216216216
"10 WEST END AVENUE, 21B",2007-09-05,1713066,2011-06-24,1750000,36934,1388,26.60951008645533
"352 WEST 117 STREET, 5G",2006-09-28,545000,2012-11-30,605000,60000,2255,26.607538802660756
"15 BROAD STREET, 3000",2006-08-31,2392887,2017-09-12,2500000,107113,4030,26.578908188585608
"9 WEST 131 STREET, B2",2006-05-18,281030,2014-06-02,359000,77970,2937,26.54749744637385
"15 WILLIAM STREET, 27C",2008-12-15,1125166,2014-08-12,1180000,54834,2066,26.54114230396902
"2250 BROADWAY, 5P",2005-05-19,495000,2006-09-21,508000,13000,490,26.53061224489796
"2000 BROADWAY, 6K",2007-03-05,648000,2013-07-29,710000,62000,2338,26.518391787852867
"220 WEST 111 STREET, 1D",2008-01-17,474045,2014-05-05,535000,60955,2300,26.502173913043478
"200 RECTOR PLACE, 11J",2005-02-02,505000,2013-10-09,589000,84000,3171,26.490066225165563
"1 IRVING PLACE, G11D",2007-02-01,800000,2011-10-19,845500,45500,1721,26.43811737361999
"516 WEST 47TH STREET, N2A",2007-06-28,870000,2014-08-21,939000,69000,2611,26.426656453466105
"123 WEST 131ST STREET, 7",2012-04-02,325000,2013-03-29,334500,9500,361,26.31578947368421
"206 EAST 95TH STREET, 4A",2007-09-24,466440,2014-05-06,530000,63560,2416,26.307947019867548
"630 1 AVENUE, 35L",2007-09-26,3195000,2013-06-17,3250000,55000,2091,26.303204208512675
"1641 THIRD AVENUE, 6B",2008-01-31,496000,2017-05-08,585000,89000,3385,26.292466765140325
"2 SOUTH END AVENUE, 8A",2008-02-04,665000,2017-01-18,751000,86000,3271,26.291653928462242
"311 EAST 38TH STREET, 4F",2004-12-15,565000,2011-03-23,625000,60000,2289,26.212319790301443
"555 WEST 59TH STREET, 8C",2008-08-13,834965,2013-04-29,880000,45035,1720,26.183139534883722
"15 BROAD STREET, 3322",2007-01-26,1252447,2010-06-23,1285000,32553,1244,26.168006430868168
"20 WEST STREET, 29F",2007-03-01,456300,2018-07-19,565000,108700,4158,26.142376142376143
"129 WEST 20TH STREET, 5A",2007-04-17,1610000,2011-03-22,1647500,37500,1435,26.13240418118467
"20 WEST STREET, 14K",2006-10-27,496860,2014-05-22,569000,72140,2764,26.099855282199712
"610 WEST 110TH STREET, 4A",2008-09-16,1532466,2012-04-18,1566550,34084,1310,26.018320610687024
"212 EAST 57TH STREET, 23A",2008-01-24,3050000,2013-04-30,3100000,50000,1923,26.001040041601666
"158 EAST 100 STREET, 3F",2007-04-19,415740,2015-02-17,490000,74260,2861,25.955959454736107
"690 RIVERSIDE DRIVE, 5E",2008-05-28,560037,2014-09-25,620000,59963,2311,25.946776287321505
"164 PEARL STREET, 2H",2004-10-04,328000,2014-06-20,420000,92000,3546,25.944726452340664
"35 EAST 38TH STREET, 9E",2006-12-15,540000,2014-07-23,612000,72000,2777,25.927259632697155
"82 BEAVER STREET, 409",2006-09-26,809508,2018-08-16,922000,112492,4342,25.90787655458314
"571 ACADEMY STREET, 4E",2007-05-21,302500,2017-12-01,402000,99500,3847,25.864309851832598
"80 RIVERSIDE BOULEVARD, 16A",2010-11-08,1298268,2012-08-16,1315000,16732,647,25.860896445131374
"1420 YORK AVENUE, 6O",2004-07-13,285000,2009-11-02,335000,50000,1938,25.799793601651185
"75 WALL STREET, 30Q",2012-02-28,712775,2018-03-29,770000,57225,2221,25.765420981539847
"212 EAST 95TH STREET, 4C",2008-10-01,819691,2013-07-26,865000,45309,1759,25.758385446276293
"75 WALL STREET, 33P",2009-05-12,1486645,2016-02-11,1550000,63355,2466,25.691403081914032
"30 WEST 90TH   STREET, 5C",2008-01-04,661862,2017-07-26,751500,89638,3491,25.676883414494416
"635 WEST 42ND STREET, 15C",2007-08-23,827940,2015-05-01,900000,72060,2808,25.662393162393162
"167 WEST 136TH STREET, 8",2005-08-08,364533,2009-03-06,398000,33467,1306,25.625574272588054
"56 PINE STREET, 12C",2005-10-06,380250,2018-06-15,499000,118750,4635,25.620280474649405
"15 BROAD STREET, 2206",2006-07-20,941881,2010-08-16,980000,38119,1488,25.61760752688172
"144 WEST 27TH STREET, 2F",2006-12-04,2440000,2010-09-03,2475000,35000,1369,25.566106647187727
"635 WEST 42ND STREET, 41H",2007-07-24,1079345,2018-05-11,1180000,100655,3944,25.52104462474645
"640 WEST END AVENUE, 1C",2005-11-28,499000,2010-04-23,540000,41000,1607,25.51337896701929
"1760 2 AVENUE, 5E",2003-08-14,400000,2016-07-01,520000,120000,4705,25.5047821466525
"350 WEST 42ND   STREET, 17G",2007-01-18,1155000,2012-06-04,1205000,50000,1964,25.45824847250509
"20 WEST STREET, 17M",2007-03-28,600000,2015-08-20,678000,78000,3067,25.432018258884902
"106 CENTRAL PARK SOUTH, 20K",2004-11-29,405000,2010-11-01,460000,55000,2163,25.42764678687009
"157 EAST 32ND   STREET, 3C",2008-06-06,399000,2012-11-06,440000,41000,1614,25.40272614622057
"421 HUDSON STREET, 709",2005-02-04,1600000,2009-05-29,1640000,40000,1575,25.396825396825395
"1420 YORK AVENUE, 5E",2008-06-26,392500,2016-04-20,465000,72500,2855,25.394045534150614
"425 MAIN STREET, 11G",2007-07-16,592000,2013-11-07,650550,58550,2306,25.39028620988725
"254 PARK AVENUE SOUTH, 6M",2010-02-10,716023,2016-10-18,778000,61977,2442,25.37960687960688
"1619 3 AVENUE, 13H",2003-02-20,412395,2007-03-13,450000,37605,1482,25.374493927125506
"350 EAST 62ND STREET, 1M",2005-01-06,355000,2018-07-05,480000,125000,4928,25.36525974025974
"1600 BROADWAY, 6E",2006-06-19,840056,2018-05-04,950000,109944,4337,25.350242102836063
"123 WASHINGTON STREET, 36G",2011-12-15,1221900,2015-09-10,1256500,34600,1365,25.347985347985347
"56 PINE STREET, 4A",2006-01-24,539672,2010-06-03,580000,40328,1591,25.347580138277813
"20 WEST STREET, 17A",2007-04-25,390390,2017-02-24,481274,90884,3593,25.29473977177846
"212 EAST 47TH STREET, 10F",2014-10-10,1425000,2018-07-25,1460000,35000,1384,25.289017341040463
"330 EAST 49TH STREET, 11C",2005-06-03,439000,2018-07-16,560000,121000,4791,25.255687747860573
"100 WEST 58 STREET, 14A",2006-04-18,753759,2016-09-23,850000,96241,3811,25.253476777748624
"350 WEST 14TH   STREET, 2F",2007-12-26,695000,2013-12-12,750000,55000,2178,25.252525252525253
"65 COOPER SQUARE, 3H",2006-01-10,895000,2013-12-10,968000,73000,2891,25.25077827741266
"350 WEST 50TH STREET, 3RR",2006-10-17,485000,2017-11-09,587000,102000,4041,25.241276911655532
"350 WEST 50TH   STREET, 2FF",2007-11-08,490000,2014-05-14,550000,60000,2379,25.220680958385877
"80 RIVERSIDE BOULEVARD, 16D",2009-10-13,952063,2013-11-26,990000,37937,1505,25.207308970099668
"300 WEST 135TH STREET, 9E",2005-07-01,280365,2014-02-25,360000,79635,3161,25.192976906042393
"455 MAIN STREET, 14D",2007-06-18,650000,2014-11-11,718000,68000,2703,25.157232704402517
"13 EAST 131 STREET, 2B",2004-04-29,313833,2014-04-02,405000,91167,3625,25.14951724137931
"517 WEST 46, 604",2008-01-03,666953,2013-03-28,715000,48047,1911,25.142333856619572
"111 FULTON STREET, 620",2008-12-16,651680,2018-03-07,736000,84320,3368,25.03562945368171
"404 EAST 66TH STREET, 11A",2008-10-07,765000,2018-08-17,855000,90000,3601,24.993057484032214
"524 EAST 72ND STREET, 26H",2005-10-19,390000,2017-04-21,495000,105000,4202,24.988100904331272
"467 CENTRAL PARK WEST, 5F",2006-11-21,535000,2013-11-27,599000,64000,2563,24.97073741708935
"635 WEST 42ND   STREET, 5L",2008-05-30,768778,2017-05-05,850000,81222,3262,24.899448191293686
"160 CENTRAL PARK SOUTH, 903",2008-06-23,2318062,2017-06-29,2400000,81938,3293,24.88247798360158
"50 EAST 129 STREET, 1B",2008-04-04,385320,2013-09-23,435000,49680,1998,24.864864864864863
"350 WEST 42ND STREET, 16D",2006-06-20,683245,2009-06-03,710000,26755,1079,24.79610750695088
"635 WEST 42ND   STREET, 10K",2008-05-30,702592,2017-07-10,785000,82408,3328,24.76201923076923
"20 WEST STREET, 17J",2007-05-18,630000,2014-01-08,690000,60000,2427,24.721878862793574
"18 WEST 48TH STREET, 27D",2007-06-28,1072624,2013-04-18,1125000,52376,2121,24.694012258368694
"150 NASSAU STREET, 7F",2005-11-29,710000,2014-07-28,788000,78000,3163,24.660132785330383
"30 EAST 37TH STREET, 6G",2008-09-25,490000,2013-09-24,535000,45000,1825,24.65753424657534
"655 SIXTH AVENUE, 3L",2007-01-03,1211717,2012-04-24,1259496,47779,1938,24.65376676986584
"120 GREENWICH STREET, 10D",2006-10-24,659316,2010-10-13,695000,35684,1450,24.60965517241379
"306 MOTT STREET, 4B",2005-11-16,395460,2011-12-13,450000,54540,2218,24.589720468890892
"779 RIVERSIDE DRIVE, B-55",2008-10-27,420810,2015-06-01,480000,59190,2408,24.580564784053156
"220 EAST 65TH STREET, 14J",2008-02-21,865000,2017-08-14,950000,85000,3462,24.552281917966493
"11 EAST 29TH STREET, 24B",2010-04-28,955000,2011-12-30,970000,15000,611,24.549918166939445
"525 EAST 11TH STREET, 4C",2006-10-31,915000,2013-07-12,975000,60000,2446,24.529844644317254
"350 WEST 50TH STREET, 5B",2006-04-11,1369546,2012-06-19,1425000,55454,2261,24.526315789473685
"71 NASSAU STREET, 15A",2006-08-01,1282995,2013-11-06,1348000,65005,2654,24.49321778447626
"350 WEST 14TH STREET, 4B",2005-08-01,545000,2011-03-07,595000,50000,2044,24.461839530332682
"309 EAST 49TH   STREET, 5C",2007-02-13,730000,2013-04-12,785000,55000,2250,24.444444444444443
"310 EAST 53RD   STREET, 4/5D",2007-05-15,1950000,2012-12-21,2000000,50000,2047,24.42598925256473
"635 WEST 42ND   STREET, 11J",2008-06-16,682227,2016-01-21,750000,67773,2775,24.422702702702704
"60 RIVERSIDE BOULEVARD, 1401",2013-03-13,4401840,2018-08-06,4450000,48160,1972,24.421906693711968
"303 GREENWICH STREET, 8F",2006-04-11,440000,2011-04-28,485000,45000,1843,24.416711882799785
"455 MAIN STREET, 16L",2006-05-03,451230,2014-12-16,528000,76770,3149,24.379167989838045
"120 GREENWICH STREET, 10H",2006-12-08,661862,2015-08-10,739000,77138,3167,24.3568045468898
"400 CENTRAL PARK WEST, 6S",2006-01-17,485000,2013-12-02,555000,70000,2876,24.339360222531294
"30 WEST 61ST   STREET, 26D",2007-11-29,1530000,2012-12-24,1575000,45000,1852,24.29805615550756
"392 CENTRAL PARK WEST, 1V",2015-09-29,975000,2018-07-24,999999,24999,1029,24.294460641399418
"382 CENTRAL PARK WEST, 14U",2006-09-25,470000,2011-10-27,515000,45000,1858,24.219590958019374
"99 JOHN STREET, 202",2008-12-29,575311,2012-10-01,608500,33189,1372,24.190233236151602
"80 JOHN STREET, 4A",2007-02-14,562074,2013-09-05,620000,57926,2395,24.186221294363257
"450 EAST 83RD   STREET, 2C",2007-05-10,997885,2015-07-10,1070000,72115,2983,24.175326852162254
"200 CHAMBERS STREET, 2J",2007-02-15,834965,2011-10-13,876000,41035,1701,24.124044679600235
"201 WEST 72ND   STREET, 5I",2008-01-18,550000,2013-02-27,595000,45000,1867,24.1028387787895
"404 EAST 66TH STREET, 2N",2005-07-06,612500,2015-05-04,699000,86500,3589,24.101421008637505
"350 EAST 82ND STREET, 8G",2006-10-27,1017231,2011-11-28,1062000,44769,1858,24.095263724434876
"225 EAST 34TH STREET, 5A",2007-09-28,636406,2014-05-30,695000,58594,2436,24.053366174055828
"75 WALL STREET, 28K",2009-03-20,916425,2012-06-20,945000,28575,1188,24.053030303030305
"455 EAST 86TH STREET, 10C",2005-05-19,815000,2013-07-30,887000,72000,2994,24.04809619238477
"715 PARK AVENUE, 9E",2004-10-20,800000,2016-03-15,900000,100000,4164,24.015369836695484
"80 JOHN STREET, 14C",2007-05-17,582540,2015-08-24,655000,72460,3021,23.98543528632903
"68 BRADHURST AVENUE, 4-H",2007-08-20,696776,2013-08-15,749000,52224,2187,23.87928669410151
"295 GREENWICH STREET, 2AN",2005-06-01,1295000,2011-02-25,1345000,50000,2095,23.86634844868735
"120 GREENWICH STREET, 10F",2007-03-13,752486,2017-11-07,845000,92514,3892,23.770298047276466
"111 WEST 67TH   STREET, 29-F",2008-03-06,2700000,2016-10-28,2775000,75000,3158,23.749208359721344
"20 WEST STREET, 44F",2006-12-29,423345,2014-09-05,490000,66655,2807,23.745992162451014
"120 RIVERSIDE BOULEVARD, 12C",2006-01-30,585493,2013-07-10,650000,64507,2718,23.733259749816042
"161 WEST 61ST STREET, 32H",2007-10-23,1100000,2013-07-30,1150000,50000,2107,23.730422401518748
"10 WEST END AVENUE, 4G",2007-06-28,794235,2012-10-10,840000,45765,1931,23.70015535991714
"450 WEST 17TH   STREET, 1905",2008-12-02,1298268,2014-11-25,1350000,51732,2184,23.686813186813186
"1600 BROADWAY, 19A",2006-08-29,875695,2012-05-14,925000,49305,2085,23.64748201438849
"2056 FIFTH AVENUE, 6-C",2008-07-02,456300,2016-06-24,525000,68700,2914,23.575840768702815
"230 RIVERSIDE DRIVE, 18C",2007-05-10,501930,2013-08-20,556000,54070,2294,23.57018308631212
"225 EAST 34TH   STREET, 14A",2008-08-14,620000,2013-04-09,660000,40000,1699,23.543260741612713
"254 PARK AVENUE SOUTH, 2PR",2014-05-01,1615000,2018-05-29,1650000,35000,1489,23.50570852921424
"206 EAST 95TH STREET, 4B",2007-09-17,403572,2014-08-20,463000,59428,2529,23.498616053776196
"124 WEST 24TH STREET, 3C",2007-11-01,1266000,2011-10-19,1300000,34000,1448,23.480662983425415
"80 JOHN STREET, 12G",2007-06-13,534581,2017-09-14,622500,87919,3746,23.47010144153764
"56 PINE STREET, 14C",2005-10-27,390390,2014-05-30,464000,73610,3137,23.46509403889066
"20 WEST STREET, 38A",2007-01-30,463144,2016-11-17,546805,83661,3579,23.375523889354568
"170 EAST 77TH STREET, 7C",2007-10-23,1451006,2010-12-02,1477500,26494,1136,23.322183098591548
"350 EAST 82ND STREET, 8B",2007-08-27,789143,2017-02-22,870000,80857,3467,23.321892125757138
"207 EAST 57TH   STREET, 25A",2006-12-27,2350000,2011-06-17,2388000,38000,1633,23.270055113288425
"100 UNITED NATIONS PLAZA, 20C",2004-09-29,690000,2010-08-19,740000,50000,2150,23.25581395348837
"736 WEST 187 STREET, 501",2005-11-15,764705,2014-10-03,840000,75295,3244,23.210542540073984
"56 PINE STREET, 9C",2005-12-01,314340,2012-06-29,370000,55660,2402,23.172356369691922
"340 CABRINI BOULEVARD, 1",2004-09-10,288990,2014-11-11,375000,86010,3714,23.15831987075929
"160 EAST 22ND   STREET, 8B",2014-09-29,1495799,2018-03-13,1525000,29201,1261,23.157018239492466
"225 RECTOR PLACE, 18E",2008-04-10,840056,2018-04-30,925000,84944,3672,23.132897603485837
"300 CATHEDRAL PARKWAY, 18G",2005-08-29,515000,2016-10-14,609000,94000,4064,23.12992125984252
"377 RECTOR PLACE, 4M",2006-01-20,625000,2013-10-04,690000,65000,2814,23.098791755508174
"415 EAST 54TH STREET, 11C",2007-03-14,1295000,2013-09-20,1350000,55000,2382,23.089840470193113
"1 IRVING PLACE, P15C",2006-11-23,847500,2012-07-12,895000,47500,2058,23.080660835762878
"280 RECTOR PLACE, 4B",2004-08-23,379000,2013-08-29,455000,76000,3293,23.079259034315214
"736 WEST 187TH STREET, 603",2005-11-07,756559,2015-02-27,835000,78441,3399,23.07766990291262
"350 WEST 50TH STREET, 29A",2008-06-02,544000,2015-01-26,600000,56000,2429,23.054755043227665
"148 MADISON STREET, 5A",2004-01-05,236262,2011-08-03,300000,63738,2767,23.03505601734731
"148 MADISON STREET, 9E",2003-06-23,447551,2009-09-16,500000,52449,2277,23.034255599472992
"350 WEST 57TH   STREET, 3J",2015-02-26,1255000,2017-07-14,1275000,20000,869,23.014959723820482
"117 EAST 29TH STREET, 5B",2007-08-28,1311506,2009-11-09,1330000,18494,804,23.002487562189053
"333 EAST 45TH STREET, 21B",2005-07-29,659000,2018-07-20,768000,109000,4739,23.00063304494619
"340 CABRINI BOULEVARD, 401",2005-03-31,543000,2013-07-31,612999,69999,3044,22.995729303547964
"350 EAST 82ND STREET, 9B",2006-09-28,743322,2015-04-13,815000,71678,3119,22.98108368066688
"211 EAST 46TH   STREET, 6H",2008-04-29,623169,2011-07-13,650000,26831,1170,22.93247863247863
"2132 SECOND AVENUE, 2B",2006-10-27,605858,2016-04-20,685000,79142,3463,22.853595148714987
"220 RIVERSIDE BOULEVARD, 14B",2007-11-20,931125,2012-07-12,969845,38720,1696,22.830188679245282
"220 RIVERSIDE BOULEVARD, 17A",2004-07-09,835000,2012-04-27,900000,65000,2849,22.815022815022814
"200 EAST 58TH   STREET, 17D",2008-02-27,845000,2015-12-23,910000,65000,2856,22.759103641456583
"303 WEST 149 STREET, 5F",2011-04-05,285000,2014-04-10,310000,25000,1101,22.70663033605813
"255 CABRINI BOULEVARD, 7K",2003-01-09,345000,2010-11-12,410000,65000,2864,22.695530726256983
"111 FULTON STREET, 720",2008-11-25,638951,2018-02-01,715000,76049,3355,22.66736214605067
"161 WEST 61ST STREET, 10D",2008-04-14,517000,2017-02-14,590000,73000,3228,22.614622057001238
"60 EAST 55TH STREET, 16A",2006-03-27,1374637,2012-05-02,1425000,50363,2228,22.604578096947936
"20 WEST STREET, 33A",2006-10-27,533000,2014-05-07,595000,62000,2749,22.553655874863587
"20 WEST STREET, 39D",2006-12-08,436020,2009-11-06,460000,23980,1064,22.537593984962406
"300 ALBANY STREET, 5O",2005-05-13,295000,2015-09-10,380000,85000,3772,22.534464475079535
"146 WEST 57TH STREET, 63E",2005-11-02,995000,2018-07-20,1099625,104625,4643,22.53392203316821
"235 WEST END AVENUE, 10E",2006-09-19,790162,2015-11-04,865000,74838,3333,22.453645364536452
"871 8 AVENUE, 4D",2007-08-17,727000,2013-07-02,775000,48000,2146,22.367194780987884
"311 EAST 38TH STREET, 16C",2006-03-31,530000,2009-12-02,560000,30000,1342,22.35469448584203
"350 WEST 42ND STREET, 27K",2006-08-14,794235,2011-08-12,835000,40765,1824,22.34923245614035
"333 EAST 30TH   STREET, 1-D",2007-08-28,471000,2017-03-29,549000,78000,3501,22.279348757497857
"455 CENTRAL PARK WEST, 1",2006-10-11,544763,2016-08-25,625000,80237,3606,22.250970604547977
"635 WEST 42ND   STREET, 4A",2007-05-16,840056,2014-10-02,900000,59944,2696,22.234421364985163
"56 PINE STREET, 14D",2005-10-26,580402,2013-10-14,645000,64598,2910,22.198625429553264
"421 EAST 13TH   STREET, 1E",2008-02-01,748413,2014-10-07,802500,54087,2440,22.166803278688526
"100 CENTRAL PARK SOUTH, 5G",2006-11-27,630000,2014-04-28,690000,60000,2709,22.148394241417495
"258 ST NICHOLAS AVENUE, 7E",2008-05-14,557301,2013-01-11,595000,37699,1703,22.13681738109219
"255 HUDSON STREET, 6G",2006-10-10,1191352,2011-07-26,1230000,38648,1750,22.08457142857143
"571 ACADEMY STREET, 2E",2004-04-07,110000,2014-10-30,195000,85000,3858,22.032141005702435
"325 FIFTH AVENUE, 39F",2007-02-13,1802302,2010-09-08,1831000,28698,1303,22.02455871066769
"130 FULTON STREET, 12A",2006-07-19,1624108,2012-04-12,1670000,45892,2094,21.915950334288443
"15 WILLIAM STREET, 38D",2009-10-20,880000,2018-07-25,950000,70000,3200,21.875
"340 CABRINI BOULEVARD, 503",2004-07-27,745868,2010-09-21,795000,49132,2247,21.86559857587895
"635 WEST 42ND   STREET, 6E",2008-11-05,789143,2013-05-06,825000,35857,1643,21.82410225197809
"635 WEST 42ND   STREET, 3C",2008-11-26,743322,2016-01-07,800000,56678,2598,21.81601231716705
"400 EAST 70TH STREET, 901",2006-07-26,840000,2018-01-29,931500,91500,4205,21.759809750297265
"120 GREENWICH STREET, 11F",2006-09-15,798054,2018-04-20,890000,91946,4235,21.71097992916175
"68 BRADHURST AVENUE, 8-O",2007-06-29,455034,2012-07-13,495000,39966,1841,21.708853883758827
"445 WEST 19TH STREET, 4C",2007-10-23,643000,2012-06-29,680000,37000,1711,21.62478082992402
"736 WEST 187 STREET, 306",2005-10-21,672045,2014-06-04,740000,67955,3148,21.586721728081322
"310 WEST 52ND   STREET, 6H",2007-06-27,832419,2011-11-16,867000,34581,1603,21.57267623206488
"455 MAIN STREET, 5G",2006-03-30,431964,2012-02-03,478000,46036,2136,21.55243445692884
"306 EAST 105 STREET, 3B",2006-06-16,400000,2017-03-21,484463,84463,3931,21.48639023149326
"100 WEST 39TH STREET, 41I",2007-06-08,745000,2016-05-13,815000,70000,3262,21.459227467811157
"350 WEST 50TH STREET, 2X",2007-11-06,468750,2013-05-07,511800,43050,2009,21.428571428571427
"333 EAST 30TH   STREET, 4-H",2007-05-08,480000,2015-05-26,543000,63000,2940,21.428571428571427
"120 RIVERSIDE BOULEVARD, 10G",2006-01-31,829873,2018-08-16,928000,98127,4580,21.425109170305678
"515 EAST 72ND   STREET, 26A",2008-01-28,923857,2017-09-06,999000,75143,3509,21.414363066400686
"230 RIVERSIDE DRIVE, 1C",2008-06-30,161000,2013-06-27,200000,39000,1823,21.393307734503566
"220 RIVERSIDE BOULEVARD, 5D",2004-11-22,708000,2011-07-22,760000,52000,2433,21.37279079325935
"300 CATHEDRAL PARKWAY, 6H",2004-12-16,350000,2010-02-01,390000,40000,1873,21.35611318739989
"380 LENOX AVENUE, 10B",2007-01-30,918461,2013-09-10,970000,51539,2415,21.34120082815735
"247 WEST 46TH   STREET, 1902",2008-12-29,1410276,2017-12-14,1480000,69724,3272,21.309290953545233
"581 ACADEMY STREET, 2C",2007-07-12,315000,2018-04-27,399000,84000,3942,21.308980213089804
"340 EAST 64TH   STREET, 14K",2008-03-31,1565000,2012-10-01,1600000,35000,1645,21.27659574468085
"30 WEST 9TH   STREET, 16",2008-02-14,825000,2013-12-03,870000,45000,2119,21.236432279377066
"660 RIVERSIDE DRIVE, 2F",2008-03-04,230178,2015-04-03,285000,54822,2586,21.19953596287703
"99 BATTERY PLACE, 8-B",2003-09-29,303000,2010-06-21,355000,52000,2457,21.164021164021165
"150 NASSAU STREET, 7K",2004-06-07,355000,2012-03-15,415000,60000,2838,21.141649048625794
"100 RIVERSIDE BOULEVARD, 7U",2008-07-03,940000,2013-01-18,975000,35000,1660,21.08433734939759
"224 WEST 18TH STREET, 4A",2007-06-11,2171000,2011-03-21,2200000,29000,1379,21.029731689630168
"148 MADISON STREET, 3C",2003-07-11,303186,2017-06-08,410000,106814,5081,21.022239716591223
"157 LUDLOW STREET, 5R",2005-10-14,687318,2017-12-13,780651,93333,4443,21.0067521944632
"225 RECTOR PLACE, 19J",2008-04-11,850238,2016-11-29,916425,66187,3154,20.985098287888395
"5 EAST 22ND STREET, 28A",2005-05-24,797289,2012-04-11,850000,52711,2514,20.96698488464598
"206 1 AVENUE, 2A",2005-12-12,541000,2012-05-09,590000,49000,2340,20.94017094017094
"350 EAST 82ND STREET, 8E",2006-09-29,535000,2015-04-08,600000,65000,3113,20.880179890780596
"55 WALL STREET, 942",2007-04-19,1269498,2011-04-22,1300000,30502,1464,20.834699453551913
"301 CATHEDRAL PARKWAY, 7V",2006-06-29,440000,2018-01-24,528016,88016,4227,20.822332623610126
"635 WEST 42ND   STREET, 3D",2007-10-11,707683,2016-11-21,777000,69317,3329,20.822168819465304
"210 LAFAYETTE STREET, 8A",2007-03-29,1850000,2010-07-14,1875000,25000,1203,20.781379883624272
"120 GREENWICH STREET, 7J",2006-08-03,538654,2014-05-29,598000,59346,2856,20.779411764705884
"1031 6 AVENUE, 36D",2006-08-02,743322,2008-02-15,755000,11678,562,20.77935943060498
"16 WEST 19TH   STREET, 11-A",2007-09-17,1425550,2011-08-05,1455000,29450,1418,20.768688293370946
"140 EAST 63RD STREET, 4D",2010-07-20,649134,2016-08-11,695000,45866,2214,20.716350496838302
"300 ALBANY STREET, 5E",2004-01-29,220000,2012-01-12,280000,60000,2905,20.65404475043029
"255 HUDSON STREET, PHC",2006-11-21,1415367,2018-02-13,1500000,84633,4102,20.632130667966845
"20 WEST STREET, 34F",2006-06-22,410670,2013-07-23,464000,53330,2588,20.60664605873261
"222 RIVERSIDE DRIVE, 1A",2005-08-12,799000,2015-01-21,870000,71000,3449,20.585677007828355
"21 LUDLOW STREET, 7B",2010-02-12,589000,2012-11-29,610000,21000,1021,20.568070519098924
"56 PINE STREET, 12B",2006-01-13,616041,2013-08-13,672500,56459,2769,20.389671361502348
"402 EAST 90TH STREET, 12F",2004-08-19,555000,2010-09-24,600000,45000,2227,20.20655590480467
"200 RECTOR PLACE, 16J",2006-12-11,540000,2015-03-19,601000,61000,3020,20.198675496688743
"619 EAST 11 STREET, 2B",2005-07-12,545000,2017-01-20,630000,85000,4210,20.19002375296912
"130 BARROW STREET, 304",2008-03-04,920000,2012-03-30,950000,30000,1487,20.174848688634835
"300 RECTOR PLACE, 8J",2003-03-07,276000,2013-11-26,355000,79000,3917,20.16849629818739
"2 SOUTH END AVENUE, 4M",2004-01-16,319000,2016-06-03,410000,91000,4522,20.123839009287927
"311 GREENWICH STREET, 9E",2007-06-29,800000,2012-11-21,839500,39500,1972,20.030425963488845
"80 PARK AVENUE, 2C",2005-07-27,360000,2010-05-17,395000,35000,1755,19.943019943019944
"2 SOUTH END AVENUE, 7W",2003-03-26,290000,2011-07-06,350000,60000,3024,19.841269841269842
"4260 BROADWAY, 408",2005-06-09,235000,2016-06-24,315000,80000,4033,19.83635011157947
"305 2 AVENUE, 330",2006-11-16,651680,2016-04-22,720000,68320,3445,19.831640058055154
"5 WEEHAWKEN STREET, 1B",2007-10-31,529490,2013-06-04,570000,40510,2043,19.82868330885952
"21 SOUTH END AVENUE, 432",2004-12-15,415000,2008-05-29,440000,25000,1261,19.825535289452816
"325 5 AVENUE, 10E",2009-10-06,810000,2012-11-14,832500,22500,1135,19.823788546255507
"120 RIVERSIDE BOULEVARD, 8E",2006-02-16,1751390,2012-11-14,1800000,48610,2463,19.73609419407227
"16 WEST 19TH   STREET, 3-B",2008-03-13,855330,2011-08-15,880000,24670,1250,19.736
"120 GREENWICH STREET, 6F",2006-07-20,720667,2014-10-14,780000,59333,3008,19.7250664893617
"88 CHAMBERS STREET, 301",2007-06-19,1527375,2010-08-16,1550000,22625,1154,19.605719237435007
"845 UNITED NATIONS PLAZA, 12F",2004-09-29,560000,2012-06-28,615000,55000,2829,19.441498762813715
"530 EAST 76TH STREET, 25H",2007-01-23,1750000,2013-12-23,1799000,49000,2526,19.398258115597784
"425 FIFTH AVENUE, 42C",2004-07-12,1058980,2010-05-06,1100000,41020,2124,19.31261770244821
"421 EAST 13TH   STREET, 7F",2008-03-11,1364455,2018-03-12,1435000,70545,3653,19.311524774158226
"230 RIVERSIDE DRIVE, 18F",2008-06-30,155000,2013-06-27,190000,35000,1823,19.199122325836534
"254 PARK AVENUE SOUTH, 9M",2013-07-26,787117,2016-11-01,810000,22883,1194,19.16499162479062
"80 JOHN STREET, 17C",2008-02-28,1114984,2013-03-01,1150000,35016,1828,19.155361050328228
"56 PINE STREET, 16G",2006-05-04,380250,2015-10-23,446500,66250,3459,19.15293437409656
"350 EAST 72ND   STREET, 1A",2007-04-18,2400000,2011-08-02,2430000,30000,1567,19.14486279514997
"120 GREENWICH STREET, 3A",2006-12-11,636406,2015-04-30,695000,58594,3062,19.135858915741345
"10 WEST END AVENUE, 5A",2007-07-06,1275256,2012-06-26,1310000,34744,1817,19.121629058888278
"82 BEAVER STREET, 1406",2008-04-30,475000,2015-07-01,525000,50000,2618,19.098548510313215
"630 1 AVENUE, 21F",2005-11-28,675000,2010-01-11,703625,28625,1505,19.019933554817275
"211 EAST 46TH   STREET, 15E",2008-07-14,902174,2012-07-20,930000,27826,1467,18.967961826857533
"120 RIVERSIDE BOULEVARD, 11P",2006-02-09,606551,2012-05-24,650000,43449,2296,18.923780487804876
"45 WEST 67TH   STREET, 9D",2007-08-15,740000,2014-11-11,790000,50000,2645,18.90359168241966
"325 FIFTH AVENUE, 12C",2006-10-16,1342817,2011-11-23,1378000,35183,1864,18.875
"300 RECTOR PLACE, 6J",2004-01-19,310000,2012-03-07,366000,56000,2970,18.855218855218855
"212 EAST 95TH STREET, 7A",2008-09-29,1463231,2013-05-13,1495000,31769,1687,18.83165382335507
"322 WEST 57TH   STREET, 24M",2008-06-23,1069162,2012-12-18,1100000,30838,1639,18.815131177547286
"340 EAST 23RD STREET, 8J",2008-02-27,534581,2013-04-24,570000,35419,1883,18.80987785448752
"31 EAST 28TH   STREET, 4W",2007-04-11,1985000,2013-02-05,2025000,40000,2127,18.805829807240244
"311 EAST 38TH STREET, 5A",2006-06-23,370000,2011-12-09,407500,37500,1995,18.796992481203006
"10 WEST END AVENUE, 7E",2007-07-26,773870,2012-09-06,809000,35130,1869,18.796147672552166
"101 WARREN STREET, 1040",2008-09-19,1344090,2011-01-14,1360000,15910,847,18.783943329397875
"225 EAST 34TH STREET, 11D",2007-11-06,784052,2010-03-05,800000,15948,850,18.76235294117647
"170 WEST 23RD STREET, 2C",2006-10-25,640000,2011-09-28,673750,33750,1799,18.760422456920512
"350 WEST 42ND STREET, 7A",2006-04-28,666953,2012-08-10,710000,43047,2296,18.74869337979094
"382 CENTRAL PARK WEST, 14V",2008-01-24,840056,2015-12-15,894000,53944,2882,18.717557251908396
"65 COOPER SQUARE, 5F",2005-12-28,470000,2010-05-27,500000,30000,1611,18.6219739292365
"400 5 AVENUE, 45C",2011-06-07,916992,2016-04-14,950000,33008,1773,18.617033276931753
"1641 THIRD AVENUE, 10F",2005-05-12,850000,2012-09-20,900000,50000,2688,18.601190476190474
"56 PINE STREET, 4E",2005-12-29,481650,2012-05-17,525000,43350,2331,18.597168597168597
"148 MADISON STREET, 6D",2004-02-19,484692,2015-03-30,560037,75345,4057,18.571604633965986
"330 EAST 38TH STREET, 6P",2007-08-03,865000,2014-03-28,910000,45000,2429,18.5261424454508
"40 BROAD STREET, 15D",2009-01-22,911333,2018-06-26,975000,63667,3442,18.497094712376526
"660 RIVERSIDE DRIVE, 5F",2008-02-22,263640,2017-12-21,330000,66360,3590,18.484679665738163
"117 EAST 57TH STREET, 20H",2007-11-16,1100000,2011-08-04,1125000,25000,1357,18.422991893883566
"205 EAST 59TH   STREET, 10C",2008-06-26,1725000,2012-03-15,1750000,25000,1358,18.40942562592047
"26 LUDLOW STREET, 4A",2006-05-26,610000,2012-05-14,650000,40000,2180,18.34862385321101
"230 RIVERSIDE DRIVE, 10CC",2006-12-01,481650,2014-02-21,530000,48350,2639,18.321333838575217
"18 WEST 48TH   STREET, 26D",2007-06-07,1282995,2015-12-21,1340000,57005,3119,18.276691247194613
"222 RIVERSIDE DRIVE, 2F",2005-05-25,487500,2015-05-13,554000,66500,3640,18.26923076923077
"263 9 AVENUE, 8E",2006-02-09,1858306,2010-07-29,1888000,29694,1631,18.206008583690988
"865 1 AVENUE, 8A",2008-03-05,950660,2015-06-25,999000,48340,2668,18.118440779610197
"340 EAST 64TH   STREET, 22B",2008-06-12,2090000,2017-07-19,2150000,60000,3324,18.050541516245488
"400 EAST 90TH   STREET, 16E",2007-07-23,677136,2015-07-30,730000,52864,2929,18.04848071013998
"504 WEST 110 STREET, 2A",2007-09-19,490000,2010-10-04,510000,20000,1111,18.001800180018
"10 WEST END AVENUE, 8J",2007-07-27,668481,2013-02-26,705000,36519,2041,17.892699657030867
"10 WEST END AVENUE, 9K",2007-07-30,1277903,2010-03-12,1295000,17097,956,17.88389121338912
"55 WALL STREET, 812",2010-04-21,530983,2017-01-19,575000,44017,2465,17.856795131845843
"581 ACADEMY STREET, 3D",2008-02-15,335000,2017-12-14,399000,64000,3590,17.827298050139277
"160 WADSWORTH AVENUE, 508",2004-07-30,360000,2018-06-27,450500,90500,5080,17.81496062992126
"571 ACADEMY STREET, GLA",2005-06-10,250000,2016-03-24,320000,70000,3940,17.766497461928935
"206 EAST 95TH STREET, 3B",2007-09-28,395460,2013-11-01,435000,39540,2226,17.762803234501348
"1641 3 AVENUE, SUB15",2003-02-20,19266,2006-05-04,40000,20734,1169,17.736526946107784
"230 RIVERSIDE DRIVE, 8H",2006-12-15,809508,2008-07-30,820000,10492,593,17.69308600337268
"635 WEST 42ND STREET, 3J",2007-08-14,702592,2013-06-06,740000,37408,2123,17.620348563353744
"340 EAST 23RD STREET, 14F",2008-03-12,855330,2014-05-15,895000,39670,2255,17.592017738359203
"555 WEST 59TH STREET, 8D",2008-03-06,920498,2012-10-09,950000,29502,1678,17.581644815256258
"100 RIVERSIDE BOULEVARD, 5J",2008-02-21,1008067,2013-12-02,1045000,36933,2111,17.49549976314543
"350 WEST 42ND STREET, 40A",2006-09-07,939335,2009-12-03,960000,20665,1183,17.46830092983939
"421 EAST 50TH STREET, 4F",2005-08-10,420000,2014-03-26,475000,55000,3150,17.46031746031746
"350 EAST 82ND   STREET, 3N",2008-04-22,737722,2015-09-29,785000,47278,2716,17.40721649484536
"635 WEST 42ND   STREET, 19J",2008-06-27,707683,2016-09-28,760000,52317,3015,17.35223880597015
"455 MAIN STREET, 14F",2006-05-11,539672,2012-07-25,579000,39328,2267,17.348037053374505
"120 GREENWICH STREET, PHA",2007-03-07,768778,2017-03-31,832500,63722,3677,17.32988849605657
"247 WEST 46TH   STREET, 3001",2008-09-10,1568105,2013-09-26,1600000,31895,1842,17.31541802388708
"404 EAST 66TH   STREET, 12H",2008-02-06,535000,2014-06-05,575000,40000,2311,17.308524448290783
"310 WEST 52ND   STREET, 29C",2007-07-09,946972,2011-03-03,970000,23028,1333,17.275318829707427
"55 WALL STREET, 500",2009-02-11,1386067,2016-02-04,1430000,43933,2549,17.23538642604943
"825 WEST END AVENUE, 9-F",2005-06-15,1162500,2011-06-03,1200000,37500,2179,17.209729233593393
"350 EAST 82ND   STREET, 3P",2007-04-17,717866,2014-08-19,764000,46134,2681,17.20775829914211
"20 WEST STREET, 38C",2007-02-26,509125,2013-12-31,552000,42875,2500,17.15
"15 WILLIAM STREET, 25C",2009-01-30,1150000,2018-01-19,1206000,56000,3276,17.094017094017094
"225 RECTOR PLACE, 5G",2008-06-24,590585,2014-07-02,628000,37415,2199,17.014552069122328
"230 RIVERSIDE DRIVE, 3B",2008-06-30,239000,2013-06-27,270000,31000,1823,17.004936917169502
"175 WEST 12TH STREET, 9H",2006-09-12,820000,2012-05-02,855000,35000,2059,16.998542982030113
"21 SOUTH END AVENUE, 323",2004-07-23,450000,2015-07-27,518289,68289,4021,16.983088783884607
"58 WEST 58TH STREET, 25F",2006-03-31,945000,2018-05-07,1020000,75000,4420,16.968325791855204
"120 GREENWICH STREET, 2F",2007-03-05,748413,2016-04-22,805000,56587,3336,16.962529976019184
"80 JOHN STREET, 7F",2007-08-29,984393,2013-05-29,1020000,35607,2100,16.955714285714286
"464 WEST 44TH   STREET, 7J",2008-02-13,790151,2015-05-15,835000,44849,2648,16.936933534743204
"15 WILLIAM STREET, 34D",2009-02-20,1069162,2015-10-06,1110000,40838,2419,16.882182720132285
"148 MADISON STREET, 7F",2003-06-23,331578,2014-07-29,400000,68422,4054,16.877651702022693
"300 RECTOR PLACE, 5M",2004-07-06,349000,2011-03-02,390000,41000,2430,16.872427983539094
"310 WEST 52ND   STREET, 3J",2007-09-06,682227,2010-07-29,700000,17773,1057,16.814569536423843
"340 EAST 23RD STREET, 4I",2008-02-07,466440,2011-12-13,490000,23560,1405,16.768683274021353
"2132 2 AVENUE, 3E",2007-01-17,340502,2015-02-18,390000,49498,2954,16.75626269465132
"2 SOUTH END AVENUE, 3B",2005-05-18,375000,2014-05-16,430000,55000,3285,16.7427701674277
"224 WEST 18TH STREET, 3D",2005-07-14,1157500,2014-02-13,1210000,52500,3136,16.741071428571427
"660 RIVERSIDE DRIVE, 5E",2010-07-23,268710,2012-05-30,280000,11290,677,16.676514032496307
"20 WEST STREET, 36B",2007-02-26,515000,2013-09-27,555000,40000,2405,16.632016632016633
"225 WEST 60TH   STREET, 15C",2007-01-22,1242265,2012-06-14,1275000,32735,1970,16.616751269035532
"360 EAST 88TH   STREET, 9B",2008-05-20,850000,2016-08-19,900000,50000,3013,16.59475605708596
"21 SOUTH END AVENUE, 333",2010-12-06,304867,2011-08-29,309270,4403,266,16.55263157894737
"158 HESTER STREET, 6J",2006-08-07,651680,2016-01-29,708888,57208,3462,16.524552281917966
"170 WEST 23RD STREET, 4Z",2006-05-25,620000,2013-11-08,665000,45000,2724,16.519823788546255
"317 WEST 95TH   STREET, D1",2007-09-11,599000,2016-03-03,650000,51000,3096,16.472868217054263
"230 RIVERSIDE DRIVE, 6B",2008-06-30,250000,2013-06-27,280000,30000,1823,16.456390565002742
"186 WEST 80TH STREET, 7E",2005-03-23,390000,2009-10-20,417500,27500,1672,16.44736842105263
"635 WEST 42ND   STREET, 6B",2008-05-22,783543,2017-10-26,840000,56457,3444,16.392857142857142
"82 BEAVER STREET, 406",2006-10-31,386334,2013-04-18,425000,38666,2361,16.37695891571368
"240 EAST 47TH STREET, 32F",2005-06-01,975000,2017-12-18,1050000,75000,4583,16.36482653283875
"400 CENTRAL PARK WEST, 9Y",2005-11-23,585000,2010-06-03,612000,27000,1653,16.33393829401089
"75 WALL STREET, 27Q",2009-06-09,773870,2016-05-17,815000,41130,2534,16.231254932912393
"120 GREENWICH STREET, 11B",2006-10-16,555964,2014-03-25,600000,44036,2717,16.20758189179242
"330 PEARL STREET, 3A",2004-02-02,575000,2010-11-05,615000,40000,2468,16.207455429497568
"200 CHAMBERS STREET, 8C",2007-04-13,1858306,2010-02-09,1875000,16694,1033,16.160696999031945
"225 EAST 34TH   STREET, 18D",2007-12-11,865512,2012-12-10,895000,29488,1826,16.14895947426068
"581 ACADEMY STREET, 1G",2005-08-16,240000,2015-07-27,298500,58500,3632,16.106828193832598
"768 5 AVENUE, 1807",2008-02-28,6274311,2012-07-18,6300000,25689,1602,16.03558052434457
"148 MADISON STREET, 5G",2003-09-24,351858,2016-03-22,425000,73142,4563,16.02936664475126
"475 GREENWICH STREET, 2C",2008-07-15,972428,2008-12-23,975000,2572,161,15.975155279503106
"20 WEST STREET, 43A",2007-05-24,692410,2016-06-02,745000,52590,3297,15.950864422202002
"20 WEST STREET, 35A",2007-06-01,509125,2013-08-16,545000,35875,2268,15.817901234567902
"327 CENTRAL PARK WEST, 2E",2008-01-25,850000,2014-11-04,889000,39000,2475,15.757575757575758
"310 WEST 52ND   STREET, 27A",2007-04-27,1005267,2011-08-19,1030000,24733,1575,15.703492063492064
"1623 3 AVENUE, SUA41",2003-02-20,25350,2006-07-26,45000,19650,1252,15.694888178913738
"350 WEST 50TH STREET, 33H",2004-10-05,585000,2010-07-15,618000,33000,2109,15.647226173541963
"425 5 AVENUE, 55B",2005-06-28,708812,2006-08-01,715000,6188,399,15.508771929824562
"110 EAST 87TH STREET, 2D",2005-08-08,767500,2018-06-15,840000,72500,4694,15.445249254367278
"400 CENTRAL PARK WEST, 1F",2004-12-16,389000,2012-03-28,430000,41000,2659,15.419330575404288
"50 BAYARD STREET, 5X",2006-05-12,365000,2007-04-04,370000,5000,327,15.290519877675841
"11 WEST 131 STREET, C2",2006-05-12,288736,2008-05-19,300000,11264,738,15.262872628726287
"348 EAST 89TH STREET, 9E",2006-12-18,589000,2017-10-03,649000,60000,3942,15.220700152207002
"635 WEST 42ND   STREET, 15L",2008-07-23,814600,2015-10-30,855000,40400,2655,15.216572504708099
"160 CENTRAL PARK SOUTH, 1714",2008-02-01,2138325,2017-05-22,2190000,51675,3398,15.207474985285462
"380 RECTOR PLACE, 16C",2005-05-11,605000,2013-06-21,650000,45000,2963,15.187310158623017
"68 BRADHURST AVENUE, 8-I",2007-10-17,617460,2014-05-20,654000,36540,2407,15.180722891566266
"1 SHERIDAN SQUARE, 5F",2006-05-03,650000,2010-11-11,675000,25000,1653,15.124016938898972
"443 WEST 151ST STREET, 4C",2004-09-01,185000,2014-09-05,240000,55000,3656,15.043763676148796
"421 EAST 13TH   STREET, 1D",2008-02-04,911333,2013-04-24,940000,28667,1906,15.040398740818468
"1420 YORK AVENUE, 5G",2007-11-21,381175,2009-06-30,390000,8825,587,15.034071550255536
"2082 8TH AVENUE, 1A",2007-07-16,301990,2015-05-20,345000,43010,2865,15.012216404886562
"167 WEST 136TH STREET, 7",2005-07-26,420810,2016-05-18,480000,59190,3949,14.988604710053178
"68 BRADHURST AVENUE, 8-T",2007-05-29,453222,2013-03-22,485000,31778,2124,14.961393596986817
"80 PARK AVENUE, 9G",2008-06-30,735000,2018-07-25,790000,55000,3677,14.957846070165896
"21 SOUTH WILLIAM STREET, 6A",2006-05-09,518289,2018-07-26,585000,66711,4461,14.954270342972428
"753 EAST 5TH STREET, 4A",2005-07-08,733140,2014-02-05,780000,46860,3134,14.952137843012125
"455 EAST 86TH STREET, 24D",2005-06-28,436000,2011-09-22,470000,34000,2277,14.931927975406236
"110 WEST 86TH STREET, 14E",2005-04-11,708000,2012-01-26,745000,37000,2481,14.913341394598952
"200 WEST END AVENUE, 5D",2008-01-03,890968,2009-09-01,900000,9032,607,14.879736408566721
"322 WEST 57TH STREET, 33P2",2008-02-27,1746298,2018-01-17,1800000,53702,3612,14.86766334440753
"165 HENRY STREET, 302",2005-05-25,265000,2014-08-14,315000,50000,3368,14.84560570071259
"10 WEST END AVENUE, 6D",2007-07-13,824782,2013-02-08,855000,30218,2037,14.834560628375062
"123 BAXTER STREET, 2D",2007-10-09,1295000,2017-10-11,1349181,54181,3655,14.823803009575924
"225 EAST 34TH STREET, 3H",2007-10-22,768778,2012-08-27,795000,26222,1771,14.806324110671937
"1760 2 AVENUE, 4E",2004-06-07,410000,2011-07-12,448000,38000,2591,14.66615206483983
"237 EAST 88TH STREET, 403",2007-08-22,339690,2013-04-30,370000,30310,2078,14.58614051973051
"2 SOUTH END AVENUE, 8E",2003-04-24,310000,2012-10-02,360000,50000,3449,14.496955639315743
"20 WEST STREET, 22D",2006-06-01,446160,2011-11-15,475000,28840,1993,14.470647265429001
"211 EAST 46TH   STREET, 10F",2008-05-23,1140041,2012-03-07,1160000,19959,1384,14.421242774566474
"15 BROAD STREET, 2620",2006-12-19,1781937,2013-01-31,1813900,31963,2235,14.301118568232662
"301 EAST 79TH   STREET, 9 K",2007-05-03,380000,2013-01-29,410000,30000,2098,14.299332697807436
"121 WEST 19TH STREET, 4C",2008-05-13,1175000,2013-02-28,1200000,25000,1752,14.269406392694064
"145 EAST 48TH STREET, 20E",2006-01-12,690000,2011-10-19,720000,30000,2106,14.245014245014245
"350 WEST 50TH STREET, 31H",2007-06-20,720000,2012-11-08,748000,28000,1968,14.227642276422765
"395 BROADWAY, 5E",2005-04-20,1120000,2011-01-28,1150000,30000,2109,14.22475106685633
"392 CENTRAL PARK WEST, 20T",2007-10-11,580000,2013-07-25,610000,30000,2114,14.191106906338694
"545 WEST 110TH STREET, 7E",2007-07-31,675000,2015-05-06,715000,40000,2836,14.104372355430183
"311 EAST 38TH STREET, 4A",2005-12-01,370000,2011-07-22,399000,29000,2059,14.084507042253522
"20 WEST STREET, 41B",2007-04-03,725000,2016-12-28,775000,50000,3557,14.05678942929435
"350 EAST 82ND   STREET, 3G",2008-04-17,748413,2014-06-16,780000,31587,2251,14.03243003109729
"280 RECTOR PLACE, 7P",2005-02-24,310000,2012-12-20,350000,40000,2856,14.005602240896359
"15 WILLIAM STREET, 23D",2009-02-26,936790,2011-09-30,950000,13210,946,13.964059196617336
"280 PARK AVENUE SOUTH, 12L",2004-08-16,780000,2010-07-28,810000,30000,2172,13.812154696132596
"305 2 AVENUE, 518",2006-11-30,933440,2013-03-15,965000,31560,2297,13.739660426643448
"2 SOUTH END AVENUE, 5N",2007-02-09,430000,2017-02-10,480129,50129,3654,13.718938149972633
"450 WEST 17TH   STREET, 1111",2008-10-07,809508,2010-11-12,820000,10492,766,13.697127937336814
"340 CABRINI BOULEVARD, 302",2004-06-09,283920,2017-08-30,350000,66080,4830,13.681159420289855
"111 FULTON STREET, PH103",2008-12-15,1400093,2014-12-18,1430000,29907,2194,13.63126709206928
"50 WEST 127TH STREET, 6C",2007-09-17,875695,2013-08-16,905000,29305,2160,13.56712962962963
"21 SOUTH END AVENUE, 733",2007-07-26,370000,2013-08-21,400000,30000,2218,13.525698827772768
"20 WEST STREET, 17C",2006-06-14,412395,2013-01-21,445000,32605,2413,13.512225445503523
"377 RECTOR PLACE, 14E",2005-12-19,965000,2012-11-09,999000,34000,2517,13.508144616607073
"99 BATTERY PLACE, 5-P",2007-07-05,552000,2015-03-26,590000,38000,2821,13.47040056717476
"14 PRINCE STREET, 4F",2005-07-22,775000,2010-08-25,800000,25000,1860,13.440860215053764
"871 8 AVENUE, 6A",2005-12-12,545000,2016-02-23,595000,50000,3725,13.422818791946309
"421 WEST 54TH   STREET, 5E",2008-02-01,957053,2013-03-08,982000,24947,1862,13.39795918367347
"21 SOUTH END AVENUE, 532",2004-06-21,360000,2012-03-28,398000,38000,2837,13.39443073669369
"120 RIVERSIDE BOULEVARD, 4V",2005-12-09,677136,2010-08-18,699998,22862,1713,13.346176298890835
"1 IRVING PLACE, V20A",2006-04-14,920000,2012-06-15,950000,30000,2254,13.309671694764862
"20 WEST STREET, 23J",2007-01-29,738231,2015-06-19,778961,40730,3063,13.297420829252367
"68 BRADHURST AVENUE, 5-K",2007-07-31,455034,2011-09-12,475000,19966,1504,13.275265957446809
"15 WILLIAM STREET, 10C",2008-11-05,1109892,2018-05-15,1156028,46136,3478,13.26509488211616
"225 RECTOR PLACE, 11F",2008-06-13,600767,2015-12-11,637000,36233,2737,13.238217025940811
"1628 2 AVENUE, 2E",2007-04-27,514216,2014-07-09,549000,34784,2630,13.225855513307986
"205 EAST 68TH STREET, T2C",2005-03-14,395000,2011-06-07,425000,30000,2276,13.181019332161688
"119 FULTON STREET, 2B",2007-01-23,697501,2011-09-26,720000,22499,1707,13.180433509080258
"150 NASSAU STREET, 6E",2005-08-12,686000,2013-09-18,725000,39000,2959,13.18012842176411
"200 EAST 28TH STREET, 6A",2006-06-07,465000,2013-07-02,499000,34000,2582,13.168086754453912
"230 RIVERSIDE DRIVE, 9C",2008-06-30,316000,2013-06-27,340000,24000,1823,13.165112452002194
"230 RIVERSIDE DRIVE, 5B",2008-06-30,246000,2013-06-27,270000,24000,1823,13.165112452002194
"230 RIVERSIDE DRIVE, 10P",2008-06-30,176000,2013-06-27,200000,24000,1823,13.165112452002194
"1 IRVING PLACE, P12G",2006-08-24,680000,2011-06-08,703000,23000,1749,13.150371640937678
"132 WEST 123 STREET, PH",2006-08-21,866530,2011-07-20,890000,23470,1794,13.082497212931996
"1600 BROADWAY, 18B",2006-06-21,1221900,2013-05-31,1255000,33100,2536,13.052050473186119
"25 NORTH MOORE STREET, SU3",2003-10-09,24500,2010-03-11,55000,30500,2345,13.00639658848614
"2109 BROADWAY, 31990",2009-01-05,580000,2011-02-14,590000,10000,770,12.987012987012987
"635 WEST 42ND STREET, 29H",2007-07-27,946972,2014-07-31,980000,33028,2561,12.896524795001952
"350 WEST 50TH STREET, 2KK",2006-01-30,485000,2013-07-11,520000,35000,2719,12.872379551305627
"201 WEST 72ND   STREET, 17F",2008-04-02,640000,2014-02-07,667500,27500,2137,12.868507253158633
"220 RIVERSIDE BOULEVARD, 18W",2007-03-16,695000,2015-05-12,733320,38320,2979,12.863376972138301
"70 BATTERY PLACE, 11A",2009-05-12,926607,2014-05-08,950000,23393,1822,12.839187705817782
"250 EAST 54TH STREET, 27C",2008-02-14,950000,2013-06-18,975000,25000,1951,12.813941568426449
"402 EAST 90TH STREET, 11E",2007-05-25,671000,2014-09-02,705000,34000,2657,12.796386902521641
"415 EAST 37TH   STREET, 6D",2007-01-31,574000,2014-10-17,610000,36000,2816,12.784090909090908
"240 RIVERSIDE BOULEVARD, 6 L",2005-10-24,572250,2011-10-07,600000,27750,2174,12.764489420423184
"20 WEST STREET, 14H",2007-06-12,660976,2013-09-09,690000,29024,2281,12.724243752740026
"15 WILLIAM STREET, 20B",2008-12-19,1043706,2014-08-19,1070000,26294,2069,12.708554857419044
"82 BEAVER STREET, 206",2007-04-20,404586,2014-11-14,439700,35114,2765,12.699457504520796
"205 EAST 59TH   STREET, 17A",2007-02-06,2419362,2013-09-18,2450000,30638,2416,12.681291390728477
"68 BRADHURST AVENUE, 2-P",2007-07-18,311203,2012-09-11,335000,23797,1882,12.64452709883103
"56 PINE STREET, 16A",2006-04-24,509125,2009-10-01,525000,15875,1256,12.639331210191083
"120 GREENWICH STREET, 9C",2007-02-12,750000,2014-02-28,782500,32500,2573,12.631169840652934
"230 RIVERSIDE DRIVE, 18M",2008-06-30,157000,2013-06-27,180000,23000,1823,12.616566099835437
"230 RIVERSIDE DRIVE, 12G",2008-06-30,167000,2013-06-27,190000,23000,1823,12.616566099835437
"101 WEST 24TH   STREET, 6H",2009-01-23,1038615,2011-07-15,1050000,11385,903,12.60797342192691
"123 BAXTER STREET, 5C",2007-11-20,1266703,2018-05-22,1315000,48297,3836,12.590458811261731
"418 CENTRAL PARK WEST, 20",2005-09-27,436020,2012-01-18,465000,28980,2304,12.578125
"27 WEST 72ND   STREET, 1001",2007-09-20,975000,2010-12-28,990000,15000,1195,12.552301255230125
"333 WEST 56TH STREET, 4K",2008-05-30,660000,2017-03-01,700000,40000,3197,12.511729746637473
"1600 BROADWAY, 15D",2006-11-17,885877,2017-09-27,935000,49123,3967,12.38290899924376
"121 EAST 23RD   STREET, 9D",2008-09-09,1165000,2012-01-09,1180000,15000,1217,12.325390304026294
"555 WEST 59TH STREET, 11A",2008-02-29,933735,2012-12-06,955000,21265,1742,12.20723306544202
"220 RIVERSIDE BOULEVARD, 6U",2005-01-27,780000,2012-12-04,815000,35000,2868,12.203626220362622
"333 EAST 45TH   STREET, 8B",2008-10-20,647500,2016-08-29,682500,35000,2870,12.195121951219512
"77 WEST 55TH STREET, 5K",2006-12-15,470000,2012-05-07,494000,24000,1970,12.182741116751268
"40 EAST 61ST   STREET, 11C",2007-08-01,1550000,2011-07-13,1567500,17500,1442,12.135922330097088
"18 ELDRIDGE STREET, 2A",2008-06-27,405600,2016-04-06,440000,34400,2840,12.112676056338028
"1600 BROADWAY, PH2B",2006-08-24,997885,2012-10-11,1025000,27115,2240,12.104910714285714
"100 RIVERSIDE BOULEVARD, 5R",2008-02-22,809508,2011-08-25,825000,15492,1280,12.103125
"56 PINE STREET, 16E",2006-04-25,672045,2014-11-26,710000,37955,3137,12.099139305068537
"250 EAST 30TH STREET, 3B",2008-05-29,725000,2017-06-20,765000,40000,3309,12.088244182532486
"157 LUDLOW STREET, 3R",2005-10-24,733140,2013-01-15,765000,31860,2640,12.068181818181818
"250 EAST 40TH STREET, 12F",2005-06-23,745000,2006-08-14,750000,5000,417,11.990407673860911
"157 EAST 32ND   STREET, 3E",2015-06-12,682500,2017-08-14,692000,9500,794,11.964735516372796
"635 WEST 42ND   STREET, 6M",2008-10-16,767354,2015-02-19,795000,27646,2317,11.931808372895986
"300 CATHEDRAL PARKWAY, 20K",2006-08-25,480000,2013-07-18,510000,30000,2519,11.909487892020643
"205 EAST 85TH   STREET, 15B",2009-07-22,1054262,2012-01-11,1065000,10738,903,11.891472868217054
"1 IRVING PLACE, U7A",2007-04-24,1685000,2010-10-29,1700000,15000,1284,11.682242990654206
"220 RIVERSIDE BOULEVARD, 11B",2007-08-07,965000,2014-08-19,995000,30000,2569,11.677695601401323
"41 WEST 72ND STREET, 11B",2005-11-23,680000,2011-03-11,702500,22500,1934,11.633919338159256
"123 WASHINGTON STREET, 38A",2012-01-06,1476462,2016-05-18,1495000,18538,1594,11.629861982434129
"555 WEST 23RD, S12F",2006-01-27,768778,2009-11-23,785000,16222,1396,11.620343839541547
"10 WEST END AVENUE, 3D",2007-07-02,814600,2011-09-21,832500,17900,1542,11.608300907911802
"138 EDGECOMBE AVENUE, PHE",2008-09-17,319538,2013-07-16,340000,20462,1763,11.606352807714124
"225 5 AVENUE, 10F",2007-01-23,1825213,2012-11-30,1850000,24787,2138,11.59354536950421
"340 CABRINI BOULEVARD, 501",2005-12-09,635000,2008-04-22,645000,10000,865,11.560693641618498
"206 EAST 95TH STREET, 9B",2007-09-20,728914,2015-09-11,762500,33586,2913,11.529694473051837
"120 RIVERSIDE BOULEVARD, 3B",2007-07-31,825000,2013-07-15,850000,25000,2176,11.488970588235293
"80 JOHN STREET, 2H",2007-05-07,390390,2011-04-27,407000,16610,1451,11.447277739490007
"404 EAST 66TH STREET, 10K",2007-01-17,512000,2012-07-20,535000,23000,2011,11.437095972153157
"706 RIVERSIDE DRIVE, 9A",2007-05-14,672045,2012-11-15,695000,22955,2012,11.409045725646124
"188 EAST 70TH   STREET, 16D",2007-08-28,1180000,2012-07-03,1200000,20000,1771,11.29305477131564
"280 RECTOR PLACE, 7C",2003-01-10,476000,2008-11-07,500000,24000,2128,11.278195488721805
"435 EAST 76TH STREET, 4A",2006-08-28,700000,2012-09-24,725000,25000,2219,11.266336187471834
"350 EAST 82ND STREET, 6H",2006-10-11,722957,2014-08-21,755000,32043,2871,11.160919540229886
"100 RIVERSIDE BOULEVARD, 11E",2008-08-22,972428,2017-11-16,1010000,37572,3373,11.13904536021346
"212 EAST 70TH STREET, 1C",2010-10-07,615000,2013-03-26,625000,10000,901,11.098779134295228
"120 RIVERSIDE BOULEVARD, 7C",2006-04-19,605000,2013-09-20,635000,30000,2711,11.066027296200664
"127 WEST 89TH   STREET, 63",2007-04-20,725000,2013-07-01,750000,25000,2264,11.042402826855124
"120 RIVERSIDE BOULEVARD, 11H",2006-02-13,989739,2007-06-07,995000,5261,479,10.98329853862213
"230 RIVERSIDE DRIVE, 7P",2008-06-30,250000,2013-06-27,270000,20000,1823,10.970927043335163
"400 5 AVENUE, 46C",2011-06-07,937527,2016-06-07,957500,19973,1827,10.932129173508484
"11 EAST 36TH   STREET, 404",2007-05-03,746377,2009-06-30,755000,8623,789,10.929024081115337
"310 EAST HOUSTON STREET, 4A",2007-06-28,758596,2014-02-18,785000,26404,2427,10.879274824886691
"1619 3 AVENUE, SUA13",2003-02-20,22308,2007-05-10,39000,16692,1540,10.838961038961038
"21 SOUTH END AVENUE, 228",2008-04-04,425000,2014-07-29,450000,25000,2307,10.836584308625921
"145 EAST 48TH STREET, 4G",2005-07-15,505000,2014-06-04,540000,35000,3246,10.782501540357362
"251 WEST 89TH STREET, 11C",2004-08-02,1150000,2009-09-01,1170000,20000,1856,10.775862068965518
"166 EAST 63RD STREET, 7J",2010-07-09,1475000,2016-11-18,1500000,25000,2324,10.757314974182444
"220 RIVERSIDE BOULEVARD, 7U",2005-05-18,780000,2011-10-04,805000,25000,2330,10.729613733905579
"425 FIFTH AVENUE, 45C",2005-12-20,585493,2009-09-03,600000,14507,1353,10.72209903917221
"158 EAST 100TH STREET, 3RR",2007-04-30,218010,2016-01-19,252000,33990,3186,10.668549905838042
"237 EAST 88TH STREET, 504",2007-09-26,339690,2012-12-21,360000,20310,1913,10.616832200731835
"516 WEST 47TH STREET, S5L",2009-03-03,562500,2012-05-30,575000,12500,1184,10.557432432432432
"350 WEST 42ND STREET, 16B",2006-06-14,758264,2010-10-19,775000,16736,1588,10.53904282115869
"555 WEST 23RD STREET, S9E",2014-05-15,985000,2016-12-19,995000,10000,949,10.53740779768177
"117 EAST 29TH STREET, 2C",2007-11-08,907260,2009-11-12,915000,7740,735,10.53061224489796
"100 RIVERSIDE BOULEVARD, 8D",2008-04-04,797671,2013-01-23,816000,18329,1755,10.443874643874643
"400 CENTRAL PARK WEST, 7J",2008-08-18,830000,2012-07-25,845000,15000,1437,10.438413361169102
"230 RIVERSIDE DRIVE, 4P",2008-06-30,241000,2013-06-27,260000,19000,1823,10.422380691168403
"1031 6 AVENUE, PH-E",2006-09-25,753505,2008-06-13,760000,6495,627,10.358851674641148
"301 WEST 57 STREET, 2E",2003-08-20,640000,2006-04-18,650000,10000,972,10.2880658436214
"100 RIVERSIDE BOULEVARD, 12H",2008-09-26,1354374,2011-07-29,1365000,10626,1036,10.256756756756756
"245 EAST 93RD   STREET, 26B",2008-09-18,699000,2014-05-13,720000,21000,2063,10.179350460494426
"222 RIVERSIDE DRIVE, 15F",2005-09-06,575000,2012-05-29,600000,25000,2457,10.175010175010176
"2 SOUTH END AVENUE, 6K",2005-11-14,435000,2015-04-16,470000,35000,3440,10.174418604651162
"206 EAST 95TH STREET, 7B",2007-09-17,681046,2018-04-11,720000,38954,3859,10.094324954651464
"15 BROAD STREET, 1722",2006-06-16,605858,2011-09-01,625000,19142,1903,10.058854440357331
"668 RIVERSIDE DRIVE, 4J",2009-03-26,405600,2014-07-11,425000,19400,1933,10.036213140196585
"220 RIVERSIDE BOULEVARD, 12K",2004-09-08,1160000,2010-03-01,1180000,20000,2000,10.0
"300 EAST 55TH STREET, 15D",2008-03-14,2299999,2016-12-27,2332000,32001,3210,9.969158878504674
"300 CATHEDRAL PARKWAY, 3H",2007-03-16,405000,2011-05-11,420000,15000,1517,9.88793671720501
"530 EAST 76 STREET, 8B",2004-06-21,650000,2012-10-16,680000,30000,3039,9.871668311944719
"342 EAST 110 STREET, 3B",2009-12-03,390000,2012-09-19,400000,10000,1021,9.79431929480901
"1623 THIRD AVENUE, 16A",2005-12-29,1160000,2011-08-15,1180000,20000,2055,9.732360097323602
"90 WILLIAM STREET, 6E",2008-08-04,544763,2012-11-20,560000,15237,1569,9.711281070745699
"4260 BROADWAY, 409",2008-04-01,278000,2015-11-12,305000,27000,2781,9.70873786407767
"40 BOND STREET, TH2",2007-10-10,9978850,2013-10-02,10000000,21150,2184,9.684065934065934
"100 UNITED NATIONS PLAZA, 4C",2005-03-08,685000,2012-04-23,710000,25000,2603,9.604302727621974
"124 WEST 93RD   STREET, 7E",2013-09-18,1865000,2016-07-27,1875000,10000,1043,9.587727708533079
"630 FIRST AVENUE, 8M",2005-03-11,853000,2013-06-25,882000,29000,3028,9.577278731836195
"16 WEST 19TH   STREET, 2-B",2008-02-28,840056,2009-07-29,845000,4944,517,9.562862669245648
"1600 BROADWAY, 16C",2006-06-15,1578287,2011-03-30,1595000,16713,1749,9.5557461406518
"321 EAST 48TH   STREET, 3J",2008-02-28,530000,2013-11-22,550000,20000,2094,9.551098376313275
"40 EAST 94TH STREET, 17G",2010-07-02,1975000,2017-09-28,2000000,25000,2645,9.45179584120983
"1255 FIFTH AVENUE, 4F",2007-03-13,600000,2014-06-09,625000,25000,2645,9.45179584120983
"20 WEST STREET, 34E",2006-11-08,651680,2014-03-20,677000,25320,2689,9.416139828932689
"21 SOUTH WILLIAM STREET, 7E",2006-05-05,767760,2014-04-10,795000,27240,2897,9.402830514325164
"807 RIVERSIDE DRIVE, AH",2009-12-30,315354,2013-09-13,328000,12646,1353,9.346637102734663
"20 WEST STREET, 22C",2006-06-12,430950,2013-07-17,455000,24050,2592,9.278549382716049
"200 RIVERSIDE BOULEVARD, 11L",2007-01-17,1275000,2012-12-21,1295000,20000,2165,9.237875288683602
"1623 3 AVENUE, SUA39",2003-03-11,25350,2009-01-09,45000,19650,2131,9.221022993899577
"15 WILLIAM STREET, 21D",2009-03-06,916425,2014-09-15,935000,18575,2019,9.200099058940069
"515 EAST 72ND   STREET, 24A",2011-03-21,730000,2017-04-17,750000,20000,2219,9.013068949977468
"350 WEST 50TH   STREET, 18A",2008-05-12,485000,2012-04-27,498000,13000,1446,8.990318118948824
"ONE WALL STREET COURT, 807",2006-11-14,404586,2011-08-10,420000,15414,1730,8.909826589595376
"82 BEAVER STREET, 202",2007-02-27,451230,2012-12-18,470000,18770,2121,8.84959924563885
"230 RIVERSIDE DRIVE, 1D",2008-06-30,444000,2013-06-27,460000,16000,1823,8.776741634668129
"230 RIVERSIDE DRIVE, 15F",2008-06-30,154000,2013-06-27,170000,16000,1823,8.776741634668129
"230 RIVERSIDE DRIVE, 14M",2008-06-30,154000,2013-06-27,170000,16000,1823,8.776741634668129
"350 WEST 42ND STREET, 25B",2007-07-26,880000,2009-02-20,885000,5000,575,8.695652173913043
"352 WEST 117TH STREET, 5E",2005-06-20,775000,2013-05-24,800000,25000,2895,8.635578583765112
"120 GREENWICH STREET, 8F",2007-03-30,733140,2014-03-19,755000,21860,2546,8.586017282010998
"90 WILLIAM STREET, 7G",2008-08-21,848202,2012-06-01,860000,11798,1380,8.549275362318841
"25 CENTRAL PARK WEST, 9S",2007-12-06,1400000,2012-10-02,1415000,15000,1762,8.51305334846765
"425 CENTRAL PARK WEST, 6F",2007-10-10,655000,2012-08-13,670000,15000,1769,8.479366873940078
"304 EAST 65TH   STREET, 8A",2007-10-09,770000,2014-04-29,790000,20000,2394,8.35421888053467
"10 WEST END AVENUE, 11A",2007-08-13,1323725,2012-03-05,1337500,13775,1666,8.268307322929171
"40 BROAD STREET, 25E",2009-11-18,936790,2015-12-03,955000,18210,2206,8.254759746146872
"230 RIVERSIDE DRIVE, 3C",2008-06-30,305000,2013-06-27,320000,15000,1823,8.228195282501371
"120 GREENWICH STREET, 2E",2006-11-22,623169,2014-07-02,646000,22831,2779,8.215545160129542
"635 WEST 42ND   STREET, 4C",2009-05-13,677136,2013-09-04,690000,12864,1575,8.167619047619048
"404 EAST 76 STREET, 5B",2004-06-17,670000,2006-02-21,675000,5000,614,8.143322475570033
"380 RECTOR PLACE, 4B",2006-10-26,1100000,2015-05-06,1125000,25000,3114,8.028259473346179
"200 CHAMBERS STREET, 4F",2007-02-22,952063,2011-08-05,965000,12937,1625,7.961230769230769
"21 SOUTH WILLIAM STREET, 7C",2006-05-11,628260,2013-11-01,650000,21740,2731,7.960454046136946
"211 EAST 46TH   STREET, 8H",2008-05-06,659744,2011-07-26,669000,9256,1176,7.870748299319728
"300 ALBANY STREET, 7C",2004-08-11,305000,2011-08-25,325000,20000,2570,7.782101167315175
"1600 BROADWAY, 14A",2006-08-09,865512,2009-12-11,875000,9488,1220,7.777049180327869
"220 RIVERSIDE BOULEVARD, 15R",2005-07-11,860000,2010-11-01,875000,15000,1939,7.735946364105209
"133 ESSEX STREET, 502",2006-12-01,683245,2011-02-18,695000,11755,1540,7.633116883116883
"231 EAST 55TH   STREET, 38C",2008-01-31,1181170,2014-12-05,1200000,18830,2500,7.532
"401 EAST 84TH   STREET, 24A",2010-06-30,2550000,2016-11-29,2567500,17500,2344,7.465870307167235
"425 5 AVENUE, 48C",2008-04-29,775000,2015-11-13,795500,20500,2754,7.443718228031954
"1601 3 AVENUE, SU-B25",2003-02-20,19266,2007-11-06,32000,12734,1720,7.403488372093023
"109 NORFOLK STREET, 4",2007-08-29,1451006,2012-11-13,1465000,13994,1903,7.353652128218602
"55 EAST 93RD STREET, 1D",2005-02-23,533100,2011-06-21,550000,16900,2309,7.3191857947163275
"40 WEST 116 STREET, A117",2008-08-26,552200,2013-06-19,565000,12800,1758,7.281001137656427
"170 WEST 23RD STREET, 2P",2008-08-26,585000,2012-06-05,595000,10000,1379,7.25163161711385
"45 PARK AVENUE, 303",2008-01-15,1832850,2010-09-29,1840000,7150,988,7.2368421052631575
"310 EAST 53RD STREET, 15C",2006-10-06,3319495,2010-09-28,3330000,10505,1453,7.229869236063317
"2132 SECOND AVENUE, 6E",2006-10-26,417560,2017-05-05,445000,27440,3844,7.138397502601457
"230 RIVERSIDE DRIVE, 9P",2008-06-30,257000,2013-06-27,270000,13000,1823,7.131102578167855
"230 RIVERSIDE DRIVE, 4C",2008-06-30,307000,2013-06-27,320000,13000,1823,7.131102578167855
"230 RIVERSIDE DRIVE, 2P",2008-06-30,237000,2013-06-27,250000,13000,1823,7.131102578167855
"230 RIVERSIDE DRIVE, 2M",2008-06-30,137000,2013-06-27,150000,13000,1823,7.131102578167855
"350 EAST 82ND   STREET, 7Z",2007-05-01,1074253,2013-05-24,1090000,15747,2215,7.109255079006772
"100 UNITED NATIONS PLAZA, 25G",2006-03-20,1381050,2013-08-08,1400000,18950,2698,7.0237212750185325
"184 THOMPSON STREET, 5M",2007-06-22,789143,2011-09-15,800000,10857,1546,7.022639068564036
"350 WEST 50TH STREET, 3II",2006-02-24,456300,2011-07-14,470000,13700,1966,6.9684638860630725
"421 EAST 13TH   STREET, 5N",2008-05-01,804417,2014-06-30,820000,15583,2251,6.922701021768103
"420 WEST 25TH   STREET, 1D",2008-05-15,610950,2011-02-28,618000,7050,1019,6.918547595682041
"184 THOMPSON STREET, 4U",2014-01-24,675000,2016-01-19,680000,5000,725,6.896551724137931
"60 EAST 55TH   STREET, 19C",2007-09-25,758596,2018-03-22,785000,26404,3831,6.892195249282172
"158 HESTER STREET, 2J",2007-08-13,656771,2012-03-07,668000,11229,1668,6.732014388489208
"10 WEST END AVENUE, 5C",2007-07-11,786089,2011-02-25,795000,8911,1325,6.725283018867924
"230 RIVERSIDE DRIVE, 9F",2008-06-30,425000,2012-07-31,435000,10000,1492,6.702412868632708
"635 WEST 42ND   STREET, 18M",2008-11-10,834965,2015-01-30,850000,15035,2272,6.617517605633803
"230 RIVERSIDE DRIVE, 7F",2008-06-30,148000,2013-06-27,160000,12000,1823,6.582556226001097
"20 PINE STREET, 708",2008-11-18,1237173,2014-08-21,1251000,13827,2102,6.57802093244529
"199 BOWERY, 11D",2006-07-06,941881,2012-01-19,955000,13119,2023,6.484923381117153
"310 EAST HOUSTON STREET, 3A",2007-07-05,738231,2012-07-31,750000,11769,1853,6.351322180248246
"101 WARREN STREET, 1290",2008-08-28,1893945,2011-04-28,1900000,6055,973,6.223021582733813
"120 RIVERSIDE BOULEVARD, 12H",2006-02-14,871947,2009-09-14,880000,8053,1308,6.1567278287461775
"225 WEST 83RD STREET, 10H",2006-06-26,800000,2008-09-23,805000,5000,820,6.097560975609756
"200 CHAMBERS STREET, 9F",2007-04-24,963264,2012-08-09,975000,11736,1934,6.068252326783868
"1601 3 AVENUE, SU-A19",2003-03-18,22088,2006-10-12,30000,7912,1304,6.067484662576687
"230 RIVERSIDE DRIVE, 5C",2008-06-30,309000,2013-06-27,320000,11000,1823,6.034009873834339
"15 BROAD STREET, 3610",2007-05-09,2570473,2013-03-26,2583300,12827,2148,5.971601489757914
"230 RIVERSIDE DRIVE, 19J",2007-08-28,534581,2012-06-13,545000,10419,1751,5.950314106225014
"400 EAST 90TH   STREET, 23A",2008-02-06,1237173,2014-01-17,1250000,12827,2172,5.90561694290976
"165 ELIZABETH STREET, 3R",2003-07-18,260000,2016-08-04,288000,28000,4766,5.874947545111205
"80 RIVERSIDE BOULEVARD, 5P",2010-03-22,1883762,2017-11-16,1900000,16238,2796,5.80758226037196
"49 EAST 21ST STREET, 10B",2008-06-18,1590000,2010-10-29,1595000,5000,863,5.793742757821553
"250 SOUTH END AVENUE, 3C",2005-09-26,360000,2013-11-04,377100,17100,2961,5.775075987841945
"240 EAST 10TH   STREET, 7C",2007-08-23,1944857,2012-06-22,1955000,10143,1765,5.746742209631728
"66 LEONARD STREET, 11A",2003-10-15,1937500,2014-07-29,1960000,22500,3940,5.710659898477157
"1601 3 AVENUE, SUB33",2003-02-20,20280,2008-10-10,32000,11720,2059,5.69208353569694
"100 RIVERSIDE BOULEVARD, 8B",2008-04-02,899055,2013-07-15,910000,10945,1930,5.670984455958549
"10 WEST END AVENUE, 6C",2007-07-11,796271,2011-11-10,805000,8729,1583,5.514213518635502
"230 RIVERSIDE DRIVE, 9J",2008-06-30,150000,2013-06-27,160000,10000,1823,5.485463521667581
"120 GREENWICH STREET, 3B",2006-06-28,534581,2014-03-20,550000,15419,2822,5.463855421686747
"220 RIVERSIDE BOULEVARD, 7S",2007-06-06,885000,2014-12-29,900000,15000,2763,5.4288816503800215
"212 EAST 70TH STREET, 2B",2007-11-01,400530,2012-08-24,410000,9470,1758,5.386803185437998
"206 EAST 95TH STREET, 16B",2007-10-23,1120075,2015-06-02,1135000,14925,2779,5.370636919755308
"1845 ADAM C POWELL BLVD, A4B",2010-11-30,967337,2012-04-09,970000,2663,496,5.368951612903226
"245 EAST 93RD   STREET, 22B",2007-09-17,680000,2012-10-24,690000,10000,1864,5.364806866952789
"2132 SECOND AVENUE, 4E",2007-01-23,355305,2014-08-04,370000,14695,2750,5.343636363636364
"321 5 AVENUE, S88",2007-02-13,18826,2007-09-21,20000,1174,220,5.336363636363636
"205 EAST 59TH STREET, 8A",2005-08-25,1435000,2013-05-09,1450000,15000,2814,5.330490405117271
"40 SUTTON PLACE, 2J",2003-11-14,384000,2012-02-15,400000,16000,3015,5.306799336650083
"333 WEST 56TH STREET, 2B",2007-02-07,750000,2012-04-20,760000,10000,1899,5.265929436545551
"20 WEST STREET, PH-C",2006-07-18,712775,2018-08-17,736000,23225,4413,5.262859732608203
"200 RIVERSIDE BOULEVARD, 304",2007-04-16,1165000,2012-07-06,1175000,10000,1908,5.241090146750524
"255 EAST 74TH STREET, 6G",2008-11-12,1369546,2011-09-22,1375000,5454,1044,5.224137931034483
"148 MADISON STREET, 4C",2003-07-31,303186,2015-07-29,326000,22814,4381,5.207486875142662
"340 EAST 23RD STREET, 11J",2008-03-11,534581,2012-02-13,542025,7444,1434,5.191073919107392
"1 IRVING PLACE, P17D",2006-02-28,845000,2011-06-10,855000,10000,1928,5.186721991701245
"340 CABRINI BOULEVARD, 202",2004-06-15,304200,2014-04-22,322500,18300,3598,5.086158977209561
"60 HENRY STREET, 3C1",2007-03-13,435000,2008-10-24,438000,3000,591,5.0761421319796955
"250 SOUTH END AVENUE, 10G",2004-08-05,410000,2009-12-29,420000,10000,1972,5.070993914807302
"250 EAST 30TH STREET, 9E",2007-05-14,517000,2014-06-06,530000,13000,2580,5.038759689922481
"10 WEST END AVENUE, 10J",2007-08-29,689049,2010-11-30,695000,5951,1189,5.005046257359125
"350 EAST 82ND   STREET, 10F",2007-05-18,488241,2011-02-01,495000,6759,1355,4.988191881918819
"130 SUFFOLK STREET, 148-A",2007-07-20,833000,2011-12-22,841000,8000,1616,4.9504950495049505
"230 RIVERSIDE DRIVE, 3H",2008-06-30,281000,2013-06-27,290000,9000,1823,4.9369171695008225
"230 RIVERSIDE DRIVE, 2A",2008-06-30,481000,2013-06-27,490000,9000,1823,4.9369171695008225
"230 RIVERSIDE DRIVE, 18L",2008-06-30,181000,2013-06-27,190000,9000,1823,4.9369171695008225
"350 WEST 42ND STREET, 16A",2006-06-22,759614,2012-04-19,770000,10386,2128,4.8806390977443606
"515 EAST 72ND   STREET, 30J",2008-12-11,916425,2015-06-18,928000,11575,2380,4.86344537815126
"377 RECTOR PLACE, 14A",2007-10-25,762500,2014-05-06,774000,11500,2385,4.821802935010482
"200 RIVERSIDE BOULEVARD, 5F",2006-06-15,714000,2012-09-14,725000,11000,2283,4.818221638195357
"270 BROADWAY, 16A",2006-10-31,2975000,2018-04-25,2995000,20000,4194,4.768717215069146
"393 WEST 49TH   STREET, 2KK",2008-03-31,485000,2016-11-14,500000,15000,3150,4.761904761904762
"184 THOMPSON STREET, 3O",2007-08-03,492000,2011-12-29,499500,7500,1609,4.661280298321939
"60 EAST 55TH   STREET, 18C",2006-12-19,738231,2013-12-05,750000,11769,2543,4.62799842705466
"80 JOHN STREET, 7A",2007-03-15,577347,2013-07-16,588000,10653,2315,4.601727861771058
"320 EAST 54TH STREET, 8H",2008-02-01,520000,2014-01-15,530000,10000,2175,4.597701149425287
"100 WEST 58TH STREET, 5B",2006-12-27,2006257,2018-06-21,2025000,18743,4194,4.46900333810205
"184 THOMPSON STREET, 6K",2007-06-22,855330,2012-10-17,864000,8670,1944,4.459876543209877
"225 EAST 34TH   STREET, 20B",2008-05-16,1603743,2012-04-05,1610000,6257,1420,4.406338028169014
"515 EAST 72ND STREET, 40A",2014-09-05,2596537,2016-11-01,2600000,3463,788,4.394670050761421
"230 RIVERSIDE DRIVE, 7N",2008-06-30,252000,2013-06-27,260000,8000,1823,4.3883708173340645
"230 RIVERSIDE DRIVE, 7H",2008-06-30,292000,2013-06-27,300000,8000,1823,4.3883708173340645
"230 RIVERSIDE DRIVE, 11M",2008-06-29,152000,2013-06-27,160000,8000,1824,4.385964912280702
"20 WEST STREET, 32D",2006-04-28,661862,2012-08-29,672000,10138,2315,4.3792656587473004
"300 EAST 62ND   STREET, 603",2007-01-05,445000,2013-05-16,455000,10000,2323,4.304778303917348
"392 CENTRAL PARK WEST, 18W",2007-05-11,865512,2013-06-07,875000,9488,2219,4.275799909869311
"220 EAST 65TH STREET, 22J",2006-08-18,755000,2009-11-11,760000,5000,1181,4.233700254022016
"186 WEST 80TH STREET, 4E",2007-07-13,445000,2012-06-15,452500,7500,1799,4.168982768204558
"421 EAST 13TH   STREET, 5C",2008-01-22,1303360,2012-06-08,1310000,6640,1599,4.152595372107567
"435 EAST 76TH   STREET, PHB",2007-10-15,3035000,2017-09-15,3050000,15000,3623,4.140215291195142
"415 MAIN STREET, 14-H",2009-09-24,707683,2011-04-12,710000,2317,565,4.100884955752212
"82 BEAVER STREET, 1204",2006-12-14,509125,2010-12-03,515000,5875,1450,4.051724137931035
"350 WEST 42ND STREET, 21G",2006-07-11,1084436,2010-05-05,1090000,5564,1394,3.9913916786226684
"464 WEST 44TH   STREET, 4E",2008-02-21,741275,2013-06-10,749000,7725,1936,3.990185950413223
"420 CENTRAL PARK WEST, 2J",2005-05-10,565000,2008-10-15,570000,5000,1254,3.9872408293460926
"571 ACADEMY STREET, GLB",2005-06-09,155000,2015-10-15,170000,15000,3780,3.9682539682539684
"230 RIVERSIDE DRIVE, 10O",2008-06-30,253000,2013-06-27,260000,7000,1823,3.8398244651673066
"82 BEAVER STREET, 1201",2007-04-12,998903,2013-11-08,1008000,9097,2402,3.7872606161532056
"82 BEAVER STREET, 1401",2007-05-04,988720,2011-12-05,995000,6280,1676,3.747016706443914
"80 JOHN STREET, 18D",2007-12-11,1036579,2017-10-03,1050000,13421,3584,3.7446986607142856
"40 BROAD STREET, 20FG",2009-08-26,1629200,2017-08-08,1640000,10800,2904,3.71900826446281
"273 WATER STREET, 3R",2005-04-29,1089527,2013-02-21,1100000,10473,2855,3.6683012259194396
"420 WEST 25TH   STREET, 7F",2008-02-15,992793,2012-10-19,999000,6207,1708,3.6340749414519906
"15 BROAD STREET, 2926",2006-12-29,1466280,2013-07-26,1475000,8720,2401,3.631820074968763
"120 GREENWICH STREET, 7C",2006-12-01,743322,2013-10-25,752400,9078,2520,3.6023809523809525
"420 EAST 58TH   STREET, 7B",2007-08-24,1030000,2011-06-14,1035000,5000,1390,3.597122302158273
"111 FULTON STREET, 412",2008-11-19,845147,2012-07-31,850000,4853,1350,3.5948148148148147
"2770 BROADWAY, 9A",2005-01-14,1832850,2006-09-14,1835000,2150,608,3.536184210526316
"161 WEST 61 STREET, 33E",2006-11-07,995000,2010-07-13,999750,4750,1344,3.5342261904761907
"555 WEST 59TH STREET, 7E",2008-03-06,910315,2011-10-27,915000,4685,1330,3.5225563909774436
"1760 SECOND AVENUE, 11A",2005-08-15,710000,2013-08-02,720000,10000,2909,3.4376074252320383
"635 WEST 42ND   STREET, 42G",2008-06-20,941881,2013-05-30,948000,6119,1805,3.390027700831025
"71 NASSAU STREET, PHB",2006-10-25,692410,2013-01-23,700000,7590,2282,3.3260297984224363
"101 ALLEN STREET, 5B",2009-09-29,320000,2018-01-12,330000,10000,3027,3.303600925008259
"230 RIVERSIDE DRIVE, 3N",2008-06-30,244000,2013-06-27,250000,6000,1823,3.2912781130005486
"230 RIVERSIDE DRIVE, 19C",2008-06-30,194000,2013-06-27,200000,6000,1823,3.2912781130005486
"230 RIVERSIDE DRIVE, 16K",2008-06-30,274000,2013-06-27,280000,6000,1823,3.2912781130005486
"230 RIVERSIDE DRIVE, 15K",2008-06-30,274000,2013-06-27,280000,6000,1823,3.2912781130005486
"215 WEST 88TH STREET, 6C",2014-04-09,2295000,2018-06-28,2300000,5000,1541,3.244646333549643
"230 RIVERSIDE DRIVE, 18N",2007-09-10,486720,2014-10-29,495000,8280,2606,3.177283192632387
"310 WEST 52ND STREET, 25B",2007-07-03,1705568,2009-09-10,1708000,2432,800,3.04
"237 EAST 88TH STREET, 402",2007-08-29,395460,2011-10-11,400000,4540,1504,3.018617021276596
"635 WEST 42ND STREET, 23E",2007-07-13,1237173,2016-06-16,1247000,9827,3261,3.0134927936215883
"455 MAIN STREET, 14N",2006-04-20,410670,2010-04-08,415000,4330,1449,2.9882677708764667
"1212 5 AVENUE, 9C",2013-03-05,992793,2018-01-24,998000,5207,1786,2.91545352743561
"20 WEST STREET, 30G",2007-04-03,765000,2016-12-28,775000,10000,3557,2.81135788585887
"393 WEST 49TH STREET, 6N",2005-01-06,793000,2010-11-17,799000,6000,2141,2.802428771602055
"275 WEST 96TH STREET, 19F",2008-08-07,1115000,2013-07-12,1120000,5000,1800,2.7777777777777777
"105 WEST 77TH STREET, 1A",2007-09-12,743000,2014-08-22,750000,7000,2536,2.7602523659305995
"230 RIVERSIDE DRIVE, 4H",2008-06-30,285000,2013-06-27,290000,5000,1823,2.7427317608337907
"230 RIVERSIDE DRIVE, 16H",2008-06-30,315000,2013-06-27,320000,5000,1823,2.7427317608337907
"505 GREENWICH STREET, 8G",2005-01-06,672045,2013-03-08,680200,8155,2983,2.733825008380825
"310 WEST 52ND   STREET, 28C",2007-06-22,985156,2012-05-08,990000,4844,1782,2.718294051627385
"350 WEST 50TH STREET, 3W",2006-06-29,555000,2011-09-01,560000,5000,1890,2.6455026455026456
"393 WEST 49TH   STREET, 3BB",2008-04-29,470000,2013-07-10,475000,5000,1898,2.6343519494204424
"340 WEST 57TH STREET, 6E",2005-12-22,570000,2011-04-13,575000,5000,1938,2.579979360165119
"100 RIVERSIDE BOULEVARD, 16A",2008-05-28,1109892,2013-12-04,1115000,5108,2016,2.5337301587301586
"22 RIVERSIDE DRIVE, 1B",2007-09-20,992793,2012-06-01,997000,4207,1716,2.4516317016317015
"157 HUDSON STREET, 1B",2012-04-13,1231148,2012-08-15,1231452,304,124,2.4516129032258065
"120 GREENWICH STREET, PHC",2007-03-12,707683,2015-06-03,715000,7317,3005,2.4349417637271213
"635 WEST 42ND STREET, 45E",2007-09-11,1446170,2012-06-04,1450000,3830,1728,2.216435185185185
"56 PINE STREET, 10E",2005-09-07,375180,2011-08-26,380000,4820,2179,2.2120238641578704
"230 RIVERSIDE DRIVE, 4N",2008-06-30,246000,2013-06-27,250000,4000,1823,2.1941854086670323
"130 WATER STREET, 9A",2008-08-05,615000,2014-11-25,620000,5000,2303,2.1710811984368217
"235 EAST 40TH STREET, 11J",2004-12-03,380000,2011-04-29,385000,5000,2338,2.1385799828913603
"350 EAST 82ND STREET, 5N",2007-10-15,763687,2015-11-23,770000,6313,2961,2.132049983113813
"400 EAST 90TH   STREET, 5A",2007-06-25,420810,2012-11-16,425000,4190,1971,2.125824454591578
"11 EAST 36TH   STREET, 1106",2008-02-06,1344090,2015-09-30,1350000,5910,2793,2.1160042964554244
"80 JOHN STREET, 11I",2007-05-30,779164,2011-03-06,782000,2836,1376,2.061046511627907
"581 ACADEMY STREET, 5B",2008-07-29,325000,2012-08-13,328000,3000,1476,2.032520325203252
"170 EAST END AVENUE, 11D",2008-11-18,3818437,2017-11-14,3825000,6563,3283,1.999086201644837
"524 EAST 72ND STREET, 37G",2005-11-07,525000,2012-11-07,530000,5000,2557,1.9554165037152913
"407 EAST 12TH STREET, 1FNW",2008-07-03,1095000,2015-07-06,1100000,5000,2559,1.9538882375928097
"225 EAST 34TH STREET, 12C",2007-11-08,1445915,2013-12-16,1450000,4085,2230,1.8318385650224216
"160 CENTRAL PARK SOUTH, 1160",2010-05-27,925000,2018-01-19,930000,5000,2794,1.7895490336435218
"240 RIVERSIDE BOULEVARD, 4 E",2008-02-29,1340000,2015-11-09,1345000,5000,2810,1.7793594306049823
"220 RIVERSIDE BOULEVARD, 4D",2007-04-09,795000,2013-07-19,799000,4000,2293,1.7444395987788923
"90 WILLIAM STREET, 2D",2008-09-11,637424,2013-01-10,640000,2576,1582,1.6283185840707965
"250 SOUTH END AVENUE, 10H",2004-09-28,395000,2013-03-28,400000,5000,3103,1.6113438607798904
"99 BATTERY PLACE, 16-A",2005-10-24,523000,2018-06-15,530250,7250,4617,1.5702837340264242
"310 EAST 53RD STREET, 2/3D",2006-12-06,1789778,2016-04-14,1795000,5222,3417,1.5282411472051507
"68 BRADHURST AVENUE, 7-G",2007-08-09,362647,2012-01-17,365000,2353,1622,1.4506781750924784
"120 RIVERSIDE BOULEVARD, 12V",2006-02-01,758596,2008-09-30,760000,1404,972,1.4444444444444444
"20 WEST STREET, PH-E",2007-03-26,461370,2017-11-30,467000,5630,3902,1.4428498206048181
"75 WALL STREET, 31C",2009-07-15,1705568,2018-02-16,1710000,4432,3138,1.4123645634161885
"220 RIVERSIDE BOULEVARD, 4E",2005-11-04,846000,2013-08-26,850000,4000,2852,1.402524544179523
"350 WEST 42ND STREET, 4J",2008-05-28,1345000,2018-07-02,1350000,5000,3687,1.3561160835367507
"253 WEST 73RD STREET, 1F",2004-08-10,370000,2015-08-04,375000,5000,4011,1.2465719272001994
"20 WEST STREET, 43E",2007-05-31,456300,2013-08-14,459000,2700,2267,1.1910013233348038
"581 ACADEMY STREET, 5G",2007-02-07,310000,2016-12-01,314000,4000,3585,1.1157601115760112
"21 SOUTH END AVENUE, 209",2005-06-02,2495000,2017-11-15,2500000,5000,4549,1.0991426687183996
"230 RIVERSIDE DRIVE, 6A",2008-06-30,488000,2013-06-27,490000,2000,1823,1.0970927043335161
"230 RIVERSIDE DRIVE, 3L",2008-06-30,318000,2013-06-27,320000,2000,1823,1.0970927043335161
"345 EAST 80TH   STREET, 5J",2007-05-16,767500,2013-11-06,770000,2500,2366,1.0566356720202874
"350 WEST 50TH   STREET, 2HH",2008-05-05,549000,2010-12-15,550000,1000,954,1.0482180293501049
"324 EAST 112TH STREET, 5C",2005-11-07,436020,2014-06-20,439000,2980,3147,0.9469335875436924
"55 WALL STREET, 726",2013-07-30,963870,2016-11-18,965000,1130,1207,0.9362054681027341
"134 EAST 93RD STREET, PH15B",2007-06-28,3247500,2014-10-20,3250000,2500,2671,0.9359790340696369
"235 WEST END AVENUE, 6G",2005-01-03,599000,2011-07-14,601000,2000,2383,0.839278220730172
"247 WEST 46TH   STREET, 304",2008-09-22,753505,2013-08-29,755000,1495,1802,0.8296337402885683
"333 WEST 56TH STREET, 5J",2005-06-23,483875,2009-11-25,485000,1125,1616,0.6961633663366337
"421 WEST 54TH   STREET, 3F",2008-06-26,998000,2012-12-18,999000,1000,1636,0.6112469437652812
"230 RIVERSIDE DRIVE, 7L",2008-06-30,329000,2013-06-27,330000,1000,1823,0.5485463521667581
"230 RIVERSIDE DRIVE, 5H",2008-06-30,289000,2013-06-27,290000,1000,1823,0.5485463521667581
"230 RIVERSIDE DRIVE, 15CC",2008-06-30,179000,2013-06-27,180000,1000,1823,0.5485463521667581
"230 RIVERSIDE DRIVE, 14L",2008-06-30,189000,2013-06-27,190000,1000,1823,0.5485463521667581
"350 WEST 57TH   STREET, 10E",2006-12-11,580000,2018-06-07,582250,2250,4196,0.5362249761677789
"100 RIVERSIDE BOULEVARD, 6J",2008-02-14,997885,2016-12-21,999500,1615,3233,0.49953603464274665
"101 ALLEN STREET, 4D",2004-02-24,83500,2013-04-02,85000,1500,3325,0.45112781954887216
"200 WEST 109 STREET, C7",2008-09-11,649000,2015-06-01,650000,1000,2454,0.40749796251018744
"635 WEST 42ND STREET, 41B",2007-07-23,1264666,2010-02-16,1265000,334,939,0.3556975505857295
"300 CATHEDRAL PARKWAY, 1J",2005-05-20,429000,2013-09-27,430000,1000,3052,0.32765399737876805
"154 ATTORNEY STREET, 101",2006-12-22,674476,2012-10-25,675000,524,2134,0.24554826616682288
"456 WEST 167 STREET, 7A",2015-04-24,824782,2018-07-03,825000,218,1166,0.18696397941680962
"100 RIVERSIDE BOULEVARD, 5B",2008-02-28,834965,2013-06-10,835000,35,1929,0.018144116122343183
"7 EAST 17TH   STREET, 7C",2008-12-29,385482,2009-09-29,385483,1,274,0.0036496350364963502
"330 EAST 75TH STREET, 36A",2015-06-30,2500000,2018-07-12,2500001,1,1108,0.0009025270758122744
"88 GREENWICH STREET, 1810",2010-08-09,820000,2014-04-10,820000,0,1340,0.0
"79 LAIGHT STREET, 5E",2006-04-10,2800000,2008-12-10,2800000,0,975,0.0
"75 WALL STREET, 31N",2010-08-19,980000,2013-12-10,980000,0,1209,0.0
"55 EAST 93 STREET, 4A",2003-03-28,660000,2004-03-28,660000,0,366,0.0
"525 PARK AVENUE, 9B",2010-06-17,2400000,2011-06-13,2400000,0,361,0.0
"524 EAST 72 STREET, 26E",2003-09-12,495000,2004-03-05,495000,0,175,0.0
"50 BAYARD STREET, 7T",2008-01-24,350000,2013-06-25,350000,0,1979,0.0
"48 MARKET STREET, 2B",2004-02-24,139000,2007-09-17,139000,0,1301,0.0
"453 WEST 143 STREET, A",2007-10-12,365000,2014-04-29,365000,0,2391,0.0
"44 EAST 67TH STREET, 7E",2012-07-09,1405000,2013-06-10,1405000,0,336,0.0
"421 HUDSON STREET, 604",2009-05-28,1025000,2013-03-28,1025000,0,1400,0.0
"418 CENTRAL PARK WEST, 88",2009-02-10,350000,2011-01-20,350000,0,709,0.0
"418 CENTRAL PARK WEST, 37",2011-02-22,200000,2011-11-21,200000,0,272,0.0
"415 EAST 37TH STREET, 14C",2007-04-25,765000,2014-06-16,765000,0,2609,0.0
"411 EAST 53RD   STREET, 10C",2008-09-10,870000,2011-07-26,870000,0,1049,0.0
"400 EAST 70TH   STREET, 2201",2017-10-26,250000,2018-05-10,250000,0,196,0.0
"350 WEST 50 STREET, 5BB",2003-12-30,265000,2004-05-07,265000,0,129,0.0
"345 EAST 80TH STREET, 30K",2014-12-12,875000,2015-09-24,875000,0,286,0.0
"340 EAST 64 STREET, 9E",2003-04-10,600000,2004-12-14,600000,0,614,0.0
"330 EAST 38 STREET, 34L",2005-03-22,950000,2006-05-10,950000,0,414,0.0
"330 EAST 33RD   STREET, 18-K",2007-08-01,650000,2008-01-28,650000,0,180,0.0
"306 EAST 105 STREET, 1B",2006-06-12,500000,2008-04-09,500000,0,667,0.0
"305 CHERRY STREET, G1",2008-06-24,499990,2009-09-10,499990,0,443,0.0
"300 EAST 93RD   STREET, 8A",2007-09-12,1200000,2010-08-16,1200000,0,1069,0.0
"300 EAST 93RD   STREET, 34C",2008-05-06,800000,2014-08-05,800000,0,2282,0.0
"254 PARK AVENUE SOUTH, 6A",2016-04-22,1475000,2018-06-28,1475000,0,797,0.0
"250 SOUTH END AVENUE, 3D",2005-06-22,475000,2013-12-13,475000,0,3096,0.0
"25 NORTH MOORE STREET, SU15",2007-07-16,65000,2009-09-14,65000,0,791,0.0
"25 CENTRAL PARK WEST, 20G",2005-10-17,225476,2006-10-17,225476,0,365,0.0
"245 EAST 93 STREET, 12F",2007-04-20,650000,2012-06-19,650000,0,1887,0.0
"220, 7F",2003-12-15,540000,2004-06-08,540000,0,176,0.0
"220 RIVERSIDE BOULEVARD, 18A",2006-08-07,1050000,2012-10-18,1050000,0,2264,0.0
"22 WEST 15TH   STREET, 17A",2010-08-11,720000,2016-11-30,720000,0,2303,0.0
"215 EAST 80TH   STREET, PHJ",2012-07-18,828750,2018-02-02,828750,0,2025,0.0
"2101 BROADWAY, 7-131",2006-05-25,1250000,2008-05-22,1250000,0,728,0.0
"210-14 COLUMBUS AVENUE, 6F",2003-10-13,375000,2004-01-22,375000,0,101,0.0
"210 COLUMBUS AVENUE, 3H",2005-01-03,700000,2005-09-12,700000,0,252,0.0
"209 EAST 51ST   STREET, 3F",2016-05-05,1250000,2017-06-22,1250000,0,413,0.0
"207 EAST 57TH STREET, 9A10A",2013-09-13,1900000,2018-04-05,1900000,0,1665,0.0
"205 EAST 59TH STREET, 20B",2012-06-28,1725000,2017-05-25,1725000,0,1792,0.0
"201 EAST 80TH STREET, 6F",2014-06-03,1200000,2018-06-14,1200000,0,1472,0.0
"200 RIVERSIDE BOULEVARD, 7C",2005-09-07,990000,2009-08-04,990000,0,1427,0.0
"2 EAST 55TH   STREET, 935",2006-12-05,501930,2007-04-24,501930,0,140,0.0
"2 EAST 55TH   STREET, 807",2006-12-12,319410,2007-04-06,319410,0,115,0.0
"1965 BROADWAY, 29C",2005-12-29,2150000,2010-08-02,2150000,0,1677,0.0
"1760 2 AVENUE, 9D",2008-08-01,755000,2011-09-20,755000,0,1145,0.0
"170 EAST 87TH STREET, W8A",2006-01-31,2139000,2018-02-27,2139000,0,4410,0.0
"170 EAST 87TH STREET, W10F",2010-11-12,650000,2011-02-16,650000,0,96,0.0
"164 PEARL STREET, 11B",2005-11-16,525000,2011-09-15,525000,0,2129,0.0
"160 WEST 86TH STREET, 6B",2015-03-18,1800000,2016-11-09,1800000,0,602,0.0
"148 MADISON STREET, 9B",2003-10-14,304200,2013-09-04,304200,0,3613,0.0
"146 WEST 57TH STREET, 34A",2008-05-06,2150000,2010-10-13,2150000,0,890,0.0
"135 DIVISION STREET, 4A",2003-09-09,370000,2004-06-29,370000,0,294,0.0
"125 WEST 21ST   STREET, 4C",2009-10-28,399000,2010-05-27,399000,0,211,0.0
"116 WEST 22ND STREET, 5",2013-08-27,2150000,2018-08-28,2150000,0,1827,0.0
"11 PRINCE STREET, 6B",2003-10-29,850000,2005-09-09,850000,0,681,0.0
"106 CENTRAL PARK SOUTH, 41003",2007-07-12,40000,2010-12-23,40000,0,1260,0.0
"106 CENTRAL PARK SOUTH, 14M",2005-02-28,460000,2011-10-11,460000,0,2416,0.0
"100 UNITED NATIONS PLAZA, 45C",2006-04-26,2750000,2010-04-20,2750000,0,1455,0.0
"100 UNITED NATIONS PLAZA, 23G",2006-06-21,1475000,2013-08-01,1475000,0,2598,0.0
"100 UNITED NATIONS PLAZA, 18A",2007-03-01,1200000,2009-08-19,1200000,0,902,0.0
"10 WEST STREET, 16C",2005-02-13,1650000,2006-02-13,1650000,0,365,0.0
"109 NORFOLK STREET, 3",2007-08-29,1400093,2011-10-19,1400000,-93,1512,-0.061507936507936505
"35 WEST 15TH   STREET, 10E",2015-06-29,1955040,2016-04-01,1955000,-40,277,-0.1444043321299639
"170 EAST END AVENUE, STUO9",2008-01-03,661970,2009-10-08,661862,-108,644,-0.16770186335403728
"321 5 AVENUE, S52",2007-02-06,22590,2008-07-09,22500,-90,519,-0.17341040462427745
"400 EAST 67TH   STREET, 11E",2009-04-16,1985587,2018-01-17,1985000,-587,3198,-0.183552220137586
"515 EAST 72ND   STREET, 25J",2009-01-09,982611,2016-07-15,982000,-611,2744,-0.222667638483965
"464 WEST 44TH   STREET, 3D",2008-02-22,700545,2013-10-16,700000,-545,2063,-0.2641783809985458
"100 RIVERSIDE BOULEVARD, 6F",2008-02-05,2151053,2018-04-24,2150000,-1053,3731,-0.28222996515679444
"10 WEST END AVENUE, 29C",2007-09-18,1770736,2013-08-13,1770000,-736,2156,-0.34137291280148424
"350 EAST 82ND   STREET, 16D",2007-02-13,2291062,2015-08-03,2290000,-1062,3093,-0.3433559650824442
"324 PEARL STREET, 1K",2008-01-25,1500000,2013-07-18,1499000,-1000,2001,-0.49975012493753124
"111 FULTON STREET, 322",2008-11-17,595676,2012-06-01,595000,-676,1292,-0.5232198142414861
"230 RIVERSIDE DRIVE, 16C",2008-06-30,181000,2013-06-27,180000,-1000,1823,-0.5485463521667581
"50 WEST 127TH STREET, 5D",2007-09-21,791180,2012-12-06,790000,-1180,1903,-0.6200735680504467
"25 COLUMBUS CIRCLE, SU-23",2005-12-29,112085,2014-09-29,110000,-2085,3196,-0.6523779724655819
"455 EAST 86TH STREET, 7E",2008-01-15,469000,2014-09-05,467393,-1607,2425,-0.6626804123711341
"400 EAST 90TH   STREET, 10A",2008-09-16,626223,2013-06-26,625000,-1223,1744,-0.7012614678899083
"130 WEST 19TH   STREET, 9F",2007-06-22,1476462,2012-04-19,1475000,-1462,1763,-0.8292682926829268
"5 EAST 22ND STREET, 26B",2005-01-12,636406,2009-07-30,635000,-1406,1660,-0.846987951807229
"350 WEST 42ND STREET, 33G",2006-09-08,1476462,2011-04-25,1475000,-1462,1690,-0.8650887573964497
"200 RECTOR PLACE, 18G",2006-02-17,638000,2011-10-06,636000,-2000,2057,-0.9722897423432183
"306 EAST 105 STREET, 1A",2004-06-25,165000,2012-08-29,162078,-2922,2987,-0.9782390358218949
"340 EAST 23RD STREET, 15K",2008-03-21,911333,2011-11-22,910000,-1333,1341,-0.994034302759135
"252 7 AVENUE, 8Z",2007-08-22,995000,2012-12-31,993000,-2000,1958,-1.0214504596527068
"400 CENTRAL PARK WEST, 18K",2008-10-28,995000,2016-11-01,992000,-3000,2926,-1.0252904989747096
"230 RIVERSIDE DRIVE, 8A",2008-06-30,492000,2013-06-27,490000,-2000,1823,-1.0970927043335161
"230 RIVERSIDE DRIVE, 12K",2008-06-30,272000,2013-06-27,270000,-2000,1823,-1.0970927043335161
"20 WEST STREET, 5J",2008-07-21,999085,2018-05-17,995000,-4085,3587,-1.138834680791748
"18 WEST 48TH STREET, 28D",2007-08-01,1308451,2015-11-11,1305000,-3451,3024,-1.1412037037037037
"146 WEST 57TH STREET, 37F",2005-09-01,830000,2009-10-01,828278,-1722,1491,-1.1549295774647887
"421 EAST 13TH   STREET, 2E",2008-01-29,738231,2013-04-01,736000,-2231,1889,-1.181048173636845
"200 CHAMBERS STREET, 3C",2007-03-05,1751390,2010-04-16,1750000,-1390,1138,-1.2214411247803163
"400 EAST 90TH STREET, 15C",2008-06-30,471510,2013-12-18,469000,-2510,1997,-1.256885327991988
"15 WILLIAM STREET, 21G",2009-04-22,977520,2014-06-05,975000,-2520,1870,-1.3475935828877006
"165 CHARLES STREET, RSU18",2006-12-13,50709,2008-09-05,49800,-909,632,-1.4382911392405062
"230 RIVERSIDE DRIVE, 5K",2008-06-30,263000,2013-06-27,260000,-3000,1823,-1.6456390565002743
"400 EAST 90TH   STREET, 15B",2007-09-20,659360,2014-06-19,655000,-4360,2464,-1.7694805194805194
"255 EAST 49TH STREET, 16E",2008-01-17,995000,2012-08-30,992000,-3000,1687,-1.7783046828689981
"411 EAST 53RD   STREET, 11M",2011-05-13,801871,2014-02-26,800000,-1871,1020,-1.834313725490196
"15 WEST 53RD   STREET, 14J",2007-04-10,1672500,2018-02-27,1665000,-7500,3976,-1.886317907444668
"635 WEST 42ND STREET, 24D",2008-04-24,1293462,2013-04-19,1290000,-3462,1821,-1.901153212520593
"555 WEST 59TH STREET, 7A",2008-09-03,890968,2012-12-07,888000,-2968,1556,-1.9074550128534704
"1 IRVING PLACE, G19I",2006-03-06,580000,2013-03-21,575000,-5000,2572,-1.9440124416796267
"455 CENTRAL PARK WEST, 22B",2004-11-05,1680112,2012-01-13,1675000,-5112,2625,-1.9474285714285715
"415 EAST 37TH STREET, 34K",2007-01-04,770000,2013-12-27,765000,-5000,2549,-1.9615535504119261
"444 WEST 19TH   STREET, 402",2007-11-26,999000,2013-06-18,995000,-4000,2031,-1.9694731659281142
"421 EAST 13TH   STREET, 3C",2008-01-17,1282995,2011-12-20,1280000,-2995,1433,-2.0900209351011863
"246 WEST 17TH   STREET, 7C",2008-11-11,2138325,2013-01-14,2135000,-3325,1525,-2.180327868852459
"215 EAST 80TH STREET, 5M",2005-12-21,520000,2013-04-29,514000,-6000,2686,-2.2338049143708116
"310 EAST 53RD   STREET, 18A",2007-08-08,2805278,2013-12-19,2800000,-5278,2325,-2.2701075268817204
"425 FIFTH AVENUE, 30A",2007-06-01,955000,2013-02-27,950000,-5000,2098,-2.3832221163012393
"135 EAST 54TH   STREET, 11E",2008-07-29,916425,2010-03-05,915000,-1425,584,-2.440068493150685
"201 EAST 36TH STREET, 3D",2007-06-13,850000,2018-08-06,840000,-10000,4072,-2.4557956777996073
"15 WILLIAM STREET, 26F",2009-02-27,1089527,2013-12-27,1085000,-4527,1764,-2.566326530612245
"20 PINE STREET, 1803",2016-04-04,750774,2017-01-30,750000,-774,301,-2.5714285714285716
"635 WEST 42ND STREET, 9B",2007-09-12,806454,2014-07-02,800000,-6454,2485,-2.5971830985915494
"240 RIVERSIDE BOULEVARD, 14 P",2005-12-02,627750,2013-12-20,620000,-7750,2940,-2.6360544217687076
"230 RIVERSIDE DRIVE, 6K",2008-06-30,265000,2013-06-27,260000,-5000,1823,-2.7427317608337907
"230 RIVERSIDE DRIVE, 2L",2008-06-30,315000,2013-06-27,310000,-5000,1823,-2.7427317608337907
"161 WEST 61ST STREET, 24H",2007-12-28,800000,2012-11-09,795000,-5000,1778,-2.81214848143982
"20 WEST STREET, PH-D",2007-03-26,466440,2013-06-13,460000,-6440,2271,-2.8357551739321885
"310 EAST 53RD STREET, 2/3B",2006-12-05,2202474,2018-08-22,2190000,-12474,4278,-2.9158485273492287
"382 CENTRAL PARK WEST, 12L",2007-10-01,575000,2012-05-23,570000,-5000,1696,-2.94811320754717
"260 PARK AVENUE SOUTH, 4H",2008-02-19,2100000,2012-06-13,2095000,-5000,1576,-3.1725888324873095
"25 CENTRAL PARK WEST, 11D",2003-08-19,630000,2017-11-01,613500,-16500,5188,-3.1804163454124903
"230 RIVERSIDE DRIVE, 11C",2008-06-30,176000,2013-06-27,170000,-6000,1823,-3.2912781130005486
"230 RIVERSIDE DRIVE, 10A",2008-06-30,496000,2013-06-27,490000,-6000,1823,-3.2912781130005486
"170 EAST END AVENUE, 5H",2008-06-16,3156575,2013-10-24,3150000,-6575,1956,-3.3614519427402865
"450 EAST 83RD   STREET, 5F",2008-02-01,710000,2016-03-01,700000,-10000,2951,-3.388681802778719
"15 WILLIAM STREET, 34B",2009-10-26,1186261,2014-10-08,1180000,-6261,1808,-3.462942477876106
"68 BRADHURST AVENUE, 10-B",2007-07-25,667660,2013-07-17,660000,-7660,2184,-3.5073260073260073
"212 EAST 70TH STREET, 3C",2007-11-02,687318,2017-05-26,675000,-12318,3493,-3.5264815344975666
"225 RECTOR PLACE, 16D",2008-04-25,778961,2013-08-13,772000,-6961,1936,-3.5955578512396693
"69 EAST 130 STREET, 4C",2006-02-24,471510,2014-08-15,460000,-11510,3094,-3.720103425985779
"15 WILLIAM STREET, 26D",2009-02-27,987702,2017-05-01,976500,-11202,2985,-3.7527638190954775
"15 BROAD STREET, 2914",2006-08-16,1384820,2013-09-06,1375000,-9820,2578,-3.809154383242824
"255 EAST 74TH STREET, 19A",2008-12-24,4811231,2017-01-06,4800000,-11231,2935,-3.8265758091993187
"120 GREENWICH STREET, 2B",2006-12-15,524398,2013-08-27,515000,-9398,2447,-3.8406211687780956
"40 WEST 55TH   STREET, 9C",2007-06-12,1257538,2012-09-18,1250000,-7538,1925,-3.9158441558441557
"20 PINE STREET, 1402",2010-05-26,1170987,2011-01-31,1170000,-987,250,-3.948
"20 WEST STREET, PH-B",2006-04-28,763687,2015-06-16,750000,-13687,3336,-4.102817745803358
"304 EAST 65TH STREET, 10D",2006-09-13,715000,2011-01-13,708500,-6500,1583,-4.10612760581175
"360 EAST 88TH STREET, 19B",2007-04-23,1130000,2010-08-18,1125000,-5000,1213,-4.122011541632316
"100 RIVERSIDE BOULEVARD, 7E",2008-03-12,906242,2015-08-04,895000,-11242,2701,-4.162162162162162
"250 EAST 30TH STREET, 7F",2008-04-09,750000,2014-10-16,740000,-10000,2381,-4.199916001679966
"350 EAST 62ND STREET, 4A",2007-05-18,845000,2013-10-04,835000,-10000,2331,-4.29000429000429
"230 RIVERSIDE DRIVE, 12CC",2008-06-30,178000,2013-06-27,170000,-8000,1823,-4.3883708173340645
"403 EAST 62ND STREET, 8D",2005-03-30,439000,2010-10-27,430000,-9000,2037,-4.418262150220913
"250 EAST 40TH STREET, 28B",2004-08-06,510000,2010-10-15,500000,-10000,2261,-4.42282176028306
"69 EAST 130 STREET, 5C",2005-12-28,481650,2014-05-29,467500,-14150,3074,-4.603122966818478
"120 EAST 87TH   STREET, R10-K",2006-12-21,572500,2012-11-16,562500,-10000,2157,-4.6360686138154845
"82 BEAVER STREET, 1309",2007-04-13,915406,2013-04-30,905000,-10406,2209,-4.710728836577637
"1623 THIRD AVENUE, 41A",2006-07-26,1800000,2012-05-14,1790000,-10000,2119,-4.719207173194904
"227 EAST 111 STREET, 6A",2005-04-06,554437,2016-10-05,534233,-20204,4200,-4.810476190476191
"200 CHAMBERS STREET, 18C",2007-05-15,1955040,2010-03-11,1950000,-5040,1031,-4.8884578079534435
"690 RIVERSIDE DRIVE, 1F",2008-05-20,339690,2013-09-11,330000,-9690,1940,-4.994845360824742
"21 SOUTH WILLIAM STREET, 6E",2006-08-18,722957,2013-09-23,710000,-12957,2593,-4.996914770536058
"200 EAST 69TH STREET, 14A",2006-06-22,1310000,2011-12-08,1300000,-10000,1995,-5.012531328320802
"39 EAST 29TH STREET, 4E",2009-01-09,646588,2012-08-14,640000,-6588,1313,-5.017517136329017
"101 WARREN STREET, 1130",2008-09-03,1629200,2010-12-15,1625000,-4200,833,-5.042016806722689
"41 WEST 72ND STREET, 15D",2006-11-01,1120075,2009-07-28,1115000,-5075,1000,-5.075
"555 WEST 23RD STREET, N4N",2008-01-25,833000,2012-05-02,825000,-8000,1559,-5.131494547787043
"184 THOMPSON STREET, 6R",2007-09-06,870603,2013-04-09,860000,-10603,2042,-5.192458374142997
"736 WEST 187TH STREET, 608",2005-11-30,534581,2013-06-19,520000,-14581,2758,-5.286802030456853
"225 5 AVENUE, 3B",2007-05-08,1374637,2009-09-25,1370000,-4637,871,-5.323765786452354
"150 WEST 56TH   STREET, 6005",2008-03-05,1450000,2013-04-19,1440000,-10000,1871,-5.344735435595938
"100 RIVERSIDE BOULEVARD, 27E",2008-07-18,1237173,2012-03-21,1230000,-7173,1342,-5.345007451564829
"120 GREENWICH STREET, 7F",2007-03-05,727030,2013-05-02,715000,-12030,2250,-5.346666666666667
"1600 BROADWAY, 19G",2006-08-31,1323725,2018-08-16,1300000,-23725,4368,-5.431547619047619
"255 CABRINI BLVD, 7E",2006-08-08,380000,2014-10-01,363800,-16200,2976,-5.443548387096774
"249 EAST 118 STREET, 2C",2010-07-19,302119,2011-08-12,300000,-2119,389,-5.447300771208226
"520 WEST 19TH STREET, 6C",2008-10-17,3182031,2012-04-27,3175000,-7031,1288,-5.458850931677019
"40 WEST 55TH   STREET, 6A",2008-02-28,1538915,2015-02-13,1525000,-13915,2542,-5.474036191974823
"20 WEST STREET, 34A",2007-05-14,595676,2017-09-14,575000,-20676,3776,-5.475635593220339
"250 EAST 30TH   STREET, 14D",2008-07-25,1260000,2013-07-18,1250000,-10000,1819,-5.497526113249038
"333 EAST 34TH   STREET, 15G",2007-03-20,631315,2011-08-03,622500,-8815,1597,-5.519724483406387
"377 RECTOR PLACE, 10A",2006-02-28,750000,2013-07-08,735000,-15000,2687,-5.582433941198363
"210 LAFAYETTE STREET, 2D",2006-02-07,1629200,2010-08-10,1620000,-9200,1645,-5.592705167173253
"581 ACADEMY STREET, 3H",2005-01-25,170000,2012-05-09,155000,-15000,2661,-5.636978579481398
"310 WEST 52ND   STREET, 19B",2007-10-19,1883762,2011-12-19,1875000,-8762,1522,-5.756898817345598
"18 WEST 48TH STREET, 6C",2008-09-19,814600,2018-01-12,795000,-19600,3402,-5.761316872427984
"250 EAST 54TH   STREET, 6C",2008-10-17,945000,2013-06-26,935000,-10000,1713,-5.837711617046118
"392 CENTRAL PARK WEST, 12B",2003-01-17,497000,2018-03-09,463750,-33250,5530,-6.012658227848101
"350 EAST 62ND   STREET, 3C",2007-07-16,620000,2016-03-01,601000,-19000,3151,-6.029831799428753
"1623 THIRD AVENUE, 19F",2006-03-10,883000,2009-10-01,875000,-8000,1301,-6.149116064565718
"301 CATHEDRAL PARKWAY, 9H",2005-10-18,686200,2012-12-27,670000,-16200,2627,-6.166730110392082
"20 WEST STREET, 36A",2006-07-07,533869,2014-11-20,515000,-18869,3058,-6.170372792674951
"230 RIVERSIDE DRIVE, 18G",2008-06-30,422500,2010-05-14,418275,-4225,683,-6.185944363103953
"2 SOUTH END AVENUE, 4H",2006-12-22,461100,2016-03-23,440000,-21100,3379,-6.244451021012134
"100 RIVERSIDE BOULEVARD, 20A",2008-06-16,1181170,2013-04-12,1170000,-11170,1761,-6.3429869392390685
"18 WEST 48TH   STREET, 23A",2007-05-23,1110910,2012-02-03,1100000,-10910,1717,-6.354105998835178
"110 EAST 87TH STREET, 4F",2015-09-03,690500,2018-01-12,685000,-5500,862,-6.380510440835267
"230 RIVERSIDE DRIVE, 15N",2008-06-30,272000,2013-06-27,260000,-12000,1823,-6.582556226001097
"45 PARK AVENUE, 1103",2007-11-27,2011043,2012-06-22,2000000,-11043,1669,-6.616536848412223
"160 WADSWORTH AVENUE, 509",2003-08-27,223900,2013-07-15,200000,-23900,3610,-6.620498614958449
"154 ATTORNEY STREET, R4",2006-11-29,50700,2013-09-26,34000,-16700,2493,-6.698756518251103
"1600 BROADWAY, 12C",2006-06-26,1588470,2011-12-05,1575000,-13470,1988,-6.775653923541247
"80 JOHN STREET, 2A",2007-03-21,552069,2010-01-20,545000,-7069,1036,-6.823359073359073
"415 EAST 37TH   STREET, 28J",2011-07-25,915000,2017-06-30,900000,-15000,2167,-6.92201199815413
"555 WEST 23RD   STREET, S11J",2007-12-21,998000,2017-01-05,975000,-23000,3303,-6.96336663639116
"460 EAST 79TH STREET, 18C",2004-11-12,354975,2010-10-01,340000,-14975,2149,-6.9683573755234995
"425 MAIN STREET, 14G",2007-07-16,605000,2012-12-27,591000,-14000,1991,-7.031642390758413
"100 WEST 58TH STREET, 2G",2007-05-08,1220881,2015-05-18,1200000,-20881,2932,-7.121759890859481
"230 RIVERSIDE DRIVE, 12C",2006-11-22,486720,2012-05-08,472500,-14220,1994,-7.131394182547643
"845 UNITED NATIONS PLAZA, 16H",2005-08-11,1350000,2015-08-07,1323725,-26275,3648,-7.202576754385965
"120 RIVERSIDE BOULEVARD, 15T",2006-11-28,1130257,2010-07-26,1120500,-9757,1336,-7.30314371257485
"20 WEST STREET, 28F",2007-05-16,646588,2016-11-28,621000,-25588,3484,-7.34443168771527
"82 BEAVER STREET, 1103",2007-02-08,414726,2012-07-12,400000,-14726,1981,-7.433619384149419
"160 CENTRAL PARK SOUTH, 2511",2014-08-29,1535000,2016-06-27,1530000,-5000,668,-7.485029940119761
"247 WEST 46TH STREET, 303",2014-02-21,785000,2017-10-11,775000,-10000,1328,-7.530120481927711
"400 EAST 90TH   STREET, 12B",2007-09-20,643906,2014-07-23,625000,-18906,2498,-7.568454763811049
"18 WEST 48TH STREET, 34D",2007-06-14,1369546,2014-06-26,1350000,-19546,2569,-7.6084079408330085
"45 PARK AVENUE, 1804",2008-01-15,1496827,2012-04-09,1485000,-11827,1546,-7.65006468305304
"56 PINE STREET, 6A",2005-10-21,560037,2011-03-03,545000,-15037,1959,-7.675855028075548
"106 CENTRAL PARK SOUTH, 3H",2011-07-11,532500,2012-05-31,530000,-2500,325,-7.6923076923076925
"418 CENTRAL PARK WEST, 28",2006-11-10,711756,2011-05-19,699000,-12756,1651,-7.726226529376135
"11 EAST 36TH   STREET, 806",2007-06-13,1272812,2015-05-29,1250000,-22812,2907,-7.847265221878225
"635 WEST 42ND   STREET, 19G",2007-09-20,941881,2013-08-06,925000,-16881,2147,-7.862598975314392
"736 WEST 187TH STREET, 504",2005-10-18,558001,2013-09-27,535000,-23001,2901,-7.928645294725957
"350 WEST 42ND   STREET, 5D",2007-06-21,717866,2010-03-09,710000,-7866,992,-7.929435483870968
"15 WILLIAM STREET, 32C",2009-03-10,1196443,2018-07-09,1169000,-27443,3408,-8.052523474178404
"801 RIVERSIDE DRIVE, 4C",2008-10-02,304200,2010-11-08,298000,-6200,767,-8.083441981747066
"80 JOHN STREET, 12D",2007-04-06,613088,2012-01-10,599000,-14088,1740,-8.096551724137932
"20 WEST STREET, 29G",2006-12-15,646588,2012-07-16,630000,-16588,2040,-8.131372549019607
"25 COLUMBUS CIRCLE, SU-7",2005-09-29,111617,2015-06-30,82500,-29117,3561,-8.176635776467284
"230 RIVERSIDE DRIVE, 16A",2008-06-30,505000,2013-06-27,490000,-15000,1823,-8.228195282501371
"300 EAST 62ND   STREET, 303",2009-10-21,370000,2011-06-20,365000,-5000,607,-8.237232289950576
"120 GREENWICH STREET, 3F",2006-11-20,766742,2014-02-07,745000,-21742,2636,-8.248103186646434
"15 BROAD STREET, 3210",2006-09-20,1685203,2010-02-04,1675000,-10203,1233,-8.274939172749392
"41 WEST 72ND STREET, 11A",2013-06-19,1350000,2017-06-30,1337500,-12500,1472,-8.491847826086957
"56 PINE STREET, 9G",2006-01-20,547560,2010-09-23,533000,-14560,1707,-8.529584065612186
"2 SOUTH END AVENUE, 6J",2004-12-09,355000,2012-12-12,330000,-25000,2925,-8.547008547008547
"200 RIVERSIDE BOULEVARD, 7B",2005-02-25,725000,2009-12-14,710000,-15000,1753,-8.556759840273816
"235 WEST END AVENUE, 3E",2005-04-26,664433,2009-12-07,650000,-14433,1686,-8.56049822064057
"280 PARK AVENUE SOUTH, 19L",2005-09-28,1382737,2011-05-18,1365000,-17737,2058,-8.618561710398446
"184 THOMPSON STREET, ME",2007-11-20,570200,2010-10-21,561000,-9200,1066,-8.630393996247655
"245 EAST 93RD STREET, 12C",2006-03-17,850000,2013-03-06,827500,-22500,2546,-8.837391987431264
"154 ATTORNEY STREET, 504",2006-11-28,534581,2012-05-03,517000,-17581,1983,-8.865859808371155
"635 WEST 42ND   STREET, 3B",2007-12-06,711592,2017-07-26,680000,-31592,3520,-8.975
"100 UNITED NATIONS PLAZA, 49C",2006-05-30,975000,2011-08-02,958000,-17000,1890,-8.994708994708995
"235 WEST END AVENUE, 16C",2004-10-21,650000,2009-05-08,635000,-15000,1660,-9.036144578313253
"1 IRVING PLACE, P16I",2005-10-25,568000,2011-03-31,550000,-18000,1983,-9.07715582450832
"280 RECTOR PLACE, 8N",2005-12-16,499900,2013-05-31,475000,-24900,2723,-9.144326110907087
"100 RIVERSIDE BOULEVARD, 12T",2008-07-28,880786,2013-04-17,865000,-15786,1724,-9.15661252900232
"123 WASHINGTON STREET, 35D",2015-06-09,1359363,2016-09-27,1355000,-4363,476,-9.165966386554622
"310 EAST HOUSTON STREET, 5D",2007-06-26,580402,2013-06-26,560000,-20402,2192,-9.307481751824817
"230 RIVERSIDE DRIVE, 18K",2008-06-30,257000,2013-06-27,240000,-17000,1823,-9.325287986834887
"10 WEST END AVENUE, 32B",2008-01-16,2367431,2013-02-26,2350000,-17431,1868,-9.3313704496788
"325 LEXINGTON AVENUE, 27B",2015-05-13,1736116,2017-02-23,1730000,-6116,652,-9.38036809815951
"404 EAST 76TH STREET, 19B",2005-08-29,950000,2014-12-17,918000,-32000,3397,-9.420076538121872
"148 MADISON STREET, 3A",2004-03-02,241332,2016-02-29,200000,-41332,4381,-9.434375713307464
"82 BEAVER STREET, PH02",2007-01-09,466440,2010-04-28,455000,-11440,1205,-9.493775933609959
"2250 BROADWAY, 3K",2006-08-03,499000,2009-09-30,488000,-11000,1154,-9.532062391681109
"18 PINE STREET, 1808",2009-07-17,1069162,2012-04-13,1059581,-9581,1001,-9.571428571428571
"220 RIVERSIDE BOULEVARD, 16C",2005-09-15,960000,2014-02-26,930000,-30000,3086,-9.721322099805574
"2 SOUTH END AVENUE, 2F",2007-01-03,445000,2012-08-14,425000,-20000,2050,-9.75609756097561
"1600 BROADWAY, 11E",2006-06-12,834965,2011-03-22,817895,-17070,1744,-9.787844036697248
"250 EAST 54TH STREET, 29D",2006-05-22,2021500,2012-05-22,2000000,-21500,2192,-9.808394160583942
"111 FULTON STREET, 417",2008-12-03,745868,2013-05-08,730000,-15868,1617,-9.813234384662955
"20 WEST STREET, 29C",2007-04-10,471510,2011-10-27,455000,-16510,1661,-9.939795304033714
"101 WARREN STREET, 1840",2008-10-17,2235440,2018-07-20,2200000,-35440,3563,-9.946674150996351
"90 WILLIAM STREET, 7D",2008-07-29,688337,2012-03-27,675000,-13337,1337,-9.975317875841435
"244 3 AVENUE, 3G",2006-01-27,358500,2015-04-01,325000,-33500,3351,-9.997015816174276
"360 EAST 88TH STREET, 10D",2004-08-18,376000,2018-07-26,325000,-51000,5090,-10.019646365422396
"38 LAIGHT STREET, P9",2005-04-19,127281,2005-12-02,125000,-2281,227,-10.048458149779735
"38 LAIGHT STREET, P7",2005-04-19,127281,2005-12-02,125000,-2281,227,-10.048458149779735
"20 WEST STREET, 36E",2007-03-02,575311,2012-08-29,555000,-20311,2007,-10.120079720976582
"141 EAST 55TH   STREET, 4B",2007-08-17,612500,2013-09-12,590000,-22500,2218,-10.144274120829577
"161 WEST 61ST   STREET, 5A",2010-10-12,975000,2012-08-29,968000,-7000,687,-10.189228529839884
"421 EAST 13TH   STREET, 5F",2008-08-07,768778,2013-11-26,749000,-19778,1937,-10.210635002581311
"15 BROAD STREET, 1908",2006-07-11,605858,2012-01-11,585000,-20858,2010,-10.377114427860697
"230 RIVERSIDE DRIVE, 18A",2008-06-30,509000,2013-06-27,490000,-19000,1823,-10.422380691168403
"60 EAST 55 STREET, 15C",2006-07-25,712775,2013-11-04,685000,-27775,2659,-10.44565626175254
"425 MAIN STREET, 4C",2007-05-31,520000,2012-05-01,500996,-19004,1797,-10.575403450194768
"1600 BROADWAY, PH6B",2006-08-17,1501918,2013-08-02,1475000,-26918,2542,-10.589299763965382
"304 EAST 65TH STREET, 12A",2006-03-03,730000,2011-04-28,710000,-20000,1882,-10.626992561105208
"1600 BROADWAY, 9C",2006-08-01,1530938,2011-12-05,1510000,-20938,1952,-10.726434426229508
"311 EAST 38TH STREET, 5C",2007-01-25,455000,2010-11-12,440000,-15000,1387,-10.814708002883922
"100 CENTRAL PARK SOUTH, 5F",2006-02-08,570000,2011-03-01,550000,-20000,1847,-10.828370330265296
"220 EAST 65TH STREET, 10F",2008-04-25,875000,2011-06-21,862500,-12500,1152,-10.850694444444445
"172 WEST 79TH STREET, 6C",2007-04-20,967000,2011-07-29,950000,-17000,1561,-10.890454836643178
"230 RIVERSIDE DRIVE, 11E",2008-06-30,270000,2013-06-27,250000,-20000,1823,-10.970927043335163
"340 EAST 23RD STREET, 8E",2008-02-01,1496827,2012-06-27,1479000,-17827,1608,-11.086442786069652
"15 BROAD STREET, 3220",2006-09-18,1883762,2013-06-26,1856250,-27512,2473,-11.124949454104327
"150 NASSAU STREET, 6B",2005-09-26,660000,2013-02-12,630000,-30000,2696,-11.127596439169139
"200 WEST END AVENUE, 9C",2008-03-12,1645556,2009-10-22,1639000,-6556,589,-11.130730050933787
"215 WEST 95TH STREET, 12A",2005-11-23,629000,2013-04-03,599000,-30000,2688,-11.160714285714286
"555 WEST 59TH STREET, 15D",2008-04-07,1007049,2012-09-06,989000,-18049,1613,-11.189708617482951
"2 SOUTH END AVENUE, 3N",2006-05-11,390000,2013-02-14,362290,-27710,2471,-11.21408336705787
"75 WALL STREET, 21I",2008-11-13,580402,2012-08-17,565000,-15402,1373,-11.217771303714494
"555 WEST 59TH STREET, 5F",2008-02-27,1353254,2010-03-03,1345000,-8254,735,-11.229931972789116
"1 IRVING PLACE, U19A",2005-10-18,999000,2010-06-04,980000,-19000,1690,-11.242603550295858
"100 RIVERSIDE BOULEVARD, 9P",2008-09-12,1400093,2014-10-07,1375000,-25093,2216,-11.3235559566787
"176 WEST 86TH STREET, 5C",2009-11-05,535000,2012-04-04,525000,-10000,881,-11.350737797956867
"85 AVENUE A, 7C",2007-05-14,515000,2011-05-20,498200,-16800,1467,-11.451942740286299
"230 RIVERSIDE DRIVE, 11L",2008-06-29,281000,2013-06-27,260000,-21000,1824,-11.513157894736842
"2112 BROADWAY, 7A",2008-01-10,4378475,2014-10-15,4350000,-28475,2470,-11.52834008097166
"15 BROAD STREET, 2516",2006-12-20,1323725,2012-07-17,1300000,-23725,2036,-11.652750491159136
"425 MAIN STREET, 4F",2007-05-31,762000,2012-07-24,739948,-22052,1881,-11.72355130249867
"205 EAST 85TH STREET, 16M",2015-06-15,900000,2016-08-09,895000,-5000,421,-11.876484560570072
"70 BATTERY PLACE, 19E",2009-01-27,2744183,2013-06-26,2725000,-19183,1611,-11.907510862818125
"2132 SECOND AVENUE, 4A",2006-10-27,487988,2014-05-15,455000,-32988,2757,-11.965179542981502
"25 MURRAY STREET, 8C",2008-10-15,992793,2012-11-07,975000,-17793,1484,-11.98989218328841
"212 EAST 57TH   STREET, 5B",2007-03-26,900000,2012-12-07,875000,-25000,2083,-12.00192030724916
"1438 THIRD AVENUE, 13E",2007-09-19,1501918,2011-07-08,1485000,-16918,1388,-12.188760806916427
"249 EAST 118 STREET, 9B",2010-07-21,568413,2013-07-23,555000,-13413,1098,-12.21584699453552
"421 EAST 13TH   STREET, 4B",2008-03-18,682227,2013-03-07,660000,-22227,1815,-12.246280991735537
"635 WEST 42ND STREET, 29F",2007-06-12,1303360,2010-05-17,1290000,-13360,1070,-12.485981308411215
"164 PEARL STREET, 4H",2007-06-26,435000,2014-01-22,405000,-30000,2402,-12.489592006661116
"555 WEST 23 STREET, N8A",2006-11-08,809508,2009-02-25,799000,-10508,840,-12.50952380952381
"301 CATHEDRAL PARKWAY, 19B",2008-11-20,515000,2014-05-09,490000,-25000,1996,-12.525050100200401
"10 WEST END AVENUE, 25A",2007-09-12,1568256,2010-02-22,1557000,-11256,894,-12.590604026845638
"230 RIVERSIDE DRIVE, 10L",2008-06-30,303000,2013-06-27,280000,-23000,1823,-12.616566099835437
"425 MAIN STREET, 6N",2007-06-21,780000,2012-11-19,755000,-25000,1978,-12.639029322548028
"60 EAST 55TH   STREET, 31A",2007-01-25,1797211,2011-11-08,1775000,-22211,1748,-12.706521739130435
"80 PARK AVENUE, 17P",2005-12-13,780000,2012-05-24,750000,-30000,2354,-12.74426508071368
"100 RIVERSIDE BOULEVARD, 14E",2008-05-16,985000,2015-10-21,950000,-35000,2714,-12.896094325718497
"80 JOHN STREET, 13C",2007-05-21,576431,2012-12-17,550000,-26431,2037,-12.97545409916544
"411 EAST 53RD STREET, 6K",2007-04-19,895000,2012-07-24,870000,-25000,1923,-13.000520020800833
"120 RIVERSIDE BOULEVARD, 12A",2006-09-18,1274136,2008-08-14,1265000,-9136,696,-13.126436781609195
"200 WEST END AVENUE, 7C",2008-03-26,1560216,2009-07-08,1554000,-6216,469,-13.253731343283581
"200 WEST END AVENUE, 11C",2008-03-12,1730896,2009-08-14,1724000,-6896,520,-13.261538461538462
"250 EAST 30TH STREET, 8E",2006-07-05,497500,2013-03-06,465000,-32500,2436,-13.341543513957307
"237 EAST 88TH STREET, 304",2007-11-14,349830,2010-06-30,337000,-12830,959,-13.37851929092805
"120 RIVERSIDE BOULEVARD, 8N",2006-01-26,899318,2011-01-06,875000,-24318,1806,-13.465116279069768
"250 EAST 53RD STREET, 1703",2008-07-23,1328760,2012-05-04,1310000,-18760,1381,-13.584359160028965
"230 RIVERSIDE DRIVE, 7G",2006-12-13,436020,2011-03-01,415000,-21020,1539,-13.658219623131904
"111 FULTON STREET, 703",2008-11-24,600767,2013-01-22,580000,-20767,1520,-13.6625
"230 RIVERSIDE DRIVE, 3E",2008-06-30,255000,2013-06-27,230000,-25000,1823,-13.713658804168952
"555 WEST 59TH STREET, 11H",2008-03-06,906242,2011-06-02,890000,-16242,1183,-13.729501267962807
"635 WEST 42ND STREET, 4N",2007-09-05,819691,2012-07-27,795000,-24691,1787,-13.817011751538892
"330 EAST 49TH STREET, 6H",2015-11-24,237080,2018-07-25,223551,-13529,974,-13.890143737166325
"18 WEST 48TH STREET, 15E",2008-08-08,1374637,2013-06-12,1350000,-24637,1769,-13.927077444884116
"10 WEST END AVENUE, 23B",2007-10-11,1734148,2012-06-27,1710000,-24148,1721,-14.031377106333528
"20 WEST STREET, 19C",2006-08-03,501930,2016-08-30,450000,-51930,3680,-14.111413043478262
"100 WEST 119TH STREET, 2D",2008-06-20,870000,2012-09-10,848000,-22000,1543,-14.257939079714841
"280 RECTOR PLACE, 6H",2005-08-31,426500,2012-08-10,390000,-36500,2536,-14.392744479495269
"510 EAST 80TH STREET, 7C",2007-08-15,820000,2011-08-11,799000,-21000,1457,-14.413177762525738
"200 WEST END AVENUE, 12D",2008-03-19,977520,2012-06-26,955000,-22520,1560,-14.435897435897436
"350 WEST 42ND   STREET, 57F",2006-12-29,885877,2011-11-21,860000,-25877,1788,-14.472595078299776
"20 WEST STREET, 28C",2007-03-30,481650,2012-04-13,455000,-26650,1841,-14.47582835415535
"300 RECTOR PLACE, 7E",2007-07-16,532000,2013-11-13,498000,-34000,2312,-14.705882352941176
"310 EAST 53RD STREET, 12B",2006-10-25,2408161,2012-12-20,2375000,-33161,2248,-14.751334519572953
"230 RIVERSIDE DRIVE, 9O",2008-06-30,357000,2013-06-27,330000,-27000,1823,-14.810751508502468
"230 RIVERSIDE DRIVE, 4E",2008-06-30,257000,2013-06-27,230000,-27000,1823,-14.810751508502468
"40 WEST 55TH STREET, 2C",2007-04-05,1120128,2010-12-22,1100000,-20128,1357,-14.832719233603537
"55 WALL STREET, 624",2006-07-19,747824,2018-01-29,685000,-62824,4212,-14.915479582146249
"1031 6 AVENUE, 40D",2006-10-04,722957,2008-02-14,715500,-7457,498,-14.973895582329318
"120 GREENWICH STREET, 12G",2006-07-17,660844,2014-01-03,620000,-40844,2727,-14.977631096442977
"90 WILLIAM STREET, 3D",2008-07-18,647607,2011-10-06,630000,-17607,1175,-14.98468085106383
"56 PINE STREET, 11F",2006-09-27,620000,2013-02-11,585000,-35000,2329,-15.027908973808502
"80 JOHN STREET, 12B",2008-01-16,612028,2012-11-14,585000,-27028,1764,-15.321995464852607
"116 WEST 22ND   STREET, PHA",2007-03-02,1827758,2015-09-10,1780000,-47758,3114,-15.336544637122671
"139 WOOSTER STREET, 4A",2007-09-06,2214693,2014-09-19,2175000,-39693,2570,-15.444747081712062
"15 WILLIAM STREET, 18B",2009-02-06,1193898,2016-11-18,1150000,-43898,2842,-15.446164672765658
"425 MAIN STREET, 5N",2007-05-31,771000,2012-07-20,742000,-29000,1877,-15.450186467767715
"635 WEST 42ND   STREET, 21K",2008-06-25,753505,2013-07-08,725000,-28505,1839,-15.500271886895051
"200 WEST END AVENUE, 23C",2008-05-23,2525000,2012-10-19,2500000,-25000,1610,-15.527950310559007
"220 RIVERSIDE BOULEVARD, 15A",2004-09-01,855000,2010-11-02,820000,-35000,2253,-15.534842432312471
"232 EAST 118TH STREET, 2A",2008-01-29,441000,2013-01-30,412500,-28500,1828,-15.590809628008753
"158 HESTER STREET, 5E",2007-01-11,544763,2010-06-30,525000,-19763,1266,-15.610584518167457
"15 WILLIAM STREET, 14C",2009-06-16,1158259,2017-11-29,1110000,-48259,3088,-15.62791450777202
"312 WEST 23RD   STREET, 2J",2007-11-14,397995,2016-03-31,350000,-47995,3060,-15.684640522875817
"220 RIVERSIDE BOULEVARD, 7A",2005-08-24,1080000,2013-05-03,1035000,-45000,2809,-16.01993592025632
"2109 BROADWAY, 7-142",2008-07-17,490000,2013-08-29,460000,-30000,1869,-16.051364365971107
"312-320 WEST 23 STREET, 3A",2007-03-19,385320,2009-10-27,370000,-15320,953,-16.07555089192025
"418 CENTRAL PARK WEST, 32",2005-06-09,1175000,2018-02-21,1100000,-75000,4640,-16.163793103448278
"101 WARREN STREET, 500",2008-06-23,1624108,2012-07-23,1600000,-24108,1491,-16.169014084507044
"252 7 AVENUE, 7E",2004-07-08,1450000,2009-07-30,1420000,-30000,1848,-16.233766233766232
"160 WEST 66TH   STREET, 20J",2007-01-26,1437500,2010-11-05,1415000,-22500,1379,-16.316171138506164
"2 SOUTH END AVENUE, 7H",2005-08-12,425000,2013-02-07,380000,-45000,2736,-16.44736842105263
"1255 5 AVENUE, 5K",2007-08-30,735000,2013-07-19,699000,-36000,2150,-16.74418604651163
"255 HUDSON STREET, 7F",2007-03-16,992793,2012-02-24,962500,-30293,1806,-16.773532668881508
"307 WEST 126 STREET, 3B",2007-09-18,454106,2014-11-21,410000,-44106,2621,-16.82792827165204
"123 WASHINGTON STREET, 45A",2011-01-21,1539975,2013-08-27,1524000,-15975,949,-16.833508956796628
"80 JOHN STREET, 22C",2007-11-20,996766,2013-11-12,960000,-36766,2184,-16.834249084249084
"123 BAXTER STREET, 6C",2007-10-19,1299000,2014-02-06,1260000,-39000,2302,-16.941789748045178
"404 EAST 66TH STREET, 7H",2007-02-08,770000,2011-12-13,740000,-30000,1769,-16.958733747880157
"59 JOHN STREET, PH1",2007-11-29,2443800,2014-12-23,2400000,-43800,2581,-16.970166602092213
"300 EAST 55TH   STREET, 11A",2008-03-11,2275000,2012-03-22,2250000,-25000,1472,-16.983695652173914
"1420 YORK AVENUE, 2E",2006-10-13,342000,2011-11-03,310000,-32000,1847,-17.325392528424473
"10 WEST END AVENUE, 11C",2007-08-30,903401,2012-12-04,870000,-33401,1923,-17.369214768590744
"736 WEST 187 STREET, 402",2005-12-22,531526,2012-06-26,490000,-41526,2378,-17.462573591253154
"225 EAST 34TH STREET, 11A",2007-11-14,589566,2010-02-25,575000,-14566,834,-17.465227817745802
"20 WEST STREET, 40B",2006-06-19,733140,2013-03-18,690000,-43140,2464,-17.508116883116884
"230 RIVERSIDE DRIVE, 6O",2008-06-30,352000,2013-06-27,320000,-32000,1823,-17.553483269336258
"2 SOUTH END AVENUE, 3M",2006-05-11,395000,2015-06-29,336298,-58702,3336,-17.59652278177458
"581 ACADEMY STREET, GLD",2011-11-02,235000,2014-12-05,215000,-20000,1129,-17.71479185119575
"1438 THIRD AVENUE, 11A",2007-09-10,901151,2010-12-14,880000,-21151,1191,-17.75902602854744
"1438 3 AVENUE, 12B",2007-06-13,865512,2011-05-19,840000,-25512,1436,-17.766016713091922
"779 RIVERSIDE DRIVE, C-61",2008-10-21,483384,2013-06-26,453000,-30384,1709,-17.778818022235225
"15 BROAD STREET, 2324",2007-03-28,687318,2011-06-01,660000,-27318,1526,-17.90170380078637
"425 MAIN STREET, 4E",2007-05-31,771000,2013-01-14,734000,-37000,2055,-18.004866180048662
"1420 YORK AVENUE, 3O",2005-09-21,380000,2010-01-20,351500,-28500,1582,-18.015170670037925
"223 WEST 14TH   STREET, 4-B",2007-03-20,560000,2010-03-29,540000,-20000,1105,-18.099547511312217
"230 RIVERSIDE DRIVE, 7O",2008-06-30,353000,2013-06-27,320000,-33000,1823,-18.102029621503018
"350 EAST 82ND STREET, 7Y",2006-10-12,492804,2012-11-14,452500,-40304,2225,-18.114157303370785
"1600 BROADWAY, 21G",2006-07-26,1323725,2014-03-28,1272812,-50913,2802,-18.170235546038544
"127 EAST 30TH   STREET, 4E",2007-02-16,725000,2013-02-21,685000,-40000,2197,-18.206645425580337
"1600 BROADWAY, 21F",2006-08-25,799326,2007-04-19,795000,-4326,237,-18.253164556962027
"1600 BROADWAY, 17E",2006-06-20,911333,2012-07-31,870000,-41333,2233,-18.510076130765786
"247 WEST 46TH   STREET, 2506",2008-11-07,1170987,2011-12-06,1150000,-20987,1124,-18.67170818505338
"505 WEST 47TH   STREET, 1H-N",2009-11-19,441090,2012-08-10,422500,-18590,995,-18.683417085427134
"1965 BROADWAY, 19A",2004-03-31,1975000,2015-03-23,1900000,-75000,4009,-18.707907208780245
"99 JOHN STREET, 1701",2009-04-07,875000,2012-09-07,851500,-23500,1249,-18.815052041633308
"400 EAST 90TH STREET, 18B",2008-07-23,651680,2013-11-22,615000,-36680,1948,-18.829568788501028
"136 BAXTER STREET, 4A4B",2008-09-10,3563875,2017-12-22,3500000,-63875,3390,-18.842182890855458
"280 PARK AVENUE SOUTH, 16A",2005-10-28,1525000,2009-06-12,1500000,-25000,1323,-18.89644746787604
"236 EAST 47TH STREET, 8D",2005-08-11,440000,2011-05-24,400000,-40000,2112,-18.939393939393938
"2 SOUTH END AVENUE, 4J",2004-12-23,355000,2011-03-01,312000,-43000,2259,-19.034971226206284
"1600 BROADWAY, 5B",2006-05-18,911333,2011-04-13,877000,-34333,1791,-19.169737576772754
"10 WEST END AVENUE, 15B",2007-07-30,1542648,2012-03-19,1510000,-32648,1694,-19.272727272727273
"161 WEST 61ST   STREET, 8C",2009-01-21,960000,2013-04-24,930000,-30000,1554,-19.305019305019304
"15 WILLIAM STREET, 21F",2009-05-21,1209171,2016-05-02,1160000,-49171,2538,-19.37391646966115
"184 THOMPSON STREET, 5H",2007-05-11,763687,2010-11-05,739000,-24687,1274,-19.377551020408163
"111 FULTON STREET, 503",2008-12-10,585493,2012-07-16,560000,-25493,1314,-19.401065449010655
"80 JOHN STREET, 2G",2006-02-14,848965,2012-04-26,805000,-43965,2263,-19.427750773309764
"350 EAST 82ND STREET, 4A",2006-10-13,982611,2012-10-12,940000,-42611,2191,-19.448197170241897
"425 MAIN STREET, 3E",2007-05-31,762000,2012-11-30,722880,-39120,2010,-19.46268656716418
"145 EAST 48TH STREET, 24F",2005-07-29,775000,2009-10-15,745000,-30000,1539,-19.49317738791423
"68 BRADHURST AVENUE, 3-D",2007-05-17,680000,2012-08-14,642500,-37500,1916,-19.572025052192068
"360 WEST 28TH STREET, 6A",2007-12-19,431000,2012-07-18,398000,-33000,1673,-19.72504482964734
"1420 YORK AVENUE, 2F",2005-06-22,370000,2009-10-06,339000,-31000,1567,-19.783024888321634
"200 EAST 32ND   STREET, 27C",2007-05-31,1225000,2012-03-29,1190000,-35000,1764,-19.841269841269842
"455 MAIN STREET, 16E",2006-04-19,617314,2008-09-05,600000,-17314,870,-19.901149425287358
"20 WEST STREET, 32H",2006-05-17,491790,2012-02-13,450000,-41790,2098,-19.91897044804576
"418 CENTRAL PARK WEST, 46",2007-11-09,465000,2011-04-07,440200,-24800,1245,-19.919678714859437
"330 EAST 75TH STREET, 11G",2008-04-10,999999,2011-09-15,975000,-24999,1253,-19.951316839584997
"219 WEST 81ST STREET, 5C",2008-06-16,636406,2011-05-17,615000,-21406,1065,-20.099530516431926
"779 RIVERSIDE DRIVE, C-50",2008-09-25,332310,2013-02-05,300000,-32310,1594,-20.269761606022584
"595 WEST END AVENUE, 5C",2007-09-19,1517192,2010-01-14,1500000,-17192,848,-20.27358490566038
"261 WEST 28TH STREET, 6F",2007-11-26,743322,2012-05-25,710000,-33322,1642,-20.293544457978076
"393 WEST 49TH   STREET, 5II",2007-06-15,682000,2013-02-08,640000,-42000,2065,-20.338983050847457
"400 CENTRAL PARK WEST, 18P",2004-04-28,700000,2011-01-17,650000,-50000,2455,-20.36659877800407
"343 EAST 30TH   STREET, 16-F",2008-02-27,490000,2010-10-27,470000,-20000,973,-20.554984583761563
"304 EAST 65TH STREET, 29C",2008-10-31,1300000,2012-02-27,1275000,-25000,1214,-20.59308072487644
"335 EAST 51ST STREET, PHC",2007-04-17,860000,2012-08-07,820000,-40000,1939,-20.629190304280556
"200 RECTOR PLACE, 25M",2007-03-07,525000,2012-06-26,485000,-40000,1938,-20.63983488132095
"80 JOHN STREET, 13D",2007-06-21,566554,2012-12-13,525000,-41554,2002,-20.756243756243755
"100 RIVERSIDE BOULEVARD, 12B",2008-07-22,977520,2013-06-27,940000,-37520,1801,-20.832870627429205
"150 EAST 85TH   STREET, 10C",2007-07-03,425000,2010-02-16,405000,-20000,959,-20.855057351407716
"170 WEST 23RD STREET, 3G",2009-11-13,549000,2016-12-07,495000,-54000,2581,-20.922123208058892
"635 WEST 42ND   STREET, 11M",2008-05-09,778961,2017-12-27,705000,-73961,3519,-21.017618641659563
"150 NASSAU STREET, 17C",2004-09-10,1591524,2010-02-05,1550000,-41524,1974,-21.0354609929078
"158 8 AVENUE, RES",2004-02-18,1020000,2013-10-24,945000,-75000,3536,-21.210407239819006
"184 THOMPSON STREET, 3L",2008-06-19,620000,2012-12-20,585000,-35000,1645,-21.27659574468085
"49 WARREN STREET, 5/6W",2005-08-02,2674181,2011-07-29,2627500,-46681,2187,-21.344764517604023
"165 WEST 91ST   STREET, 9E",2014-03-27,2540533,2016-03-18,2525000,-15533,722,-21.513850415512465
"322 WEST 57TH   STREET, 37Q1",2008-05-14,1374637,2014-09-05,1325000,-49637,2305,-21.534490238611713
"845 UNITED NATIONS PLAZA, 6B",2005-05-25,980000,2012-05-10,925000,-55000,2542,-21.636506687647522
"1600 BROADWAY, 6C",2006-05-12,1395002,2012-01-19,1350000,-45002,2078,-21.656400384985563
"115 4 AVENUE, 5A",2014-03-13,1050000,2016-02-01,1035000,-15000,690,-21.73913043478261
"68 BRADHURST AVENUE, 3-E",2007-05-21,630000,2012-05-24,590000,-40000,1830,-21.85792349726776
"135 WEST 70TH STREET, 2F",2007-07-23,1820000,2012-07-24,1780000,-40000,1828,-21.88183807439825
"210 EAST 47TH STREET, 6J",2006-01-23,600000,2018-06-29,500000,-100000,4540,-22.026431718061673
"230 WEST 56TH   STREET, 50C",2008-09-10,2865000,2016-10-05,2800000,-65000,2947,-22.05632846963013
"52 EAST END AVENUE, 12B",2007-06-26,707000,2009-04-13,692500,-14500,657,-22.070015220700153
"250 WEST 90TH STREET, 17F",2005-05-17,799000,2012-03-29,743600,-55400,2508,-22.08931419457735
"220 RIVERSIDE BOULEVARD, 11V",2005-11-22,885000,2013-04-30,825000,-60000,2716,-22.091310751104565
"220 RIVERSIDE BOULEVARD, 27B",2005-11-29,1950000,2018-03-28,1850000,-100000,4502,-22.21235006663705
"15 WILLIAM STREET, 38C",2009-07-02,1272812,2018-06-11,1200000,-72812,3266,-22.293937538273116
"175 WEST 12TH   STREET, 5F",2007-05-31,997885,2013-04-16,950000,-47885,2147,-22.303213786679088
"75 WALL STREET, 38C",2009-09-14,2426238,2017-03-21,2365000,-61238,2745,-22.308925318761386
"1600 BROADWAY, 20A",2006-08-03,1115000,2016-07-19,1033672,-81328,3638,-22.35514018691589
"68 BRADHURST AVENUE, 8-S",2007-08-07,455034,2016-11-01,379466,-75568,3374,-22.397154712507408
"253 WEST 73RD STREET, 7J",2005-10-27,485000,2010-02-04,450000,-35000,1561,-22.42152466367713
"400 EAST 67TH   STREET, 22D",2011-10-20,2818006,2013-12-31,2800000,-18006,803,-22.423412204234122
"40 WEST 116 STREET, A1109",2008-10-31,1265040,2013-02-04,1230000,-35040,1557,-22.504816955684007
"99 BATTERY PLACE, 18-E",2007-10-16,745000,2013-11-11,695000,-50000,2218,-22.54283137962128
"240 RIVERSIDE BOULEVARD, 11D-T",2005-09-29,2575000,2011-10-19,2525000,-50000,2211,-22.61420171867933
"220 EAST 65TH   STREET, 14L",2007-06-20,1900000,2013-06-07,1850555,-49445,2179,-22.691601652134008
"425 MAIN STREET, 4N",2007-05-31,762000,2013-02-12,714346,-47654,2084,-22.866602687140116
"125 WEST 22ND STREET, 9C",2008-03-28,1624109,2011-02-10,1600000,-24109,1049,-22.98284080076263
"255 HUDSON STREET, 5F",2006-10-03,967337,2010-08-09,935000,-32337,1406,-22.999288762446657
"230 RIVERSIDE DRIVE, 3D",2008-06-30,522000,2013-06-27,480000,-42000,1823,-23.03894679100384
"205 EAST 85TH   STREET, 9F",2009-04-16,757093,2013-06-28,721500,-35593,1534,-23.202737940026076
"211 EAST 46TH   STREET, 30G",2008-09-22,1224527,2012-11-06,1189438,-35089,1506,-23.299468791500665
"260 WEST BROADWAY, 5G",2005-03-30,1325000,2009-05-06,1290000,-35000,1498,-23.364485981308412
"400 EAST 90TH   STREET, 5B",2007-06-21,682227,2013-07-29,630000,-52227,2230,-23.42017937219731
"350 WEST 42ND STREET, 57G",2006-12-13,1893945,2012-08-15,1845000,-48945,2072,-23.622104247104247
"230 RIVERSIDE DRIVE, 7K",2007-08-31,733140,2012-08-24,690000,-43140,1820,-23.703296703296704
"440 EAST 117TH STREET, 1A",2007-06-01,640000,2014-12-02,575000,-65000,2741,-23.713973002553814
"222 RIVERSIDE DRIVE, 16C",2014-04-08,1995000,2016-07-29,1975000,-20000,843,-23.72479240806643
"425 MAIN STREET, 10J",2007-07-16,583000,2012-10-22,537140,-45860,1925,-23.823376623376625
"301 CATHEDRAL PARKWAY, 15H",2005-09-29,699000,2010-03-22,660000,-39000,1635,-23.853211009174313
"20 WEST STREET, 19G",2008-07-21,916665,2013-11-27,870000,-46665,1955,-23.869565217391305
"230 RIVERSIDE DRIVE, 14F",2008-06-30,425000,2011-06-21,399000,-26000,1086,-23.941068139963168
"301 CATHEDRAL PARKWAY, 1F",2007-08-10,460000,2010-06-18,435000,-25000,1043,-23.969319271332694
"425 MAIN STREET, 3N",2007-05-31,753000,2012-09-12,706615,-46385,1931,-24.02123252200932
"225 5 AVENUE, 9F",2007-01-30,1799756,2012-03-02,1755000,-44756,1858,-24.08826695371367
"1623 THIRD AVENUE, 29D",2006-09-06,660000,2012-05-04,610000,-50000,2067,-24.189646831156264
"425 MAIN STREET, 8L",2007-06-21,405000,2013-05-14,352404,-52596,2154,-24.41782729805014
"425 MAIN STREET, 5F",2007-05-31,771000,2010-11-18,740000,-31000,1267,-24.4672454617206
"199 PRINCE STREET, 11",2005-11-18,525000,2009-10-15,490000,-35000,1427,-24.52697967764541
"1623 3 AVENUE, 19J",2003-01-31,275404,2015-08-28,162500,-112904,4592,-24.587108013937282
"225 EAST 34TH STREET, 17D",2007-11-29,936790,2013-02-12,890000,-46790,1902,-24.60042060988433
"2 SOUTH END AVENUE, 6V",2005-08-22,410100,2012-04-30,350000,-60100,2443,-24.600900532132624
"120 GREENWICH STREET, 5B",2006-07-27,530508,2012-09-28,475000,-55508,2255,-24.615521064301554
"401 EAST 84TH   STREET, 14D",2007-08-31,650000,2012-08-29,605000,-45000,1825,-24.65753424657534
"225 5 AVENUE, 10D",2007-03-15,1634291,2010-12-30,1600000,-34291,1386,-24.74098124098124
"88 GREENWICH STREET, 1305",2008-09-23,646588,2013-11-19,600000,-46588,1883,-24.74137015400956
"382 CENTRAL PARK WEST, 5B",2007-05-09,840000,2012-10-24,790434,-49566,1995,-24.84511278195489
"1619 THIRD AVENUE, 2B",2008-09-08,495000,2013-08-19,450000,-45000,1806,-24.916943521594686
"230 RIVERSIDE DRIVE, 10K",2007-05-25,743322,2010-06-30,715000,-28322,1132,-25.019434628975265
"340 EAST 23RD STREET, SHA",2008-04-16,1420458,2014-11-17,1360000,-60458,2406,-25.128013300083126
"300 ALBANY STREET, 4I",2005-04-15,800000,2010-09-23,750000,-50000,1987,-25.163563160543532
"1600 BROADWAY, PH4B",2006-08-03,1206626,2018-02-21,1100000,-106626,4220,-25.266824644549764
"200 RECTOR PLACE, 29B",2006-08-17,985000,2011-06-28,940000,-45000,1776,-25.33783783783784
"80 JOHN STREET, 6D",2007-03-20,503248,2018-05-04,400000,-103248,4063,-25.41176470588235
"206 EAST 95TH   STREET, 10A",2008-10-01,834965,2011-06-10,810000,-24965,982,-25.422606924643585
"212 WARREN STREET, 4L",2016-01-06,3843893,2018-07-31,3820000,-23893,937,-25.499466382070437
"392 CENTRAL PARK WEST, 17B",2008-11-25,875000,2012-08-27,840000,-35000,1371,-25.52881108679796
"10 WEST END AVENUE, 25C",2007-08-20,1642524,2011-02-14,1610000,-32524,1274,-25.529042386185242
"21 SOUTH END AVENUE, 212",2007-04-02,810000,2008-06-04,799000,-11000,429,-25.641025641025642
"120 RIVERSIDE BOULEVARD, 12T",2006-03-31,1251225,2011-09-08,1200000,-51225,1987,-25.780070457976848
"230 RIVERSIDE DRIVE, 7D",2008-06-30,537000,2013-06-27,490000,-47000,1823,-25.78167855183763
"1 MT MORRIS PARK WEST, 8A",2006-07-12,689000,2012-10-12,630000,-59000,2284,-25.83187390542907
"322 WEST 57TH   STREET, 50H",2009-01-08,1858306,2015-03-09,1800000,-58306,2251,-25.902265659706796
"211 EAST 46TH   STREET, 26B",2008-08-26,795579,2012-12-06,755000,-40579,1563,-25.96225207933461
"20 WEST STREET, 15D",2006-05-31,425880,2012-04-11,370000,-55880,2142,-26.087768440709617
"82 BEAVER STREET, PH09",2007-01-11,763687,2012-01-30,715000,-48687,1845,-26.38861788617886
"350 EAST 82ND   STREET, 4R",2008-04-14,1125166,2013-06-27,1075000,-50166,1900,-26.403157894736843
"400 EAST 51ST   STREET, 4C",2008-06-13,1180000,2013-02-11,1135000,-45000,1704,-26.408450704225352
"343 EAST 30TH   STREET, 3-B",2007-05-16,720000,2011-07-07,680000,-40000,1513,-26.437541308658293
"426 WEST 58TH STREET, 2B",2006-05-23,2291062,2011-08-30,2240000,-51062,1925,-26.525714285714287
"491-497 GREENWICH STREET, 3A",2007-05-09,3900000,2017-08-29,3800000,-100000,3765,-26.56042496679947
"400 EAST 90TH STREET, 15A",2007-11-27,672045,2013-09-24,615000,-57045,2128,-26.80686090225564
"504 CATHEDRAL PARKWAY, 4F",2007-07-25,569000,2012-01-11,525000,-44000,1631,-26.977314530962598
"2101 5 AVENUE, GS",2007-12-05,805000,2013-06-25,750000,-55000,2029,-27.106949236076886
"215 EAST 81ST   STREET, 3B",2008-08-07,632842,2014-06-10,575000,-57842,2133,-27.117674636661977
"119 FULTON STREET, 7A",2007-02-13,1221900,2009-04-30,1200000,-21900,807,-27.13754646840149
"170 EAST 77TH STREET, 7A",2007-12-12,5890576,2014-07-18,5825000,-65576,2410,-27.209958506224066
"140 WEST 22ND   STREET, 10D",2010-04-16,1570000,2012-04-17,1550000,-20000,732,-27.3224043715847
"15 WILLIAM STREET, 25G",2009-08-25,1130257,2014-09-05,1080000,-50257,1837,-27.358192705498094
"211 MADISON AVENUE, 5A",2008-06-04,1221900,2015-08-12,1150000,-71900,2625,-27.39047619047619
"425 MAIN STREET, 15H",2007-07-16,1120000,2012-08-30,1068256,-51744,1872,-27.641025641025642
"1760 SECOND AVENUE, 12E",2005-04-19,650000,2009-08-20,606000,-44000,1584,-27.77777777777778
"16 WEST 19TH   STREET, 5-A",2007-11-28,575311,2011-11-17,535000,-40311,1450,-27.800689655172413
"130 BARROW STREET, 107",2007-01-29,1155000,2014-06-12,1080000,-75000,2691,-27.870680044593087
"121 WEST 15TH STREET, 2",2007-04-17,2952925,2017-04-20,2850000,-102925,3656,-28.152352297592998
"400 EAST 90TH   STREET, 18C",2007-06-28,410670,2012-05-31,360000,-50670,1799,-28.165647581989994
"500 WEST 43RD STREET, 30A",2007-06-01,1350000,2012-04-10,1300000,-50000,1775,-28.169014084507044
"310 EAST HOUSTON STREET, 4D",2007-06-29,565128,2012-10-26,510000,-55128,1946,-28.328879753340185
"154 ATTORNEY STREET, 501",2006-11-21,1182487,2012-06-06,1125000,-57487,2024,-28.402667984189723
"15 BROAD STREET, 1902",2006-06-26,865512,2009-11-23,830000,-35512,1246,-28.500802568218297
"779 RIVERSIDE DRIVE, C-34",2008-09-18,375180,2013-06-03,326000,-49180,1719,-28.609656777196044
"635 WEST 42ND   STREET, 6A",2007-04-23,823764,2010-07-14,790000,-33764,1178,-28.66213921901528
"603 WEST 148 STREET, 1C",2010-09-10,633822,2013-12-03,600000,-33822,1180,-28.66271186440678
"155 WEST 68TH STREET, 41138",2007-08-09,758500,2011-04-11,720000,-38500,1341,-28.70991797166294
"266 WEST 115TH STREET, 7B",2007-12-19,740000,2012-09-24,690000,-50000,1741,-28.71912693854107
"101 WARREN STREET, 7F",2008-06-27,1654656,2012-09-27,1610000,-44656,1553,-28.754668383773343
"505 GREENWICH STREET, 3C",2007-03-02,1235000,2010-06-23,1200000,-35000,1209,-28.949545078577337
"154 ATTORNEY STREET, 503",2006-12-05,865512,2011-09-13,815000,-50512,1743,-28.97991967871486
"425 FIFTH AVENUE, 41B",2005-05-25,1300000,2011-01-20,1240000,-60000,2066,-29.04162633107454
"555 LENOX AVENUE, PHE",2008-12-09,476000,2013-09-25,425000,-51000,1751,-29.12621359223301
"18 ELDRIDGE STREET, 5B",2008-08-18,554946,2014-09-22,490000,-64946,2226,-29.17610062893082
"225 RECTOR PLACE, 3L",2016-02-16,825000,2018-06-20,800000,-25000,855,-29.239766081871345
"1 IRVING PLACE, V20F",2008-07-07,1030000,2012-04-03,990000,-40000,1366,-29.282576866764277
"166 EAST 63RD STREET, 2G",2008-04-01,1608835,2013-09-25,1550000,-58835,2003,-29.37343984023964
"595 WEST END AVENUE, 12D",2007-09-06,870561,2012-05-22,820000,-50561,1720,-29.39593023255814
"69 WEST 106 STREET, 2A",2006-03-14,650000,2013-02-22,575000,-75000,2537,-29.562475364603863
"230 RIVERSIDE DRIVE, 9D",2008-06-30,544000,2013-06-27,490000,-54000,1823,-29.621503017004937
"103 GREENE STREET, 7A",2008-10-08,5000000,2013-05-22,4950000,-50000,1687,-29.63841138114997
"516 WEST 47 STREET, S4B",2006-04-10,892191,2009-09-09,855000,-37191,1248,-29.80048076923077
"200 WEST END AVENUE, 4K",2008-04-25,733140,2011-05-10,700000,-33140,1110,-29.855855855855857
"15 WILLIAM STREET, 33G",2009-05-20,1131275,2014-09-04,1073500,-57775,1933,-29.88877392653906
"300 CATHEDRAL PARKWAY, 17J",2008-01-24,460000,2010-06-08,434000,-26000,866,-30.023094688221708
"30 WEST 90TH   STREET, 6E",2007-06-19,736000,2012-07-24,680000,-56000,1862,-30.075187969924812
"455 MAIN STREET, 15F",2006-04-25,687318,2011-12-22,625000,-62318,2067,-30.14900822447992
"425 MAIN STREET, 4G",2007-05-31,370000,2013-02-25,306722,-63278,2097,-30.175488793514546
"15 BROAD STREET, 2814",2006-08-11,1593561,2012-10-25,1525000,-68561,2267,-30.243052492280547
"350 EAST 30TH STREET, 4W",2005-01-25,525100,2009-08-07,475000,-50100,1655,-30.27190332326284
"261 WEST 28TH STREET, 8B",2007-12-05,1654656,2012-11-12,1600000,-54656,1804,-30.29711751662971
"206 EAST 95TH STREET, 8C",2007-10-02,609931,2014-01-24,540000,-69931,2306,-30.325672159583696
"225 5 AVENUE, 11T",2007-05-28,969883,2012-05-09,915000,-54883,1808,-30.355641592920353
"2056 5 AVENUE, 2-A",2011-07-06,483668,2012-12-11,467685,-15983,524,-30.501908396946565
"20 WEST STREET, 27F",2007-06-21,534581,2012-05-11,480000,-54581,1786,-30.56047032474804
"140 7 AVENUE, 5P",2005-08-01,721000,2016-05-27,600000,-121000,3952,-30.61740890688259
"25 CENTRAL PARK WEST, 19O",2009-04-01,655931,2011-07-21,630000,-25931,841,-30.833531510107015
"200 RIVERSIDE BOULEVARD, 32D",2006-07-14,1550000,2010-12-17,1500000,-50000,1617,-30.921459492888065
"300 EAST 77TH STREET, 12A",2008-01-30,3655000,2013-05-22,3595000,-60000,1939,-30.943785456420837
"235 WEST END AVENUE, 9H",2005-01-18,929000,2009-10-26,875000,-54000,1742,-30.998851894374283
"20 WEST STREET, 43D",2007-06-14,451230,2011-12-20,400000,-51230,1650,-31.048484848484847
"60 HENRY STREET, 3E",2007-03-01,260000,2016-11-08,150000,-110000,3540,-31.073446327683616
"184 THOMPSON STREET, 6J",2007-05-09,845147,2011-05-13,799500,-45647,1465,-31.158361774744026
"2 SOUTH END AVENUE, TH9",2005-12-21,360000,2009-12-04,315000,-45000,1444,-31.16343490304709
"15 WILLIAM STREET, 37C",2009-02-27,1262630,2014-08-27,1200000,-62630,2007,-31.20577977080219
"45 PARK AVENUE, 702",2007-10-15,1349181,2012-01-24,1300000,-49181,1562,-31.485915492957748
"1600 BROADWAY, 17D",2006-06-19,997885,2012-10-17,925000,-72885,2312,-31.524653979238753
"250 EAST 54TH STREET, 8C",2005-12-09,960000,2012-06-14,885000,-75000,2379,-31.525851197982345
"225 EAST 34TH STREET, 20D",2007-12-21,967337,2012-01-26,920000,-47337,1497,-31.62124248496994
"421 EAST 13TH   STREET, 5L",2008-02-06,733140,2013-02-14,675000,-58140,1835,-31.68392370572207
"154 ATTORNEY STREET, 302",2006-12-21,1070000,2010-06-01,1030000,-40000,1258,-31.79650238473768
"22 WEST 15TH STREET, 4F",2006-12-18,750000,2009-12-16,715000,-35000,1094,-31.992687385740403
"520 EAST 81ST   STREET, 5J",2007-07-20,497000,2013-09-16,425000,-72000,2250,-32.0
"57 WEST 58TH STREET, PHC",2004-11-09,1200000,2013-05-29,1100000,-100000,3123,-32.02049311559398
"120 RIVERSIDE BOULEVARD, 4C",2006-04-04,599000,2012-08-01,525000,-74000,2311,-32.02077022933795
"450 EAST 83RD STREET, 4E",2006-04-19,957155,2011-03-04,900000,-57155,1780,-32.109550561797754
"504 WEST 136 STREET, 1C",2006-11-07,349830,2010-06-15,307500,-42330,1316,-32.16565349544073
"2 SOUTH END AVENUE, 2C",2008-02-14,395000,2011-08-10,354000,-41000,1273,-32.20738413197172
"23 EAST 128 STREET, 6R",2006-04-27,570220,2013-04-04,488349,-81871,2534,-32.30899763220205
"754 EAST 6TH   STREET, 6B",2015-02-26,850000,2015-12-30,840000,-10000,307,-32.57328990228013
"77 WHITE STREET, 3",2006-03-22,1817576,2010-11-04,1762500,-55076,1688,-32.627962085308056
"88 GREENWICH STREET, 721",2015-06-25,647089,2016-11-29,630000,-17089,523,-32.67495219885277
"310 WEST 52ND   STREET, 17H",2007-03-22,1619017,2009-08-25,1590000,-29017,887,-32.713641488162345
"170 EAST END AVENUE, 3L",2008-03-10,1945264,2011-12-19,1900000,-45264,1379,-32.82378535170413
"232 EAST 118TH STREET, 5A",2008-01-25,510000,2013-01-23,450000,-60000,1825,-32.87671232876713
"15 WILLIAM STREET, 39C",2009-06-15,1330000,2014-11-13,1265000,-65000,1977,-32.87809812847749
"68 BRADHURST AVENUE, 6-M",2007-06-28,745000,2013-04-25,675000,-70000,2128,-32.89473684210526
"322 WEST 57TH   STREET, 32L",2008-01-31,794235,2011-10-03,750000,-44235,1341,-32.986577181208055
"2000 BROADWAY, 10A",2006-05-01,920000,2009-12-22,876000,-44000,1331,-33.05785123966942
"123 BAXTER STREET, 3D",2008-06-25,1218845,2013-10-04,1155000,-63845,1927,-33.13181110534509
"200 EAST 69TH STREET, 7G",2006-07-07,845000,2009-05-28,810000,-35000,1056,-33.14393939393939
"20 WEST STREET, 12J",2007-04-12,615000,2012-08-23,550000,-65000,1960,-33.16326530612245
"230 RIVERSIDE DRIVE, 11D",2008-06-30,551000,2013-06-27,490000,-61000,1823,-33.461327482172244
"155 EAST 38TH   STREET, 3G",2007-06-01,1160000,2014-11-04,1069162,-90838,2713,-33.48249170659786
"10 WEST END AVENUE, 7C",2007-07-16,859969,2012-06-04,800000,-59969,1785,-33.59607843137255
"425 MAIN STREET, 4L",2007-05-31,405000,2012-10-10,339000,-66000,1959,-33.6906584992343
"243 WEST 60TH STREET, 5B",2014-08-15,2495000,2018-04-06,2450000,-45000,1330,-33.83458646616541
"200 RIVERSIDE BOULEVARD, 8C",2007-05-15,1120000,2012-08-06,1055000,-65000,1910,-34.031413612565444
"72 MERCER STREET, 4E",2008-04-01,3222761,2010-01-29,3200000,-22761,668,-34.07335329341317
"401 EAST 60TH STREET, 20D",2007-01-25,1875000,2011-09-16,1817000,-58000,1695,-34.21828908554572
"301 CATHEDRAL PARKWAY, 10J",2006-02-27,635000,2013-01-18,548800,-86200,2517,-34.247119586809696
"266 WEST 115 STREET, 5A",2008-01-25,715322,2010-09-08,682500,-32822,957,-34.29676071055381
"350 EAST 82ND STREET, 6J",2006-09-29,702592,2013-04-25,620000,-82592,2400,-34.413333333333334
"311 EAST 38TH   STREET, 3E",2007-07-30,550000,2009-12-16,520000,-30000,870,-34.48275862068966
"404 EAST 76TH   STREET, 7K",2007-08-06,490000,2009-12-17,460000,-30000,864,-34.72222222222222
"215 EAST 81ST   STREET, 5E",2009-10-27,711756,2016-12-12,621132,-90624,2603,-34.81521321552055
"99 BATTERY PLACE, 11-A",2005-07-11,621000,2017-10-13,465000,-156000,4477,-34.84476211748939
"184 THOMPSON STREET, 5T",2007-07-05,631315,2011-07-15,580000,-51315,1471,-34.8844323589395
"305 SECOND AVENUE, 707",2007-03-29,946972,2012-05-02,881500,-65472,1861,-35.181085437936595
"230 RIVERSIDE DRIVE, 6F",2008-06-30,425000,2010-07-09,399000,-26000,739,-35.182679296346414
"530 WEST END AVENUE, 8B",2005-09-29,1150000,2011-12-12,1070000,-80000,2265,-35.32008830022075
"768 FIFTH AVENUE, 1502",2007-06-26,1513033,2018-07-23,1370000,-143033,4045,-35.36044499381953
"230 RIVERSIDE DRIVE, 12D",2008-06-30,555000,2013-06-27,490000,-65000,1823,-35.655512890839276
"595 WEST END AVENUE, 12A",2007-09-12,2978381,2017-07-18,2850000,-128381,3597,-35.691131498470945
"225 WEST 60TH   STREET, 8B",2007-03-15,1298268,2012-05-30,1230000,-68268,1903,-35.87388334209143
"555 WEST 23RD STREET, S5J",2008-08-28,775000,2011-04-28,740000,-35000,973,-35.97122302158273
"8 GREENE STREET, 4",2006-04-27,1550000,2010-11-15,1490000,-60000,1663,-36.079374624173184
"255 HUDSON STREET, 8E",2006-10-05,1410276,2011-04-29,1350000,-60276,1667,-36.15836832633473
"425 MAIN STREET, 5T",2007-05-31,493000,2012-08-22,423562,-69438,1910,-36.35497382198953
"221 WEST 148 STREET, 4A",2010-04-28,370000,2017-12-18,268000,-102000,2791,-36.546040845575064
"230 RIVERSIDE DRIVE, 17D",2007-06-30,570000,2013-06-27,490000,-80000,2189,-36.546368204659665
"45 EAST 25TH   STREET, 32C",2007-07-10,1850000,2011-06-29,1797000,-53000,1450,-36.55172413793103
"200 WEST END AVENUE, 10E",2008-02-27,2041591,2012-05-24,1985000,-56591,1548,-36.55749354005168
"75 WALL STREET, 25C",2009-06-18,1462955,2013-05-15,1410750,-52205,1427,-36.58374211632796
"15 BROAD STREET, 1100",2006-08-23,744274,2013-09-10,650000,-94274,2575,-36.61126213592233
"216 EAST 47TH   STREET, 21A",2007-08-16,685000,2010-03-28,650000,-35000,955,-36.64921465968586
"56 PINE STREET, 16D",2006-03-30,616041,2011-07-18,545000,-71041,1936,-36.69473140495868
"200 EAST 89TH   STREET, 16C",2007-02-20,677000,2010-08-23,630000,-47000,1280,-36.71875
"15 BROAD STREET, 2404",2006-11-02,1420458,2012-01-27,1350000,-70458,1912,-36.85041841004184
"220 RIVERSIDE BOULEVARD, 30G",2006-05-26,2141000,2009-06-11,2100000,-41000,1112,-36.8705035971223
"99 JOHN STREET, 1702",2008-11-12,1120000,2012-07-27,1070000,-50000,1353,-36.95491500369549
"300 WEST 135TH STREET, 4V",2005-05-11,276049,2015-01-09,145000,-131049,3530,-37.124362606232296
"350 EAST 72ND STREET, 8A",2008-05-20,1325000,2012-06-08,1270000,-55000,1480,-37.16216216216216
"420 WEST 25TH   STREET, 7G",2008-02-15,1960131,2012-07-17,1900000,-60131,1614,-37.25588599752169
"630 FIRST AVENUE, 35B",2006-05-05,730000,2010-05-06,675000,-55000,1462,-37.61969904240766
"421 EAST 13TH   STREET, 7J",2008-03-13,906242,2011-08-18,859000,-47242,1253,-37.70311252992817
"310 WEST 52ND   STREET, 28B",2007-07-23,1926529,2009-02-13,1905000,-21529,571,-37.70402802101576
"127 WEST 89TH   STREET, 62",2007-02-07,695000,2012-07-17,620000,-75000,1987,-37.7453447408153
"333 EAST 45TH STREET, PHB",2005-08-05,1775000,2007-05-23,1750000,-25000,656,-38.109756097560975
"255 HUDSON STREET, 9D",2006-10-12,1247356,2011-12-16,1175000,-72356,1891,-38.263352723426756
"295 GREENWICH STREET, 7EN",2005-10-12,690000,2009-07-15,637500,-52500,1372,-38.265306122448976
"100 RIVERSIDE BOULEVARD, 11R",2008-04-24,1374637,2012-12-06,1309500,-65137,1687,-38.611144042679314
"15 BROAD STREET, 3110",2007-03-09,1761572,2012-04-02,1690000,-71572,1851,-38.666666666666664
"15 WILLIAM STREET, 16F",2015-06-25,1038665,2018-07-26,995000,-43665,1127,-38.744454303460515
"255 HUDSON STREET, 7C",2006-09-28,1160805,2011-01-13,1100000,-60805,1568,-38.77869897959184
"400 EAST 90TH   STREET, 17A",2007-06-20,604840,2012-09-21,530000,-74840,1920,-38.979166666666664
"377 RECTOR PLACE, 1D",2007-06-21,520000,2012-01-12,455000,-65000,1666,-39.015606242497
"117 EAST 57TH   STREET, 20G",2010-09-22,1095000,2017-05-20,1000000,-95000,2432,-39.0625
"515 EAST 72ND   STREET, 5E",2008-03-20,760989,2014-03-28,675000,-85989,2199,-39.103683492496586
"425 MAIN STREET, 9N",2007-07-16,807000,2012-04-13,739000,-68000,1733,-39.238315060588576
"404 EAST 79TH STREET, 10D",2005-10-24,695000,2011-08-03,612000,-83000,2109,-39.35514461830251
"350 WEST 42ND STREET, 55G",2006-11-03,1873580,2012-04-12,1795000,-78580,1987,-39.54705586311022
"68 BRADHURST AVENUE, 5-D",2007-05-30,690000,2012-11-30,610000,-80000,2011,-39.781203381402285
"90 WILLIAM STREET, 14G",2009-07-17,933735,2012-11-20,885000,-48735,1222,-39.88134206219313
"15 WILLIAM STREET, 24C",2008-12-23,1094618,2014-10-06,1010000,-84618,2113,-40.04637955513488
"261 WEST 28TH   STREET, 5B",2008-05-29,1575000,2013-07-12,1500000,-75000,1870,-40.106951871657756
"301 WEST 57TH   STREET, 28F",2009-03-19,720000,2011-08-05,685000,-35000,869,-40.27617951668584
"200 EAST 66TH   STREET, A0903",2009-02-27,1313542,2012-07-11,1263950,-49592,1230,-40.31869918699187
"322 WEST 57TH STREET, 23V",2008-03-18,837001,2013-02-04,765000,-72001,1784,-40.35930493273543
"100 UNITED NATIONS PLAZA, 21F",2008-07-31,725000,2012-08-23,665000,-60000,1484,-40.43126684636118
"120 RIVERSIDE BOULEVARD, 3P",2007-08-28,860000,2012-05-24,790000,-70000,1731,-40.43905257076834
"65 WEST 107TH STREET, 1D",2008-12-19,380250,2011-01-05,350000,-30250,747,-40.49531459170014
"425 MAIN STREET, 3S",2007-09-06,690000,2012-11-27,612500,-77500,1909,-40.597171293871135
"103 NORFOLK STREET, 10C",2007-02-28,987702,2012-05-22,910000,-77702,1910,-40.68167539267016
"1619 THIRD AVENUE, 18K",2005-04-07,953000,2012-03-06,850000,-103000,2525,-40.79207920792079
"28 EAST 10TH STREET, 8A",2013-03-15,4950000,2018-03-26,4875000,-75000,1837,-40.827436037016874
"425 MAIN STREET, 12E",2007-07-16,1120000,2012-11-19,1040000,-80000,1953,-40.9626216077829
"39 EAST 29TH STREET, 8C",2008-09-16,987702,2011-05-23,947500,-40202,979,-41.06435137895812
"230 RIVERSIDE DRIVE, PHL",2008-06-30,555000,2013-06-27,480000,-75000,1823,-41.14097641250686
"610 WEST 110TH STREET, 4D",2008-09-03,1201535,2010-02-08,1180000,-21535,523,-41.17590822179732
"421 HUDSON STREET, 407",2006-04-14,1150000,2011-03-30,1075000,-75000,1811,-41.413583655438984
"20 WEST STREET, 32A",2006-11-08,515000,2012-06-21,430000,-85000,2052,-41.42300194931774
"21 SOUTH WILLIAM STREET, 7D",2006-05-08,857366,2013-06-06,750000,-107366,2586,-41.51817478731632
"144 COLUMBUS AVENUE, 10A",2005-06-17,2400000,2010-05-24,2325000,-75000,1802,-41.620421753607104
"230 RIVERSIDE DRIVE, 16D",2008-06-30,566000,2013-06-27,490000,-76000,1823,-41.68952276467361
"211 EAST 46TH   STREET, 30A",2008-06-04,750715,2011-10-03,700000,-50715,1216,-41.70641447368421
"330 EAST 75TH STREET, 6K",2008-07-10,699000,2012-05-23,640000,-59000,1413,-41.75513092710545
"155 EAST 38TH STREET, 3J",2007-09-27,795000,2012-10-02,718500,-76500,1832,-41.75764192139738
"1420 YORK AVENUE, 5J",2007-11-26,400000,2012-06-26,330000,-70000,1674,-41.816009557945044
"2 SOUTH END AVENUE, TH5",2005-04-01,750000,2012-10-10,635000,-115000,2749,-41.83339396144052
"13 EAST 16TH   STREET, 7",2008-03-07,1650000,2013-01-31,1575000,-75000,1791,-41.87604690117253
"458 WEST 146 STREET, PH-N",2006-11-22,1150622,2013-06-12,1050000,-100622,2394,-42.030910609857976
"80 JOHN STREET, 8B",2007-05-11,912352,2010-02-11,870000,-42352,1007,-42.05759682224429
"188 EAST 76TH STREET, 8B",2005-06-29,1887500,2009-07-24,1825000,-62500,1486,-42.059219380888294
"15 WILLIAM STREET, 23G",2008-12-19,1120075,2017-11-29,982500,-137575,3267,-42.11049892868075
"377 RECTOR PLACE, 8A",2007-07-11,1338000,2011-08-10,1275000,-63000,1491,-42.25352112676056
"56 PINE STREET, 12D",2005-11-01,577347,2010-03-24,509500,-67847,1604,-42.29862842892768
"455 CENTRAL PARK WEST, 22A",2004-09-27,2123051,2009-06-17,2050000,-73051,1724,-42.37296983758701
"171 EAST 84TH STREET, 20E",2006-05-05,592500,2009-01-30,550000,-42500,1001,-42.45754245754246
"322 WEST 57TH   STREET, 26U",2008-02-22,809417,2011-04-27,760000,-49417,1160,-42.60086206896552
"27 WEST 72ND STREET, 907",2008-06-11,1715000,2011-05-02,1670000,-45000,1055,-42.654028436018955
"100 CENTRAL PARK SOUTH, 2G",2007-04-02,575311,2018-07-02,400000,-175311,4109,-42.6651253346313
"308 EAST 72ND STREET, 15A",2006-07-07,2275000,2011-04-28,2200000,-75000,1756,-42.710706150341686
"345 EAST 80TH   STREET, 14E",2010-03-09,600000,2011-02-22,585000,-15000,350,-42.857142857142854
"211 EAST 46TH   STREET, 15B",2008-10-17,741734,2011-07-06,699000,-42734,992,-43.078629032258064
"16 WEST 19TH   STREET, 3-A",2008-02-01,575311,2011-08-02,520000,-55311,1278,-43.279342723004696
"10 WEST END AVENUE, 12B",2007-08-01,1300508,2013-12-06,1200000,-100508,2319,-43.34109529969815
"425 MAIN STREET, 16J",2007-09-06,798000,2012-11-30,715000,-83000,1912,-43.41004184100419
"530 EAST 76TH   STREET, 12J",2007-04-06,700000,2011-08-30,630000,-70000,1607,-43.559427504667084
"106 CENTRAL PARK SOUTH, 9L",2005-11-21,650000,2010-12-01,570000,-80000,1836,-43.57298474945534
"80 JOHN STREET, 3F",2007-07-31,935517,2012-12-06,850000,-85517,1955,-43.74271099744246
"155 WEST 70TH STREET, 10H",2005-11-04,600000,2010-11-03,520000,-80000,1825,-43.83561643835616
"40 BROAD STREET, PH4B",2013-07-11,1181170,2018-08-02,1100000,-81170,1848,-43.92316017316017
"100 RIVERSIDE BOULEVARD, 8R",2008-04-10,1272812,2010-12-09,1230000,-42812,973,-44.0
"203 WEST 81ST STREET, 6D",2006-05-31,1665000,2010-06-15,1600000,-65000,1476,-44.03794037940379
"425 MAIN STREET, PH1F",2007-08-09,1188000,2012-10-18,1104400,-83600,1897,-44.069583552978386
"71 LUDLOW STREET, 4C",2013-09-20,1275000,2018-06-29,1198145,-76855,1743,-44.09351692484223
"692 BROADWAY, 1115",2007-05-08,1650000,2013-06-27,1551000,-99000,2242,-44.15700267618198
"20 WEST STREET, 21H",2007-06-27,672045,2012-01-31,597800,-74245,1679,-44.21977367480643
"464 WEST 44TH   STREET, 7E",2008-03-11,890968,2013-10-25,800000,-90968,2054,-44.28821811100292
"129 DUANE STREET, 5T",2005-05-17,3700000,2018-01-16,3495000,-205000,4627,-44.30516533390966
"220 RIVERSIDE BOULEVARD, 8S",2005-05-05,845000,2012-09-05,725000,-120000,2680,-44.776119402985074
"130 BARROW STREET, 314",2006-11-20,850000,2011-06-16,775000,-75000,1669,-44.93708807669263
"230 RIVERSIDE DRIVE, 16B",2007-06-28,768778,2012-04-13,690000,-78778,1751,-44.99029126213592
"706 RIVERSIDE DRIVE, 9B",2008-02-12,248541,2012-08-03,175000,-73541,1634,-45.006731946144434
"1623 THIRD AVENUE, 15G",2007-01-29,632000,2009-01-08,600000,-32000,710,-45.070422535211264
"401 EAST 84TH STREET, 16C",2007-05-14,1295000,2010-01-29,1250000,-45000,991,-45.40867810292634
"382 CENTRAL PARK WEST, 7U",2010-12-06,550000,2013-01-09,515000,-35000,765,-45.751633986928105
"127 EAST 30TH STREET, 8C",2007-03-28,735000,2011-09-14,660000,-75000,1631,-45.98405885959534
"45 PARK AVENUE, 606",2007-12-06,1277903,2012-07-25,1200000,-77903,1693,-46.01476668635558
"7 ESSEX STREET, 19",2005-04-14,1272812,2009-08-12,1200000,-72812,1581,-46.05439595192916
"230 RIVERSIDE DRIVE, 18D",2008-06-30,574000,2013-06-27,490000,-84000,1823,-46.07789358200768
"205 EAST 85TH   STREET, 5F",2009-05-07,650125,2012-01-11,605000,-45125,979,-46.09295199182839
"200 CHAMBERS STREET, 4L",2007-03-19,931698,2012-05-09,845000,-86698,1878,-46.16506922257721
"20 WEST STREET, 35H",2006-11-29,441090,2009-08-21,395000,-46090,996,-46.27510040160642
"211 MADISON AVENUE, 5B",2008-07-01,1308451,2015-03-18,1195000,-113451,2451,-46.28763769889841
"250 EAST 54 STREET, 21E",2005-05-25,435000,2008-01-22,390000,-45000,972,-46.2962962962963
"182 EAST 2ND   STREET, 1C",2007-07-10,645000,2011-08-26,575000,-70000,1508,-46.41909814323608
"148 MADISON STREET, 10B",2004-01-14,268710,2012-01-25,132500,-136210,2933,-46.44050460279577
"845 UNITED NATIONS PLAZA, 63C",2008-05-28,3850000,2017-03-29,3700000,-150000,3227,-46.482801363495504
"18 WEST 48TH   STREET, 26C",2007-06-13,1273830,2012-07-12,1187500,-86330,1856,-46.51400862068966
"464 WEST 44TH   STREET, 4G",2008-02-05,774878,2011-01-11,725000,-49878,1071,-46.57142857142857
"845 UNITED NATIONS PLAZA, 21C",2005-09-28,1200000,2011-04-29,1105000,-95000,2039,-46.59146640510054
"425 5 AVENUE, 41D",2007-09-06,1200000,2013-07-10,1100000,-100000,2134,-46.860356138706656
"516 WEST 47TH STREET, N3F",2007-07-25,868000,2012-02-07,790000,-78000,1658,-47.04463208685163
"425 MAIN STREET, 12M",2007-09-06,785000,2013-01-14,692760,-92240,1957,-47.13336739908023
"1760 SECOND AVENUE, 21A",2005-12-13,760000,2010-08-04,680000,-80000,1695,-47.1976401179941
"166 EAST 63RD STREET, 11F",2006-03-08,1150000,2009-12-11,1085000,-65000,1374,-47.30713245997089
"82 BEAVER STREET, 1405",2007-05-08,1415367,2018-08-10,1220000,-195367,4112,-47.5114299610895
"425 MAIN STREET, 8N",2007-06-21,798000,2009-12-10,755000,-43000,903,-47.61904761904762
"425 MAIN STREET, 4S",2007-09-06,708000,2012-07-25,623000,-85000,1784,-47.6457399103139
"280 RECTOR PLACE, 7D",2006-09-13,444000,2011-08-17,358000,-86000,1799,-47.80433574207893
"40 EAST 66TH STREET, 9A",2008-11-17,6669537,2012-11-07,6600000,-69537,1451,-47.92350103376982
"500 WEST 43RD STREET, 21C",2006-06-05,677500,2010-11-05,600000,-77500,1614,-48.01734820322181
"350 WEST 42ND STREET, 25F",2007-04-12,857000,2011-12-14,775000,-82000,1707,-48.03749267721148
"80 JOHN STREET, 7G",2007-08-30,928389,2012-11-30,836000,-92389,1919,-48.14434601354872
"155 EAST 38 STREET, 17A",2005-06-29,562500,2011-04-26,460000,-102500,2127,-48.18993888105312
"257 WEST 117TH STREET, 5F",2008-07-22,636406,2018-08-20,458850,-177556,3681,-48.235805487639226
"455 MAIN STREET, 16K",2006-04-27,651680,2011-08-31,557500,-94180,1952,-48.247950819672134
"211 EAST 46TH   STREET, 28A",2008-09-29,739292,2012-05-22,675000,-64292,1331,-48.30353117956424
"90 WILLIAM STREET, 16F",2008-08-12,771833,2012-12-19,695000,-76833,1590,-48.322641509433964
"400 EAST 51ST   STREET, 5E",2007-11-15,2477500,2013-05-24,2380000,-97500,2017,-48.339117501239464
"524 EAST 72ND   STREET, 27G",2008-02-06,615000,2012-12-18,529000,-86000,1777,-48.39617332583005
"425 MAIN STREET, 3M",2007-05-31,516000,2011-12-22,435000,-81000,1666,-48.619447779111646
"15 WILLIAM STREET, 35C",2009-03-16,1242265,2014-08-27,1145000,-97265,1990,-48.87688442211055
"59 JOHN STREET, 2A",2007-08-15,840056,2010-06-04,790000,-50056,1024,-48.8828125
"404 EAST 79TH STREET, 4H",2005-07-27,950000,2010-08-09,860000,-90000,1839,-48.939641109298535
"330 EAST 49TH STREET, 2H",2007-08-29,445000,2010-06-15,395000,-50000,1021,-48.97159647404506
"160 CENTRAL PARK SOUTH, 1120",2008-07-21,1100000,2017-06-29,940000,-160000,3265,-49.004594180704444
"10 WEST END AVENUE, 23A",2008-02-15,1629200,2012-07-19,1550000,-79200,1616,-49.00990099009901
"455 MAIN STREET, 12G",2006-04-06,344760,2007-02-01,330000,-14760,301,-49.03654485049834
"200 WEST END AVENUE, 9B",2008-07-23,992793,2012-04-26,925000,-67793,1373,-49.37581937363438
"425 MAIN STREET, 11M",2007-09-06,771000,2012-10-26,678202,-92798,1877,-49.43953116675546
"340 EAST 23RD   STREET, PH1A",2008-06-20,1477151,2013-10-30,1380000,-97151,1958,-49.61746680286006
"15 WILLIAM STREET, 24F",2009-03-19,1069162,2013-07-30,990000,-79162,1594,-49.6624843161857
"148 MADISON STREET, 10C",2004-01-14,288990,2012-01-25,142500,-146490,2933,-49.945448346403
"15 WILLIAM STREET, 35B",2009-04-09,1226991,2018-05-29,1060000,-166991,3337,-50.04225352112676
"350 WEST 42ND STREET, 26L",2006-09-12,1109892,2011-01-20,1030000,-79892,1591,-50.214959145191706
"505 WEST 47TH   STREET, 1E-N",2009-12-03,456300,2011-06-28,427500,-28800,572,-50.34965034965035
"1600 BROADWAY, 11G",2006-07-27,1359363,2010-11-18,1280000,-79363,1575,-50.38920634920635
"50 PINE STREET, 11S",2007-01-30,1287369,2013-12-30,1160000,-127369,2526,-50.42319873317498
"15 WILLIAM STREET, 36F",2009-04-01,1226991,2013-09-13,1145000,-81991,1626,-50.424969249692495
"100 RIVERSIDE BOULEVARD, 22E",2008-07-17,1186261,2010-12-31,1141000,-45261,897,-50.458193979933114
"184 THOMPSON STREET, 5N",2007-06-20,840056,2010-03-08,790000,-50056,992,-50.45967741935484
"220 RIVERSIDE BOULEVARD, 36D",2007-07-10,3250000,2011-11-10,3170000,-80000,1584,-50.505050505050505
"450 EAST 83RD STREET, 21B",2007-04-11,5151250,2018-03-02,4950000,-201250,3978,-50.590749120160886
"158 HESTER STREET, 6F",2006-08-18,890968,2016-04-07,712775,-178193,3520,-50.623011363636365
"425 MAIN STREET, 7S",2007-09-06,740000,2012-07-18,650000,-90000,1777,-50.64715813168261
"90 WILLIAM STREET, 6C",2008-07-22,870604,2011-10-26,810000,-60604,1191,-50.88497061293031
"82 BEAVER STREET, 905",2007-04-06,1257538,2012-08-02,1158500,-99038,1945,-50.919280205655525
"15 WEST 63RD STREET, 14B",2006-11-02,2550000,2013-07-17,2425000,-125000,2449,-51.041241322988974
"455 CENTRAL PARK WEST, 4",2005-12-14,556880,2012-09-20,430000,-126880,2472,-51.32686084142395
"300 CATHEDRAL PARKWAY, 1K",2005-10-20,487500,2018-08-07,247517,-239983,4674,-51.34424475823705
"393 WEST 49TH   STREET, 2FF",2010-03-24,400714,2012-09-28,353500,-47214,919,-51.37540805223068
"200 WEST END AVENUE, 7B",2008-06-02,962704,2010-12-16,915000,-47704,927,-51.46062567421791
"170 EAST 87TH   STREET, W4G",2008-06-12,1250000,2012-06-04,1175000,-75000,1453,-51.6173434273916
"865 FIRST AVENUE, 8B",2007-11-07,498000,2012-03-12,416000,-82000,1587,-51.6698172652804
"450 EAST 83RD   STREET, 2B",2007-12-10,661862,2015-02-25,525000,-136862,2634,-51.959757023538344
"15 BROAD STREET, 1214",2006-06-15,1008067,2017-05-30,800000,-208067,4002,-51.990754622688655
"350 EAST 82ND   STREET, 12C",2007-04-16,789143,2010-09-22,723750,-65393,1255,-52.10597609561753
"1600 BROADWAY, 8F",2006-07-10,717866,2011-08-31,620000,-97866,1878,-52.11182108626198
"230 RIVERSIDE DRIVE, PHJ",2008-06-30,895000,2013-06-27,800000,-95000,1823,-52.11190345584202
"200 CHAMBERS STREET, 4J",2007-02-27,811545,2010-05-21,750000,-61545,1179,-52.20101781170484
"75 WALL STREET, 18I",2009-02-09,605858,2012-03-12,547000,-58858,1127,-52.225377107364686
"10 WEST END AVENUE, 20C",2007-08-22,1669140,2012-04-20,1580000,-89140,1703,-52.3429242513212
"66 LEONARD STREET, 4C",2005-02-09,2500000,2008-03-31,2440000,-60000,1146,-52.35602094240838
"309 EAST 49TH STREET, 2E",2010-04-22,965000,2012-11-01,916500,-48500,924,-52.489177489177486
"1600 BROADWAY, 21C",2006-07-17,1761572,2012-06-26,1647500,-114072,2171,-52.543528327959464
"342 EAST 110 STREET, 1A",2008-07-31,400000,2011-02-09,351400,-48600,923,-52.65438786565547
"99 BATTERY PLACE, 16-C",2015-06-22,1170000,2018-01-25,1120000,-50000,948,-52.742616033755276
"150 WEST 56TH STREET, 3605",2007-11-20,1370000,2010-06-23,1320000,-50000,946,-52.854122621564485
"350 WEST 42ND STREET, 6L",2006-06-05,967337,2010-07-15,888000,-79337,1501,-52.856095936042635
"635 WEST 42ND   STREET, 20A",2008-02-29,987702,2013-03-14,890000,-97702,1840,-53.09891304347826
"261 WEST 28TH STREET, 2D",2007-11-16,840056,2011-09-28,765000,-75056,1412,-53.155807365439095
"59 JOHN STREET, 6A",2007-12-26,940000,2013-05-21,835000,-105000,1973,-53.21844906234161
"300 EAST 62ND   STREET, 404",2009-05-07,735000,2012-06-01,675000,-60000,1121,-53.52363960749331
"425 MAIN STREET, 6S",2007-09-06,731000,2012-03-28,641556,-89444,1665,-53.72012012012012
"171 EAST 84TH STREET, 4D1",2005-06-16,875000,2014-05-12,700000,-175000,3252,-53.8130381303813
"301 EAST 45TH   STREET, 3A",2008-04-30,580000,2011-02-15,525000,-55000,1021,-53.86875612144956
"347 WEST 57TH   STREET, 28-BB",2007-05-17,515000,2010-07-19,452500,-62500,1159,-53.92579810181191
"344 WEST 23RD STREET, 1B",2005-10-28,1230000,2012-03-02,1105000,-125000,2317,-53.949072075960295
"225 EAST 34TH STREET, 19D",2007-12-10,946972,2011-05-04,880000,-66972,1241,-53.96615632554391
"333 EAST 30TH   STREET, 17-K",2010-06-23,715000,2016-04-13,600000,-115000,2121,-54.21970768505422
"120 RIVERSIDE BOULEVARD, 10A",2006-01-31,1272812,2014-10-15,1100000,-172812,3179,-54.36049072035231
"1420 YORK AVENUE, 7H",2007-06-25,417942,2011-11-21,330000,-87942,1610,-54.62236024844721
"100 RIVERSIDE BOULEVARD, 19F",2008-07-21,2469256,2013-04-08,2375000,-94256,1722,-54.736353077816496
"15 WEST 53RD   STREET, 22C",2008-09-02,1250000,2013-02-28,1160000,-90000,1640,-54.8780487804878
"300 CATHEDRAL PARKWAY, 9J",2007-08-16,500000,2012-05-11,405000,-95000,1730,-54.91329479768786
"225 EAST 34TH STREET, 4K",2007-10-04,860421,2011-04-08,790000,-70421,1282,-54.930577223088925
"10 WEST END AVENUE, 20D",2007-08-30,1514112,2010-05-11,1460000,-54112,985,-54.93604060913706
"2322 ADAM C POWELL BLVD, 4F",2007-10-23,470000,2012-06-08,377000,-93000,1690,-55.02958579881657
"455 MAIN STREET, 16F",2006-06-27,697501,2011-05-16,599000,-98501,1784,-55.21356502242153
"111 FULTON STREET, 515",2008-12-12,779950,2012-05-31,710000,-69950,1266,-55.25276461295419
"158 EAST 100 STREET, 5R",2007-03-06,425880,2009-09-09,375000,-50880,918,-55.42483660130719
"225 5 AVENUE, 10B",2007-04-13,1552831,2008-08-26,1525000,-27831,501,-55.550898203592816
"635 WEST 42ND STREET, 31F",2007-08-31,1354272,2012-10-15,1250000,-104272,1872,-55.7008547008547
"300 EAST 93RD   STREET, 28E",2009-05-27,645000,2011-12-20,592800,-52200,937,-55.70971184631804
"15 WILLIAM STREET, 16D",2008-12-03,865512,2013-09-16,768000,-97512,1748,-55.784897025171624
"201 WEST 74TH STREET, 15G",2008-06-27,350000,2012-05-31,270000,-80000,1434,-55.78800557880056
"55 WALL STREET, 824",2007-04-05,853860,2018-06-11,625000,-228860,4085,-56.024479804161565
"301 CATHEDRAL PARKWAY, 12B",2006-04-12,445000,2010-11-24,350000,-95000,1687,-56.31298162418494
"15 BROAD STREET, 3620",2007-05-09,2725011,2012-10-26,2612500,-112511,1997,-56.340010015022536
"845 UNITED NATIONS PLAZA, 52D",2003-09-15,1425550,2004-02-06,1417404,-8146,144,-56.56944444444444
"82 BEAVER STREET, 201",2007-02-28,902967,2010-12-07,825000,-77967,1378,-56.57982583454282
"305 WEST 18TH   STREET, 3F",2007-04-18,679000,2009-08-31,630000,-49000,866,-56.581986143187066
"100 RIVERSIDE BOULEVARD, 18C",2008-06-05,2194328,2012-12-27,2100000,-94328,1666,-56.619447779111646
"505 WEST 47TH   STREET, 4D-N",2009-11-23,855000,2012-05-04,804417,-50583,893,-56.64389697648376
"377 RECTOR PLACE, 5B",2006-12-01,615000,2009-04-30,565000,-50000,881,-56.75368898978434
"1760 SECOND AVENUE, 15E",2005-09-12,680000,2008-02-06,630000,-50000,877,-57.01254275940707
"188 EAST 78TH STREET, 5E",2005-05-17,2650000,2017-04-24,2400000,-250000,4360,-57.3394495412844
"55 WALL STREET, 605",2008-03-24,1031354,2015-09-03,875000,-156354,2719,-57.50422949613829
"270 WEST 19TH STREET, 1A",2005-11-10,1400093,2011-10-14,1275000,-125093,2164,-57.80637707948244
"2628 BROADWAY, 35A",2008-04-03,3258400,2013-05-22,3150000,-108400,1875,-57.81333333333333
"1049 5 AVENUE, 6C",2008-09-26,2200000,2013-06-19,2100000,-100000,1727,-57.903879559930516
"555 WEST 23RD STREET, S11D",2006-05-08,860421,2011-05-02,755000,-105421,1820,-57.92362637362638
"77 WEST 55TH STREET, 15B",2006-03-14,1282500,2010-02-03,1200000,-82500,1422,-58.016877637130804
"52 PARK AVENUE, 16",2006-05-22,1629200,2011-01-24,1530000,-99200,1708,-58.07962529274005
"80 JOHN STREET, 19B",2007-05-03,1377895,2013-06-18,1247500,-130395,2238,-58.26407506702413
"100 RIVERSIDE BOULEVARD, 8C",2008-07-22,1320415,2011-11-11,1250000,-70415,1207,-58.33885666942833
"15 BROAD STREET, 3122",2007-01-31,1215067,2010-02-17,1150000,-65067,1113,-58.460916442048514
"92 WARREN STREET, 6(5E)",2007-03-13,3462050,2010-02-02,3400000,-62050,1057,-58.7038789025544
"455 MAIN STREET, 12D",2006-02-03,625000,2011-06-13,510000,-115000,1956,-58.79345603271984
"505 GREENWICH STREET, 7F",2005-01-06,931698,2013-03-08,756200,-175498,2983,-58.83271873952397
"421 EAST 13TH   STREET, 7K",2008-03-28,1114983,2012-06-04,1025000,-89983,1529,-58.85088293001962
"40 BROAD STREET, 15C",2012-07-27,1069162,2018-02-09,950000,-119162,2023,-58.90360850222442
"1420 YORK AVENUE, 7K",2007-10-17,425000,2009-12-22,378000,-47000,797,-58.971141781681304
"725 RIVERSIDE DRIVE, 5G",2007-11-15,314340,2009-10-02,273780,-40560,687,-59.03930131004367
"206 FIRST AVENUE, 1B",2006-01-17,1148000,2012-12-14,999000,-149000,2523,-59.05667855727309
"330 EAST 33RD   STREET, 11-E",2009-11-18,298866,2012-12-13,232500,-66366,1121,-59.20249776984835
"261 WEST 28TH STREET, 5D",2007-11-09,936790,2012-05-11,839000,-97790,1645,-59.4468085106383
"120 GREENWICH STREET, 12F",2006-10-23,799326,2009-07-15,740000,-59326,996,-59.56425702811245
"2000 BROADWAY, 11E",2008-09-15,875000,2011-06-16,815000,-60000,1004,-59.7609561752988
"421 EAST 13TH   STREET, 5B",2008-01-25,682410,2011-02-22,615000,-67410,1124,-59.97330960854092
"200 EAST 61ST   STREET, 37C",2007-05-21,820000,2010-07-29,750000,-70000,1165,-60.08583690987125
"41 WEST 72ND STREET, 15G",2005-07-26,780000,2009-03-18,700000,-80000,1331,-60.10518407212622
"60 EAST 55TH   STREET, 39A",2007-11-02,1909218,2012-10-19,1800000,-109218,1813,-60.24158852730281
"10 WEST END AVENUE, 24C",2007-08-29,1823756,2012-08-07,1715000,-108756,1805,-60.252631578947366
"350 WEST 50TH STREET, 4F",2006-11-15,670000,2010-01-14,600000,-70000,1156,-60.55363321799308
"120 RIVERSIDE BOULEVARD, 4A",2006-03-20,906242,2011-03-31,795000,-111242,1837,-60.556341861731084
"200 RECTOR PLACE, 25L",2005-11-30,550000,2010-02-24,456300,-93700,1547,-60.568842921784096
"203 WEST 90TH STREET, 4G",2006-06-01,1335000,2012-06-29,1200000,-135000,2220,-60.810810810810814
"500 WEST 43RD STREET, 27B",2008-10-24,884000,2012-08-01,800000,-84000,1377,-61.00217864923747
"200 WEST END AVENUE, 21A",2009-10-01,2136400,2015-11-13,2000000,-136400,2234,-61.05640107430618
"100 RIVERSIDE BOULEVARD, 11C",2008-04-25,1425550,2012-07-20,1331000,-94550,1547,-61.11829347123465
"211 EAST 46TH   STREET, 9F",2008-09-11,1303360,2012-03-16,1225000,-78360,1282,-61.123244929797195
"169 HUDSON STREET, 2S",2011-04-27,5200000,2016-11-29,5075000,-125000,2043,-61.18453255017132
"404 EAST 79TH STREET, 18B",2005-12-02,725000,2009-09-21,640000,-85000,1389,-61.19510439164867
"22 GRAMERCY PARK SOUTH, 1",2012-08-07,992793,2016-09-30,900000,-92793,1515,-61.24950495049505
"120 RIVERSIDE BOULEVARD, PH4E",2006-03-17,897587,2011-01-06,790000,-107587,1756,-61.268223234624145
"467 CENTRAL PARK WEST, 9A",2006-04-03,1310996,2010-11-16,1207500,-103496,1688,-61.312796208530806
"280 PARK AVENUE SOUTH, 20L",2007-03-20,1476462,2011-09-26,1375000,-101462,1651,-61.45487583282859
"420 WEST 25TH   STREET, 6B",2008-01-25,1069162,2012-09-13,965000,-104162,1693,-61.52510336680449
"1600 BROADWAY, 6D",2006-05-25,1028432,2012-01-25,900000,-128432,2071,-62.01448575567359
"90 WILLIAM STREET, 5D",2008-06-06,667972,2010-07-19,620000,-47972,773,-62.059508408796894
"779 RIVERSIDE DRIVE, C-24",2009-07-27,300000,2015-04-10,170000,-130000,2083,-62.40998559769563
"106 CENTRAL PARK SOUTH, 14F",2008-02-08,780000,2010-04-19,730000,-50000,801,-62.421972534332085
"20 WEST STREET, 33D",2006-06-22,743322,2012-04-19,610000,-133322,2128,-62.651315789473685
"10 WEST END AVENUE, 16B",2007-08-15,1596794,2011-11-01,1500000,-96794,1539,-62.89408706952567
"635 WEST 42ND STREET, 37E",2007-07-09,1430641,2012-04-30,1320000,-110641,1757,-62.97154240182129
"525 EAST 11TH STREET, 6D",2008-07-31,1575000,2011-11-04,1500000,-75000,1191,-62.97229219143577
"225 EAST 34TH STREET, 4A",2007-11-21,556335,2012-01-27,460000,-96335,1528,-63.04646596858639
"250 EAST 54TH   STREET, 25D",2007-08-21,995000,2011-07-18,905000,-90000,1427,-63.06937631394534
"1400 FIFTH AVENUE, 6D",2004-12-16,293830,2006-06-01,260145,-33685,532,-63.317669172932334
"309 EAST 49TH STREET, 11D",2005-10-27,1220000,2011-11-16,1080000,-140000,2211,-63.319764812302125
"82 BEAVER STREET, 208",2007-05-04,650661,2010-07-15,576450,-74211,1168,-63.53681506849315
"40 WEST 116 STREET, A605",2008-11-20,768060,2010-02-04,740000,-28060,441,-63.6281179138322
"768 5 AVENUE, 510",2008-01-31,4619780,2017-06-27,4400000,-219780,3435,-63.9825327510917
"150 NASSAU STREET, 16A",2003-03-27,1114984,2018-06-28,757500,-357484,5572,-64.15721464465183
"15 BROAD STREET, 2924",2007-02-23,1323725,2010-04-16,1250000,-73725,1148,-64.22038327526133
"41 WEST 72ND STREET, 17H",2006-06-14,836050,2010-10-04,735000,-101050,1573,-64.24030514939606
"160 CENTRAL PARK SOUTH, 1005",2007-06-12,3818437,2011-02-24,3731500,-86937,1353,-64.2549889135255
"330 EAST 38 STREET, 20D",2007-05-18,1450000,2009-07-03,1400000,-50000,777,-64.35006435006434
"66 LEONARD STREET, 4B-5B",2006-01-30,1950000,2008-04-17,1898000,-52000,808,-64.35643564356435
"360 WEST 28TH   STREET, 5B",2007-04-19,700000,2013-03-29,560000,-140000,2171,-64.48641179180102
"55 WALL STREET, 703",2007-07-19,743379,2013-05-30,605000,-138379,2142,-64.60270774976658
"200 RECTOR PLACE, 28A",2007-10-17,660000,2012-06-27,549000,-111000,1715,-64.72303206997084
"15 WILLIAM STREET, 8H",2009-04-09,1578287,2014-09-09,1450000,-128287,1979,-64.82415361293583
"59 JOHN STREET, 11B",2007-09-18,1781937,2011-02-28,1700000,-81937,1259,-65.08101667990469
"15 WILLIAM STREET, 17C",2009-10-20,999000,2013-07-18,910000,-89000,1367,-65.10607168983175
"230 RIVERSIDE DRIVE, 8B",2007-04-04,707683,2011-10-13,600000,-107683,1653,-65.14398064125832
"516 WEST 47TH   STREET, N6K",2007-12-18,525000,2012-02-28,425000,-100000,1533,-65.23157208088715
"350 WEST 42ND   STREET, PH H",2006-12-11,1107518,2011-06-30,999000,-108518,1662,-65.29362214199759
"160 WEST 12TH STREET, 86",2016-04-27,7500425,2018-06-08,7450000,-50425,772,-65.31735751295336
"635 WEST 42ND STREET, 3L",2007-08-06,799326,2010-06-16,731000,-68326,1045,-65.38373205741627
"350 EAST 30TH   STREET, 1L",2007-05-07,602000,2010-12-22,515000,-87000,1325,-65.66037735849056
"300 RECTOR PLACE, 8M",2007-06-12,465000,2011-08-10,365000,-100000,1520,-65.78947368421052
"1420 YORK AVENUE, 6G",2006-10-26,425000,2011-10-24,305000,-120000,1824,-65.78947368421052
"25 CENTRAL PARK WEST, 14S",2017-10-10,1995000,2018-08-09,1975000,-20000,303,-66.00660066006601
"18 WEST 48TH STREET, 32D",2007-06-06,1501918,2017-06-15,1260000,-241918,3662,-66.06171490988531
"220 EAST 65TH STREET, 9H",2006-08-24,1250000,2014-12-03,1050000,-200000,3023,-66.15944426066821
"125 WEST 22ND   STREET, 12A",2008-07-16,1765136,2010-05-28,1720000,-45136,681,-66.27900146842879
"40 BROAD STREET, 17H",2009-09-08,1416000,2018-08-03,1200000,-216000,3251,-66.44109504767763
"11 EAST 36TH   STREET, 605",2007-05-03,1105813,2012-09-20,974450,-131363,1967,-66.78342653787493
"150 NASSAU STREET, 13A",2003-03-17,970000,2013-08-05,716000,-254000,3794,-66.9478123352662
"524 EAST 72ND STREET, 31C",2005-08-04,1375000,2012-12-12,1195000,-180000,2687,-66.98920729438035
"400 EAST 90TH STREET, 3H",2007-11-29,778961,2013-05-20,645000,-133961,1999,-67.01400700350175
"300 EAST 23RD   STREET, 17C",2012-07-13,2160000,2017-11-01,2030000,-130000,1937,-67.11409395973155
"350 WEST 53RD STREET, 6C",2006-03-20,1360000,2010-01-27,1265000,-95000,1409,-67.4237047551455
"50 WEST 15TH STREET, 1E",2008-12-05,1547740,2010-08-30,1505000,-42740,633,-67.51974723538704
"456 WEST 167 STREET, 7D",2015-04-06,911333,2018-05-07,835000,-76333,1127,-67.73114463176574
"300 CATHEDRAL PARKWAY, 16K",2005-08-12,495000,2011-03-24,356000,-139000,2050,-67.8048780487805
"55 WEST 131 STREET, E-2",2005-10-19,421000,2009-09-16,324000,-97000,1428,-67.92717086834733
"610 WEST 110TH STREET, 10E",2008-08-12,1415367,2012-06-13,1320000,-95367,1401,-68.07066381156316
"16 WEST 19TH   STREET, 2-C",2007-11-30,1008067,2008-08-21,990000,-18067,265,-68.17735849056604
"100 RIVERSIDE BOULEVARD, 5T",2008-02-19,804417,2012-04-27,700000,-104417,1529,-68.29103989535645
"436 EAST 11 STREET, 3",2003-01-21,980000,2003-08-28,965000,-15000,219,-68.4931506849315
"1600 BROADWAY, PH5A",2006-08-17,1374637,2017-07-18,1100000,-274637,3988,-68.86584754262789
"15 WILLIAM STREET, 36C",2009-03-31,1252447,2013-04-12,1151000,-101447,1473,-68.87101154107265
"111 CENTRAL PARK NORTH, 14C",2007-10-24,1924401,2012-09-28,1800000,-124401,1801,-69.07329261521377
"5 EAST 22ND STREET, 28-F",2004-09-14,1016213,2006-05-03,975000,-41213,596,-69.1493288590604
"220 RIVERSIDE BOULEVARD, 5B",2005-07-15,925000,2008-11-21,840000,-85000,1225,-69.38775510204081
"300 ALBANY STREET, 9A",2006-10-27,368000,2012-09-25,218010,-149990,2160,-69.43981481481481
"120 GREENWICH STREET, 12J",2006-08-31,587530,2011-05-18,468000,-119530,1721,-69.45380592678676
"80 JOHN STREET, 10D/E",2007-01-24,1102815,2013-01-31,950000,-152815,2199,-69.49295134151888
"25 WEST HOUSTON STREET, PHB",2005-04-06,2250000,2011-12-16,2080000,-170000,2445,-69.52965235173824
"200 RECTOR PLACE, 20D",2006-12-15,635000,2016-08-26,387500,-247500,3542,-69.87577639751552
"40 BROAD STREET, 17B",2011-07-22,893668,2015-03-18,800000,-93668,1335,-70.16329588014982
"1 IRVING PLACE, U20A",2005-11-22,2000000,2011-03-28,1862500,-137500,1952,-70.44057377049181
"520 WEST 19TH STREET, 5B",2008-09-19,3054750,2011-10-26,2975000,-79750,1132,-70.45053003533569
"392 CENTRAL PARK WEST, 18L",2010-10-22,640000,2018-03-09,450000,-190000,2695,-70.50092764378479
"230 RIVERSIDE DRIVE, 5F",2008-06-30,425000,2010-10-28,365040,-59960,850,-70.54117647058824
"555 WEST 59TH STREET, 21E",2008-04-22,1120075,2013-02-27,995000,-125075,1772,-70.58408577878104
"261 WEST 28TH STREET, 4C",2007-11-15,809508,2009-08-06,765000,-44508,630,-70.64761904761905
"700 RIVERSIDE DRIVE, 2C",2010-01-29,281285,2014-03-13,175000,-106285,1504,-70.66821808510639
"253 WEST 73RD STREET, 3A",2005-02-04,1475000,2011-11-08,1300000,-175000,2468,-70.90761750405187
"421 HUDSON STREET, 603",2005-09-26,1625000,2010-12-08,1490000,-135000,1899,-71.09004739336493
"165 CHARLES STREET, RU7",2005-10-03,1451006,2012-07-13,1275000,-176006,2475,-71.11353535353535
"450 EAST 83RD STREET, 18C",2007-06-04,2026317,2012-04-13,1900000,-126317,1775,-71.16450704225352
"736 WEST 187 STREET, 601",2005-10-18,771833,2012-10-15,590000,-181833,2554,-71.1953797963978
"240 PARK AVENUE SOUTH, 9C",2008-04-07,2291062,2010-03-25,2240000,-51062,717,-71.21617852161785
"635 WEST 42ND STREET, 9J",2007-11-16,672045,2010-09-01,599000,-73045,1020,-71.61274509803921
"845 UNITED NATIONS PLAZA, 9D",2006-10-11,2100000,2012-07-02,1950000,-150000,2091,-71.73601147776183
"158 HESTER STREET, PH-C",2006-11-30,995000,2011-09-07,870000,-125000,1742,-71.75660160734787
"392 CENTRAL PARK WEST, 9H",2004-06-24,410670,2018-03-09,50000,-360670,5006,-72.04754294846184
"77 PARK AVENUE, 12E",2008-01-28,2400000,2018-02-20,2135000,-265000,3676,-72.0892274211099
"359 EAST 68TH STREET, 3B",2005-12-12,600490,2009-09-23,500738,-99752,1381,-72.23171614771904
"50 PINE STREET, 5N",2008-08-04,1500000,2011-06-03,1425000,-75000,1033,-72.60406582768636
"340 EAST 23RD STREET, 4M",2008-02-22,1710660,2012-01-30,1606000,-104660,1438,-72.7816411682893
"425 5 AVENUE, 34D",2007-05-03,1625000,2011-02-04,1525000,-100000,1373,-72.83321194464676
"18 WEST 48TH STREET, 29D",2007-06-06,1091361,2012-05-04,960000,-131361,1794,-73.22240802675586
"768 FIFTH AVENUE, 1410",2007-07-26,2654005,2013-03-29,2500000,-154005,2073,-74.29088277858176
"200 EAST 89TH   STREET, 11D",2010-03-09,575000,2011-04-28,544000,-31000,415,-74.6987951807229
"219 WEST 80TH STREET, 7B",2007-05-15,1510000,2011-05-19,1400000,-110000,1465,-75.08532423208192
"57 WEST 58 STREET, 9E",2004-11-29,575000,2011-07-20,392631,-182369,2424,-75.23473597359735
"45 PARK AVENUE, 2101",2008-02-08,2800187,2013-07-25,2650000,-150187,1994,-75.31945837512538
"200 CHAMBERS STREET, 6L",2007-03-28,870603,2010-03-02,790000,-80603,1070,-75.32990654205608
"300 EAST 79TH STREET, 12A",2008-09-26,1578287,2013-03-20,1455000,-123287,1636,-75.35880195599022
"211 EAST 46TH   STREET, 34D",2008-10-07,736378,2012-01-30,645000,-91378,1210,-75.51900826446281
"1623 THIRD AVENUE, 33D",2006-03-29,660000,2009-08-27,565000,-95000,1247,-76.18283881315156
"75 WALL STREET, 23D",2008-11-19,773870,2012-12-21,660000,-113870,1493,-76.26925653047556
"252 SEVENTH AVENUE, 5Z",2006-01-11,1020000,2010-05-03,900000,-120000,1573,-76.28734901462174
"52 WEST 22ND STREET, 4",2008-06-02,1420458,2012-09-18,1300000,-120458,1569,-76.77374123645635
"80 JOHN STREET, 20C",2008-05-02,1015400,2012-06-13,900000,-115400,1503,-76.7797737857618
"220 RIVERSIDE BOULEVARD, 14A",2008-06-20,998000,2011-06-06,915000,-83000,1081,-76.78075855689177
"205 EAST 85TH   STREET, 14CD",2009-09-16,4318914,2013-01-17,4225000,-93914,1219,-77.04183757178015
"55 WALL STREET, 733",2007-08-10,814600,2014-01-28,632500,-182100,2363,-77.06305543800254
"420 WEST 25TH   STREET, 9B",2009-04-23,2087412,2015-12-18,1900000,-187412,2430,-77.12427983539095
"78 LAIGHT STREET, 5A",2008-11-13,4774574,2011-07-07,4700000,-74574,966,-77.19875776397515
"230 RIVERSIDE DRIVE, 18E",2007-06-18,758596,2009-07-15,699999,-58597,758,-77.3047493403694
"2628 BROADWAY, 6C",2007-10-12,2087412,2013-05-07,1929700,-157712,2034,-77.5378564405113
"71 NASSAU STREET, 7C",2008-03-31,960000,2012-05-24,842500,-117500,1515,-77.55775577557756
"10 WEST END AVENUE, 8F",2007-08-15,778961,2009-09-10,720000,-58961,757,-77.887714663144
"350 WEST 50TH   STREET, 4JJ",2007-06-26,570000,2010-03-08,493000,-77000,986,-78.09330628803245
"200 WEST END AVENUE, 10J",2008-02-25,1077308,2011-03-18,990000,-87308,1117,-78.16293643688451
"382 CENTRAL PARK WEST, 14B",2007-07-16,859000,2018-03-09,555000,-304000,3889,-78.1691951658524
"220 RIVERSIDE BOULEVARD, 7R",2005-11-03,880000,2011-06-07,720000,-160000,2042,-78.35455435847209
"1200 5 AVENUE, 1E",2008-10-23,763687,2013-04-22,635000,-128687,1642,-78.3721071863581
"200 WEST END AVENUE, 18C",2008-05-09,2851100,2010-07-29,2787500,-63600,811,-78.4217016029593
"249 EAST 48TH   STREET, 18B",2010-06-21,2100000,2017-06-12,1900000,-200000,2548,-78.49293563579278
"392 CENTRAL PARK WEST, 2E",2014-12-05,784300,2018-03-09,690602,-93698,1190,-78.73781512605042
"150 NASSAU STREET, 7I",2009-10-22,330000,2015-06-10,168000,-162000,2057,-78.75546912980069
"255 HUDSON STREET, 3E",2006-09-25,1384820,2011-12-08,1235000,-149820,1900,-78.85263157894737
"130 BEEKMAN STREET, 3C",2004-10-14,950000,2012-03-22,735000,-215000,2716,-79.16053019145802
"400 EAST 70TH STREET, 1901",2007-04-17,885000,2009-07-28,819000,-66000,833,-79.23169267707082
"595 WEST END AVENUE, 8C",2007-09-06,1568105,2010-11-22,1475000,-93105,1173,-79.37340153452685
"120 RIVERSIDE BOULEVARD, 4M",2006-07-06,855000,2011-03-01,720000,-135000,1699,-79.45850500294291
"635 WEST 42ND STREET, 34K",2007-07-30,1456097,2012-08-01,1310000,-146097,1829,-79.87807545106615
"308 EAST 72ND STREET, 12D",2005-12-09,3850000,2012-04-10,3665000,-185000,2314,-79.94814174589456
"252 SEVENTH AVENUE, 15I",2008-01-07,3750000,2011-06-09,3650000,-100000,1249,-80.0640512409928
"80 JOHN STREET, 8H",2007-04-20,441090,2009-05-22,380000,-61090,763,-80.06553079947575
"635 WEST 42ND STREET, 35D",2007-06-29,1306822,2011-02-14,1200000,-106822,1326,-80.55957767722474
"505 WEST 47TH   STREET, 6H-N",2010-07-26,593000,2011-09-08,560000,-33000,409,-80.68459657701712
"400 CENTRAL PARK WEST, 12U",2014-12-05,804540,2018-03-09,708424,-96116,1190,-80.76974789915967
"382 CENTRAL PARK WEST, 4T",2014-12-05,804540,2018-03-09,708424,-96116,1190,-80.76974789915967
"500 WEST END AVENUE, 8Z",2006-05-05,430950,2007-06-04,399000,-31950,395,-80.88607594936708
"200 EAST 66TH   STREET, D0804",2008-10-21,1435604,2009-09-04,1409874,-25730,318,-80.9119496855346
"1600 BROADWAY, 7A",2006-06-08,992793,2009-12-23,887500,-105293,1294,-81.37017001545595
"425 FIFTH AVENUE, 53B",2007-02-16,2698362,2015-06-17,2450000,-248362,3043,-81.61748274728886
"468 WEST 23RD STREET, 1B",2006-03-10,2112868,2013-06-26,1895000,-217868,2665,-81.75159474671669
"82 BEAVER STREET, 1003",2007-04-09,415740,2016-05-02,145002,-270738,3311,-81.76925400181214
"135 WEST 52ND STREET, 11A",2015-12-02,1934675,2018-05-03,1862000,-72675,883,-82.30464326160815
"1600 BROADWAY, PH6A",2006-10-03,1476462,2012-08-15,1300000,-176462,2143,-82.3434437704153
"812 RIVERSIDE DRIVE, 41",2008-09-23,763687,2017-09-22,492500,-271187,3286,-82.52799756542909
"150 WEST 26TH STREET, 202",2014-10-14,2000000,2017-12-07,1905000,-95000,1150,-82.6086956521739
"18 WEST 48TH   STREET, 25D",2007-06-06,1053888,2011-09-12,925000,-128888,1559,-82.67350865939704
"408 EAST 79TH STREET, 19B",2005-12-14,3450798,2013-02-04,3235000,-215798,2609,-82.71291682637026
"30 WEST 61ST STREET, 17A",2006-03-30,1415000,2010-01-11,1300000,-115000,1383,-83.1525668835864
"1 IRVING PLACE, V28C",2009-03-10,2900000,2012-06-21,2800000,-100000,1199,-83.40283569641367
"250 EAST 40TH STREET, 45B",2008-04-02,990000,2012-07-06,860000,-130000,1556,-83.54755784061696
"1600 BROADWAY, 21D",2006-07-27,1135348,2012-12-18,940000,-195348,2336,-83.625
"392 CENTRAL PARK WEST, 19D",2015-05-26,1815000,2017-07-11,1750000,-65000,777,-83.65508365508366
"65 NORTH MOORE STREET, 6A",2010-09-24,2680000,2012-07-12,2625000,-55000,657,-83.71385083713851
"1600 BROADWAY, 11B",2006-06-01,992793,2009-12-07,885064,-107729,1285,-83.83579766536965
"22 RIVERSIDE DRIVE, 4",2007-04-16,3207487,2012-10-03,3040000,-167487,1997,-83.8693039559339
"201 WEST 72ND STREET, 10N",2007-02-01,925000,2009-07-14,850000,-75000,894,-83.89261744966443
"1280 5 AVENUE, 16B",2013-06-19,3258400,2018-08-17,3100000,-158400,1885,-84.03183023872678
"1600 BROADWAY, PH6C",2006-08-16,2800187,2013-07-15,2588000,-212187,2525,-84.03445544554455
"322 WEST 57TH   STREET, 28K1",2008-03-11,1690295,2012-10-01,1550000,-140295,1665,-84.26126126126127
"1600 BROADWAY, 5D",2006-06-05,1023341,2009-07-22,926607,-96734,1143,-84.63167104111986
"20 WEST STREET, 22A",2006-05-26,405600,2016-04-25,99000,-306600,3622,-84.64936499171728
"404 EAST 79TH STREET, 12B",2007-05-24,720000,2009-08-27,650000,-70000,826,-84.7457627118644
"450 EAST 83RD   STREET, 3A",2007-04-04,1033523,2011-07-14,901000,-132523,1562,-84.84186939820742
"515 EAST 72ND   STREET, 17H",2008-02-14,1351218,2011-06-02,1249000,-102218,1204,-84.89867109634551
"215 WEST 88TH STREET, 7A",2008-01-07,885877,2011-06-02,780000,-105877,1242,-85.24718196457327
"300 WEST 135 STREET, 4S",2005-06-10,348884,2010-11-19,179000,-169884,1988,-85.45472837022133
"106 CENTRAL PARK SOUTH, 12M",2008-07-23,610000,2011-06-07,520000,-90000,1049,-85.79599618684462
"77 WEST 55TH   STREET, 12H",2008-01-29,799000,2009-12-16,740000,-59000,687,-85.8806404657933
"120 GREENWICH STREET, 5F",2006-09-15,710994,2009-11-10,612000,-98994,1152,-85.93229166666667
"120 GREENWICH STREET, 3G",2006-10-27,636406,2012-02-10,470250,-166156,1932,-86.00207039337474
"20 WEST STREET, 23G",2006-07-26,708499,2009-03-20,625000,-83499,968,-86.25929752066116
"25 5 AVENUE, 14F",2007-12-28,1392966,2009-05-08,1350000,-42966,497,-86.45070422535211
"161 WEST 61ST STREET, 3A",2007-10-23,1020000,2010-05-04,940000,-80000,924,-86.58008658008659
"215 EAST 81ST   STREET, PHB",2009-11-09,456300,2017-03-01,225000,-231300,2669,-86.66167103784188
"20 WEST STREET, 43B",2007-06-21,770000,2016-04-18,490000,-280000,3224,-86.848635235732
"100 RIVERSIDE BOULEVARD, 26D",2008-10-10,2509986,2012-03-29,2400000,-109986,1266,-86.87677725118483
"313 WEST 119 STREET, 8A",2007-07-12,1145531,2012-03-30,995000,-150531,1723,-87.36564132327337
"121 WEST 19TH   STREET, 3B",2007-09-13,2000000,2013-02-28,1825000,-175000,1995,-87.71929824561404
"311 EAST 38TH STREET, 12E",2006-12-27,785000,2010-04-26,678300,-106700,1216,-87.7467105263158
"200 CHAMBERS STREET, 7G",2007-06-04,1058980,2011-06-23,929000,-129980,1480,-87.82432432432432
"220 RIVERSIDE BOULEVARD, 24E",2006-02-15,948000,2009-08-24,835000,-113000,1286,-87.86936236391912
"432 PARK AVENUE, 28J",2016-03-17,1848486,2018-06-28,1775000,-73486,833,-88.21848739495799
"120 GREENWICH STREET, 11J",2006-07-27,581420,2011-02-09,435000,-146420,1658,-88.31121833534378
"200 WEST END AVENUE, 4B",2008-01-10,926607,2009-12-07,865000,-61607,697,-88.38880918220947
"2 SOUTH END AVENUE, TH4",2006-08-08,785000,2012-04-30,600000,-185000,2092,-88.43212237093691
"455 CENTRAL PARK WEST, 21A",2005-09-15,2886738,2012-08-21,2662500,-224238,2532,-88.56161137440758
"25 CENTRAL PARK WEST, 6D",2005-08-01,966600,2007-01-09,920000,-46600,526,-88.59315589353612
"1965 BROADWAY, 16A",2005-09-22,3000000,2010-05-11,2850000,-150000,1692,-88.65248226950355
"10 WEST END AVENUE, 26A",2007-08-24,3305056,2010-11-12,3200000,-105056,1176,-89.33333333333333
"213 EAST 77TH   STREET, 5E",2007-08-27,665000,2010-05-28,575000,-90000,1005,-89.55223880597015
"2000 BROADWAY, 3B",2007-09-05,1818000,2012-10-24,1650000,-168000,1876,-89.55223880597015
"123 BAXTER STREET, 4A",2007-12-17,1680112,2011-10-14,1555000,-125112,1397,-89.55762347888331
"134 WEST 13TH   STREET, 2 UPPE",2006-08-11,800000,2011-01-03,656000,-144000,1606,-89.66376089663761
"55 WALL STREET, 837",2010-02-11,775000,2016-12-22,550000,-225000,2506,-89.78451715881883
"379 FIRST AVENUE, 3",2008-12-15,430000,2014-10-29,237500,-192500,2144,-89.78544776119404
"398 PARK AVENUE SOUTH, 29B",2015-11-09,5091250,2018-08-20,5000000,-91250,1015,-89.90147783251231
"160 WEST 66TH STREET, 16B",2009-02-23,1175000,2014-06-23,1000000,-175000,1946,-89.92805755395683
"101 WALL STREET, 9A",2017-05-11,1160805,2017-12-28,1140000,-20805,231,-90.06493506493507
"100 CENTRAL PARK SOUTH, 8A",2007-06-29,2000000,2011-02-08,1881000,-119000,1320,-90.15151515151516
"243 WEST 98TH STREET, 3A",2006-01-23,800000,2008-10-15,709912,-90088,996,-90.44979919678715
"635 WEST 42ND   STREET, 30C",2007-05-03,928440,2010-01-04,840000,-88440,977,-90.52200614124872
"68 BRADHURST AVENUE, 8-R",2007-06-12,725000,2012-05-11,562000,-163000,1795,-90.80779944289694
"15 BROAD STREET, 3014",2006-08-02,1172844,2010-04-08,1050000,-122844,1345,-91.33382899628253
"555 WEST 23RD   STREET, S7M",2015-02-04,950000,2018-03-09,846545,-103455,1129,-91.63418954827281
"184 THOMPSON STREET, 1W",2007-04-27,661862,2010-05-12,560000,-101862,1111,-91.68496849684969
"77 PARK AVENUE, 15E",2010-04-16,2200000,2013-04-08,2100000,-100000,1088,-91.91176470588235
"301 EAST 79TH   STREET, 20 B",2008-06-13,1250000,2011-06-03,1150000,-100000,1085,-92.16589861751152
"116 WEST 22ND   STREET, PHB",2007-07-18,3200000,2016-08-04,2895000,-305000,3305,-92.28441754916793
"2000 BROADWAY, 20A",2004-12-01,890000,2012-12-31,617000,-273000,2952,-92.47967479674797
"200 EAST 89TH STREET, 15F",2008-01-25,785000,2011-06-21,670000,-115000,1243,-92.51810136765889
"555 WEST 59TH STREET, 21H",2008-04-03,997885,2010-05-27,925000,-72885,784,-92.96556122448979
"200 RIVERSIDE BOULEVARD, 5B-T",2010-08-25,862050,2017-06-21,629887,-232163,2492,-93.16332263242376
"530 PARK AVENUE, 11A",2013-12-16,9082125,2016-05-09,9000000,-82125,875,-93.85714285714286
"1600 BROADWAY, 12B",2006-07-24,1117821,2011-01-06,965000,-152821,1627,-93.92808850645359
"200 WEST END AVENUE, 8L",2008-03-07,1374637,2013-04-01,1200000,-174637,1851,-94.34737979470556
"635 WEST 42ND STREET, 31G",2007-08-09,885877,2010-12-16,770000,-115877,1225,-94.5934693877551
"555 WEST 59TH   STREET, 28B",2009-02-03,2825550,2012-09-20,2700000,-125550,1325,-94.75471698113208
"220 WEST 111 STREET, 6A",2007-09-26,655243,2012-05-04,495000,-160243,1682,-95.269322235434
"120 EAST 87TH   STREET, RPH1CT",2014-06-30,2900000,2017-05-11,2800000,-100000,1046,-95.60229445506693
"330 SPRING STREET, 5D",2006-03-07,1858306,2011-06-02,1675000,-183306,1913,-95.8212232096184
"200 RIVERSIDE BOULEVARD, 409",2006-09-12,723000,2009-05-07,630000,-93000,968,-96.07438016528926
"18 WEST 48TH STREET, 34C",2007-07-27,1491736,2013-01-10,1300000,-191736,1994,-96.15646940822468
"272 WEST 107TH STREET, 16C",2013-06-18,1650000,2014-11-19,1600000,-50000,519,-96.33911368015414
"80 JOHN STREET, 12F",2008-07-22,1170987,2012-09-14,1025000,-145987,1515,-96.36105610561056
"188 EAST 70TH   STREET, 4C",2008-08-26,2300900,2018-04-24,1960000,-340900,3528,-96.62698412698413
"768 5 AVENUE, 1806",2008-03-07,2119949,2011-07-29,2000000,-119949,1239,-96.81113801452784
"635 WEST 42ND STREET, 16C",2007-11-15,841583,2010-07-08,748000,-93583,966,-96.8768115942029
"100 UNITED NATIONS PLAZA, 11D",2007-08-31,910000,2012-08-10,735000,-175000,1806,-96.89922480620154
"455 MAIN STREET, 16G",2006-05-30,753505,2011-03-02,585000,-168505,1737,-97.00921128382268
"199 BOWERY, 11F",2007-12-21,728048,2010-06-14,640000,-88048,906,-97.1832229580574
"55 WALL STREET, 814",2006-10-26,871355,2016-03-23,537420,-333935,3436,-97.18713620488941
"100 RIVERSIDE BOULEVARD, 3N",2008-01-07,1708623,2012-05-01,1555000,-153623,1576,-97.4765228426396
"10 WEST END AVENUE, 27A",2007-09-24,1621021,2009-01-07,1575000,-46021,471,-97.70912951167728
"57 READE STREET, 12E",2013-05-22,990757,2014-04-01,960000,-30757,314,-97.95222929936305
"845 UNITED NATIONS PLAZA, 6F",2005-06-28,670000,2010-04-30,496860,-173140,1767,-97.985285795133
"40 BROAD STREET, 11A",2008-06-30,957155,2012-06-22,814600,-142555,1453,-98.11080523055746
"251 WEST 89TH   STREET, 3F",2007-06-22,3200000,2010-04-06,3100000,-100000,1019,-98.13542688910697
"15 WILLIAM STREET, 20G",2009-01-28,967337,2013-03-08,820000,-147337,1500,-98.22466666666666
"530 WEST END AVENUE, 4B",2005-08-09,665000,2012-12-27,400000,-265000,2697,-98.25732295142751
"301 EAST 79TH   STREET, 28 M",2008-10-16,760000,2012-02-01,641500,-118500,1203,-98.50374064837905
"40 WEST 55TH STREET, 9A",2007-05-18,1540000,2012-05-14,1360000,-180000,1823,-98.73834339001645
"305 EAST 51ST   STREET, RU5H",2015-07-07,1807393,2017-12-08,1720000,-87393,885,-98.74915254237288
"200 EAST 66TH   STREET, E0406",2009-01-20,1135348,2011-07-11,1046000,-89348,902,-99.05543237250555
"220 RIVERSIDE BOULEVARD, 10E",2007-06-06,1800000,2010-11-16,1675000,-125000,1259,-99.28514694201748
"144 SUFFOLK STREET, B",2006-09-25,775000,2015-09-25,447000,-328000,3287,-99.78703985397019
"75 WALL STREET, 23K",2008-12-16,1058980,2011-12-13,950000,-108980,1092,-99.7985347985348
"55 WALL STREET, 546",2006-12-05,1195733,2017-03-13,820000,-375733,3751,-100.16875499866703
"2132 2 AVENUE, 6A",2007-08-10,524398,2012-04-11,353379,-171019,1706,-100.24560375146541
"200 WEST END AVENUE, 11B",2008-06-05,992947,2010-06-02,920000,-72947,727,-100.33975240715269
"261 WEST 28TH STREET, 4A",2007-11-16,1374637,2011-04-06,1250000,-124637,1237,-100.75747776879547
"260 PARK AVENUE SOUTH, 6D",2008-02-12,2700000,2010-02-24,2625000,-75000,743,-100.9421265141319
"10 WEST END AVENUE, 8B",2007-07-25,1191352,2011-10-20,1035000,-156352,1548,-101.00258397932816
"392 CENTRAL PARK WEST, 7V",2014-12-05,1006940,2018-03-09,886644,-120296,1190,-101.0890756302521
"202 WEST 140 STREET, 4E",2008-09-23,539672,2012-02-07,415000,-124672,1232,-101.1948051948052
"20 WEST STREET, 31B",2006-06-06,534581,2009-11-09,407500,-127081,1252,-101.50239616613419
"515 EAST 72ND   STREET, 17F",2008-05-05,1619017,2012-06-28,1465000,-154017,1515,-101.66138613861386
"299 WEST 12TH STREET, 8G",2008-06-05,3150000,2011-02-08,3050000,-100000,978,-102.24948875255623
"515 EAST 72ND   STREET, 4H",2008-05-23,780939,2012-06-26,627500,-153439,1495,-102.63478260869566
"2628 BROADWAY, 27B",2008-01-04,2291062,2013-02-04,2100000,-191062,1858,-102.83207750269106
"99 JOHN STREET, 521",2009-02-20,1060000,2012-04-09,942189,-117811,1144,-102.98164335664336
"1400 5 AVENUE, 5A",2008-11-24,525000,2010-06-29,465000,-60000,582,-103.09278350515464
"68 BRADHURST AVENUE, 10-V",2008-05-02,662640,2015-04-20,400000,-262640,2544,-103.23899371069183
"252 7 AVENUE, 5W",2005-11-15,1665000,2009-09-16,1520000,-145000,1401,-103.49750178443969
"1600 BROADWAY, 8B",2006-05-22,1135348,2011-06-01,945000,-190348,1836,-103.67538126361656
"20 WEST STREET, 10A",2008-07-21,999034,2013-10-21,800000,-199034,1918,-103.77163712200209
"150 WEST 56TH   STREET, 6304",2008-07-10,3300000,2011-10-27,3175000,-125000,1204,-103.82059800664452
"356 BROADWAY, 5C",2007-06-21,2145000,2011-12-14,1975000,-170000,1637,-103.84850335980452
"515 EAST 72ND   STREET, 29G",2008-05-07,1797211,2013-07-18,1600000,-197211,1898,-103.90463645943098
"15 WILLIAM STREET, 12B",2009-07-02,1160805,2014-08-28,965000,-195805,1883,-103.98566117896974
"1600 BROADWAY, 6F",2006-05-15,595676,2013-10-11,312500,-283176,2706,-104.64745011086474
"635 WEST 42ND   STREET, 28A",2009-02-25,1083927,2015-11-24,825000,-258927,2463,-105.12667478684531
"220 EAST 65TH   STREET, 4F",2007-06-28,740000,2016-11-29,375000,-365000,3442,-106.04299825682743
"240 RIVERSIDE BOULEVARD, 0.16666666666666666",2006-02-21,2340000,2011-01-13,2150000,-190000,1787,-106.32344711807498
"100 WEST 93RD   STREET, 9B",2008-05-22,799326,2011-12-15,660000,-139326,1302,-107.00921658986175
"350 EAST 82ND   STREET, 10G",2007-09-25,1247356,2011-06-29,1100000,-147356,1373,-107.32410779315367
"1 LEROY STREET, 5C",2004-04-08,2655000,2010-05-17,2415000,-240000,2230,-107.62331838565022
"447 WEST 18TH   STREET, 7D",2008-10-10,1875000,2011-07-29,1765000,-110000,1022,-107.63209393346379
"123 WASHINGTON STREET, 50F",2012-08-21,2018171,2014-11-17,1930000,-88171,818,-107.7885085574572
"170 EAST END AVENUE, 5F",2008-05-28,3462050,2009-12-23,3400000,-62050,574,-108.10104529616724
"245 EAST 93RD   STREET, 27E",2007-08-29,1388000,2011-08-15,1230000,-158000,1447,-109.19143054595715
"317 WEST 89TH STREET, 6E",2013-11-26,4378475,2018-05-14,4200000,-178475,1630,-109.49386503067484
"2112 BROADWAY, 7/8FT",2008-01-28,5702200,2018-02-12,5300000,-402200,3668,-109.65103598691385
"230 RIVERSIDE DRIVE, 1L",2007-09-17,834965,2010-09-14,715000,-119965,1093,-109.75754803293687
"150 EAST 56TH STREET, 9G",2008-06-30,750000,2011-05-11,635000,-115000,1045,-110.04784688995215
"80 PARK AVENUE, 2L",2005-03-18,451500,2015-02-10,53000,-398500,3616,-110.20464601769912
"500 WEST 43RD   STREET, 22D",2008-05-22,534500,2010-08-10,445000,-89500,810,-110.49382716049382
"458 WEST 146 STREET, PH-S",2007-08-27,1221900,2014-04-23,952887,-269013,2431,-110.6593994241053
"199 PRINCE STREET, 7",2008-04-15,762669,2010-03-15,685000,-77669,699,-111.11444921316166
"247 WEST 46TH   STREET, 1701",2008-10-17,1349181,2012-02-01,1215000,-134181,1202,-111.63144758735442
"690 RIVERSIDE DRIVE, 3F",2009-09-11,310500,2016-02-23,47165,-263335,2356,-111.77207130730051
"40 BROAD STREET, 23D",2011-09-12,765000,2018-03-09,499999,-265001,2370,-111.81476793248945
"725 RIVERSIDE DRIVE, 3A",2007-07-02,840000,2011-08-29,670000,-170000,1519,-111.9157340355497
"215 EAST 81ST   STREET, 4F",2009-09-24,694200,2013-01-30,557000,-137200,1224,-112.09150326797386
"650 WEST END AVENUE, 11A",2004-03-09,1600000,2016-09-28,1085000,-515000,4586,-112.29829917139119
"299 WEST 12 STREET, 6K",2008-09-26,1395000,2011-01-14,1300000,-95000,840,-113.0952380952381
"55 WALL STREET, 552",2006-11-28,1807393,2018-03-12,1336900,-470493,4122,-114.14192139737992
"69 EAST 130 STREET, 4B",2006-01-23,501930,2011-11-04,260000,-241930,2111,-114.60445286594032
"542 LA GUARDIA PLACE, 6B",2007-09-07,2795000,2012-07-30,2590000,-205000,1788,-114.65324384787472
"80 RIVERSIDE BOULEVARD, 9K",2010-08-27,1043706,2012-11-21,950000,-93706,817,-114.6952264381885
"330 EAST 33RD   STREET, 8-K",2007-07-31,650000,2014-09-30,347500,-302500,2618,-115.54621848739495
"201 EAST 36TH   STREET, 16E",2008-01-08,515000,2015-08-07,195000,-320000,2768,-115.60693641618496
"124 HUDSON STREET, 5C",2006-04-04,5250000,2012-03-05,5000000,-250000,2162,-115.63367252543941
"310 WEST 52ND STREET, 6G",2007-10-04,1914310,2010-06-18,1800000,-114310,988,-115.69838056680162
"45 PARK AVENUE, 803",2008-01-07,2124578,2012-11-08,1920000,-204578,1767,-115.77702320316921
"20 WEST STREET, 26D",2006-11-07,670000,2012-04-05,440000,-230000,1976,-116.39676113360323
"10 UNION SQUARE EAST, P16H",2004-06-28,655000,2005-08-31,605000,-50000,429,-116.55011655011656
"188 EAST 70TH STREET, 22B",2007-12-07,1700000,2010-07-07,1590000,-110000,943,-116.64899257688229
"120 WEST 72ND STREET, 11A",2008-04-02,2367431,2010-06-01,2275000,-92431,790,-117.00126582278482
"205 EAST 85TH STREET, 11M",2010-08-04,584666,2011-01-19,565000,-19666,168,-117.05952380952381
"60 EAST 55TH   STREET, 21B",2006-12-12,2087412,2010-05-20,1940000,-147412,1255,-117.4597609561753
"35 WEST 15TH   STREET, 13B",2015-10-30,2120000,2017-05-05,2055000,-65000,553,-117.54068716094032
"215 EAST 81ST   STREET, 6F",2009-09-24,712000,2013-01-30,568000,-144000,1224,-117.6470588235294
"464 WEST 44TH   STREET, 5B",2008-02-26,928889,2010-11-29,810000,-118889,1007,-118.06256206554121
"455 MAIN STREET, PH2E",2006-07-12,992793,2009-05-15,870000,-122793,1038,-118.29768786127168
"80 JOHN STREET, 15E",2008-02-15,855330,2011-12-13,690000,-165330,1397,-118.34645669291339
"90 WILLIAM STREET, 7A",2008-07-18,1122111,2011-10-31,980000,-142111,1200,-118.42583333333333
"100 RIVERSIDE BOULEVARD, 11U",2008-07-25,1018250,2011-11-10,875000,-143250,1203,-119.07730673316708
"350 WEST 42ND STREET, 57A",2008-04-10,1185000,2010-07-28,1085000,-100000,839,-119.18951132300357
"200 EAST 66TH   STREET, A1807",2015-06-30,2067047,2016-09-08,2015000,-52047,436,-119.37385321100918
"211 EAST 46TH   STREET, 32G",2008-10-16,1266804,2011-06-21,1150000,-116804,978,-119.43149284253579
"88 JANE STREET, 4E",2008-09-04,1550000,2013-07-18,1337404,-212596,1778,-119.570303712036
"200 EAST 66TH STREET, B0403",2008-12-30,2198728,2010-05-19,2138325,-60403,505,-119.609900990099
"380 LENOX AVENUE, 9D",2007-02-07,1256520,2012-12-24,999000,-257520,2147,-119.944108057755
"1420 YORK AVENUE, 4E",2008-03-27,440000,2011-03-31,308000,-132000,1099,-120.10919017288444
"404 EAST 76 STREET, 2P",2004-10-22,425000,2006-10-17,337400,-87600,725,-120.82758620689656
"90 WILLIAM STREET, 3F",2009-07-14,535000,2014-06-03,319133,-215867,1785,-120.93389355742296
"200 EAST 69TH STREET, 7L",2005-10-28,1042800,2010-03-10,850000,-192800,1594,-120.95357590966123
"325 FIFTH AVENUE, 19G",2007-09-07,1100000,2011-07-18,929000,-171000,1410,-121.27659574468085
"15 WILLIAM STREET, 28G",2009-02-20,1150622,2014-03-25,924900,-225722,1859,-121.42119419042496
"200 EAST 66TH   STREET, E2007",2014-05-08,3808255,2017-12-01,3650000,-158255,1303,-121.45433614735227
"303 GREENWICH STREET, 9F",2008-04-04,612500,2010-12-16,492500,-120000,986,-121.70385395537525
"630 FIRST AVENUE, 6L",2007-11-29,999000,2011-04-01,850000,-149000,1219,-122.23133716160787
"1600 BROADWAY, 21B",2006-07-07,1170987,2011-01-06,970000,-200987,1644,-122.25486618004867
"211 EAST 46TH   STREET, 7G",2008-06-12,997844,2017-07-07,592500,-405344,3312,-122.38647342995169
"1438 THIRD AVENUE, 21C",2007-06-21,1501918,2011-08-25,1315000,-186918,1526,-122.48885976408913
"334 WEST 89TH STREET, 4R",2004-09-24,730000,2017-03-17,169228,-560772,4557,-123.0572745227123
"380 LENOX AVENUE, 7B",2007-02-13,759288,2010-02-02,625000,-134288,1085,-123.76774193548387
"68 BRADHURST AVENUE, 9-K",2007-05-17,915000,2012-01-06,705000,-210000,1695,-123.89380530973452
"635 WEST 42ND   STREET, 40D",2008-10-24,1481553,2011-09-19,1350000,-131553,1060,-124.10660377358491
"82 BEAVER STREET, 205",2007-05-14,1298268,2012-05-25,1070000,-228268,1838,-124.1936887921654
"408 EAST 79TH STREET, 10C",2005-12-07,2088493,2011-05-26,1840000,-248493,1996,-124.49549098196393
"455 CENTRAL PARK WEST, 17C",2005-09-29,3950810,2006-06-01,3920262,-30548,245,-124.68571428571428
"137 DUANE STREET, 2E",2008-01-29,3156575,2011-06-30,3000000,-156575,1248,-125.46073717948718
"177 EAST 77TH   STREET, 7B/C",2007-06-14,2950000,2008-07-15,2900000,-50000,397,-125.94458438287154
"80 JOHN STREET, 2C",2007-08-29,1378783,2013-04-29,1117500,-261283,2070,-126.22367149758455
"235 EAST 40 STREET, 38D",2003-11-13,470000,2004-04-19,450000,-20000,158,-126.58227848101266
"20 WEST STREET, 11H",2007-03-30,466440,2016-05-04,45000,-421440,3323,-126.82515798976829
"55 WALL STREET, 832",2007-03-26,1251677,2014-10-02,900000,-351677,2747,-128.02220604295596
"27 WEST 72ND   STREET, 1201",2008-02-05,999000,2009-11-18,915000,-84000,652,-128.83435582822085
"225 5 AVENUE, 10N",2006-12-29,1074253,2009-05-13,962500,-111753,866,-129.04503464203233
"158 HESTER STREET, 3K",2006-10-20,880786,2015-05-15,475000,-405786,3129,-129.6855225311601
"80 JOHN STREET, 9F",2007-06-15,996612,2009-11-30,880000,-116612,899,-129.7130144605117
"82 BEAVER STREET, 1301",2007-04-25,998903,2008-05-05,950000,-48903,376,-130.06117021276594
"220 RIVERSIDE BOULEVARD, 7F",2007-06-25,1015000,2010-04-22,880000,-135000,1032,-130.8139534883721
"325 5 AVENUE, 16G",2007-02-15,941881,2010-02-02,800000,-141881,1083,-131.00738688827332
"641 FIFTH AVENUE, 24C",2008-04-29,2150000,2013-03-15,1915000,-235000,1781,-131.94834362717575
"200 RECTOR PLACE, 5U",2005-06-14,710000,2015-07-28,220000,-490000,3696,-132.57575757575756
"140 EAST 63RD   STREET, 6G",2007-12-12,1170987,2011-11-14,981000,-189987,1433,-132.57990230286114
"240 RIVERSIDE BOULEVARD, 6 F",2006-11-09,700000,2013-11-15,360000,-340000,2563,-132.65704252828715
"1600 BROADWAY, PH5D",2006-08-25,2876556,2011-04-27,2650000,-226556,1706,-132.79953106682296
"310 EAST 53RD STREET, 7C",2006-09-26,1375000,2012-05-24,1100000,-275000,2067,-133.04305757135947
"350 WEST 42ND STREET, 42H",2008-08-20,1100000,2012-03-20,925000,-175000,1308,-133.79204892966362
"119 FULTON STREET, 3A",2006-12-19,1221900,2010-04-30,1057500,-164400,1228,-133.87622149837134
"18 WEST 48TH   STREET, 21D",2007-07-06,1116002,2012-07-31,868000,-248002,1852,-133.91036717062636
"263 9 AVENUE, STG16",2007-09-21,48000,2008-05-01,18124,-29876,223,-133.97309417040358
"406-408 WEST 45TH STREET, 5A",2007-11-01,855330,2011-07-07,675000,-180330,1344,-134.17410714285714
"1600 BROADWAY, 12A",2006-07-24,1069162,2010-03-01,892500,-176662,1316,-134.24164133738603
"635 WEST 42ND   STREET, 31K",2008-05-07,1517192,2011-02-22,1380000,-137192,1021,-134.3702252693438
"15 WILLIAM STREET, 29D",2009-10-20,860000,2012-05-07,735000,-125000,930,-134.40860215053763
"555 LENOX AVENUE, 3D",2012-07-30,590000,2015-05-01,454675,-135325,1005,-134.65174129353233
"205 EAST 16TH   STREET, 5A",2010-10-13,5283183,2018-01-12,4925000,-358183,2648,-135.2654833836858
"40 BOND STREET, 7D",2007-08-17,3258400,2017-11-28,2750000,-508400,3756,-135.35676251331202
"350 WEST 42ND   STREET, 48C",2007-12-24,1495000,2012-12-05,1250000,-245000,1808,-135.50884955752213
"515 EAST 72ND   STREET, 6C",2008-02-06,832419,2011-10-13,650000,-182419,1345,-135.6275092936803
"16 WEST 19TH   STREET, 7-F",2007-12-04,1360000,2011-05-06,1190000,-170000,1249,-136.10888710968774
"380 LENOX AVENUE, 12B",2007-06-05,1608580,2013-01-07,1330000,-278580,2043,-136.3582966226138
"68 BRADHURST AVENUE, 7-H",2007-08-17,778100,2012-12-28,510000,-268100,1960,-136.78571428571428
"351 EAST 51ST STREET, 11C",2005-03-10,2749275,2012-02-29,2400000,-349275,2547,-137.1319199057715
"1600 BROADWAY, PH1C",2006-08-16,2876917,2013-02-21,2550000,-326917,2381,-137.30239395212095
"444 WEST 19TH STREET, 302",2014-08-08,1175000,2017-02-03,1050000,-125000,910,-137.36263736263737
"130 WEST 19TH STREET, 7B",2006-08-25,1454061,2011-01-25,1231000,-223061,1614,-138.20384138785624
"300 EAST 55TH STREET, 4F",2007-10-31,1155000,2011-04-15,980000,-175000,1262,-138.66877971473852
"80 JOHN STREET, 3C",2007-08-29,1378989,2012-09-10,1122500,-256489,1839,-139.47199564980968
"59 JOHN STREET, 11C",2008-03-28,2450000,2012-08-14,2225000,-225000,1600,-140.625
"100 RIVERSIDE BOULEVARD, 17H",2008-07-14,1013158,2011-09-16,850000,-163158,1159,-140.77480586712684
"11 EAST 29TH   STREET, 10A",2008-02-05,1669930,2010-03-24,1560000,-109930,778,-141.2982005141388
"90 PRINCE STREET, 5B",2008-06-30,2100000,2012-05-15,1900000,-200000,1415,-141.3427561837456
"155 PERRY STREET, 2A",2003-04-07,975000,2017-10-10,224977,-750023,5300,-141.51377358490566
"136 BAXTER STREET, PH-A",2009-06-05,4000000,2013-04-18,3800000,-200000,1413,-141.54281670205236
"330 EAST 38TH   STREET, 39K",2007-06-18,1160000,2011-01-11,975000,-185000,1303,-141.9800460475825
"184 THOMPSON STREET, 1B",2007-04-27,656771,2009-11-09,525000,-131771,927,-142.1477885652643
"111 EAST 30TH STREET, 3A",2008-09-10,1175000,2012-02-27,995000,-180000,1265,-142.29249011857706
"55 WALL STREET, 620",2006-12-26,1353466,2014-03-25,975000,-378466,2646,-143.03325774754347
"160 CENTRAL PARK SOUTH, 515",2006-01-31,3425000,2009-06-05,3250000,-175000,1221,-143.32514332514333
"151 WEST 17TH STREET, 4B",2008-06-05,1375000,2010-10-25,1250000,-125000,872,-143.348623853211
"517 WEST 149 STREET, 1",2007-10-04,939335,2012-04-27,700000,-239335,1667,-143.57228554289142
"101 WARREN STREET, 9A",2008-06-27,4073000,2017-02-28,3618000,-455000,3168,-143.62373737373738
"310 EAST 53RD STREET, 22C",2006-10-24,3885692,2010-05-05,3700000,-185692,1289,-144.0589604344453
"418 CENTRAL PARK WEST, 23",2003-01-22,715000,2006-07-26,530000,-185000,1281,-144.4184231069477
"222 RIVERSIDE DRIVE, PH3E",2004-01-27,399000,2008-07-11,163000,-236000,1627,-145.05224339274739
"44 EAST 67TH   STREET, 3A",2013-09-04,2445455,2016-06-02,2300000,-145455,1002,-145.16467065868264
"240 EAST 47TH   STREET, 14A",2007-04-23,770000,2010-08-10,595000,-175000,1205,-145.22821576763485
"250 EAST 54TH   STREET, 5D",2010-03-09,850000,2011-05-09,788000,-62000,426,-145.5399061032864
"310 WEST 52ND   STREET, 31B",2007-08-24,1929583,2011-01-07,1750000,-179583,1232,-145.76542207792207
"215 EAST 81ST   STREET, 4G",2009-09-24,683475,2012-03-12,552000,-131475,900,-146.08333333333334
"301 EAST 45TH   STREET, 19F",2007-07-18,600000,2013-08-09,275000,-325000,2214,-146.79313459801264
"25 FIFTH AVENUE, 14H",2007-12-17,1099710,2009-11-02,999000,-100710,686,-146.80758017492712
"230 WEST 56TH   STREET, 63A",2012-01-04,7450000,2016-09-01,7200000,-250000,1702,-146.88601645123384
"1200 5 AVENUE, 5D",2007-10-31,1389911,2014-01-31,1053888,-336023,2284,-147.12040280210158
"400 EAST 67TH STREET, 6H",2008-12-15,1247356,2011-09-12,1100000,-147356,1001,-147.2087912087912
"20 WEST STREET, 9C",2007-03-30,1272812,2013-04-05,949108,-323704,2198,-147.27206551410373
"200 WEST END AVENUE, 12E",2008-06-06,1970313,2015-07-23,1586496,-383817,2603,-147.45178640030733
"301 EAST 45TH STREET, 10B",2005-05-06,610000,2013-11-12,150000,-460000,3112,-147.81491002570695
"15 WILLIAM STREET, 17D",2009-06-05,999999,2013-09-04,770000,-229999,1552,-148.1952319587629
"45 PARK AVENUE, 604",2007-12-18,1176078,2011-04-20,995000,-181078,1219,-148.54634946677604
"635 WEST 42ND   STREET, 43D",2008-07-03,1512101,2012-10-03,1280000,-232101,1553,-149.4533161622666
"1600 BROADWAY, PH6D",2006-10-15,2902012,2011-05-24,2650000,-252012,1682,-149.82877526753865
"301 CATHEDRAL PARKWAY, 7F",2007-11-30,497500,2008-04-28,475000,-22500,150,-150.0
"67 WEST 107 STREET, 67(3)",2009-03-10,365040,2010-05-17,300000,-65040,433,-150.2078521939954
"100 RIVERSIDE BOULEVARD, 27B/C",2008-07-25,3848985,2013-01-30,3600000,-248985,1650,-150.9
"455 MAIN STREET, PH1D",2006-05-24,1456861,2011-04-14,1187000,-269861,1786,-151.0979843225084
"450 EAST 83RD STREET, 19B",2006-07-18,2963107,2012-03-16,2650000,-313107,2068,-151.40570599613153
"255 EAST 49TH STREET, 19B",2005-07-07,779000,2010-07-28,499000,-280000,1847,-151.59718462371413
"310 WEST 52ND STREET, 18C",2011-07-11,932500,2011-12-06,910000,-22500,148,-152.02702702702703
"725 RIVERSIDE DRIVE, 2A",2008-06-06,835000,2010-07-01,720000,-115000,755,-152.31788079470198
"325 5 AVENUE, 8D",2007-10-03,975000,2016-03-29,500000,-475000,3100,-153.2258064516129
"1760 SECOND AVENUE, 21F",2007-08-29,1090000,2009-08-14,980000,-110000,716,-153.6312849162011
"116 WEST 14TH   STREET, 8F",2007-12-12,1995000,2011-11-11,1775000,-220000,1430,-153.84615384615384
"200 RIVERSIDE BOULEVARD, 28E",2005-04-05,1371000,2012-07-26,960000,-411000,2669,-153.99025852379168
"310 WEST 52ND STREET, 31C",2014-09-30,1415000,2018-07-27,1200000,-215000,1396,-154.01146131805157
"309 EAST 49TH   STREET, 0.25",2008-01-31,1390000,2017-06-07,862500,-527500,3415,-154.46559297218155
"55 WALL STREET, 905",2008-02-11,1634105,2014-08-21,1265000,-369105,2383,-154.89089383130508
"422 EAST 72ND   STREET, 31D",2007-03-16,2000000,2013-06-12,1645500,-354500,2280,-155.48245614035088
"140 EAST 63RD   STREET, 5G",2007-12-17,1221900,2011-11-14,998903,-222997,1428,-156.16036414565826
"322 WEST 57TH   STREET, 21P1",2008-08-05,1649565,2012-12-18,1400000,-249565,1596,-156.36904761904762
"450 EAST 83RD STREET, 4B",2006-09-27,722957,2011-10-25,433000,-289957,1854,-156.39536138079828
"1600 BROADWAY, 21A",2006-08-30,1165896,2010-06-10,950000,-215896,1380,-156.4463768115942
"55 WALL STREET, 506",2008-05-21,1300000,2017-11-17,755000,-545000,3467,-157.1964234208249
"236 EAST 47TH STREET, 11B",2009-05-15,625000,2014-08-04,325000,-300000,1907,-157.31515469323546
"100 CENTRAL PARK SOUTH, 6F",2008-03-28,585493,2013-06-03,287500,-297993,1893,-157.41838351822503
"101 WARREN STREET, 11I",2008-09-12,2586355,2011-12-07,2400000,-186355,1181,-157.79424216765452
"120 GREENWICH STREET, 9F",2007-03-30,739249,2011-01-12,520000,-219249,1384,-158.41690751445086
"243 WEST 60TH   STREET, 2F",2008-11-19,2036500,2012-12-12,1800000,-236500,1484,-159.36657681940702
"210 LAFAYETTE STREET, 6B",2007-06-26,1300000,2010-01-22,1150000,-150000,941,-159.4048884165781
"25 CENTRAL PARK WEST, 4R",2005-10-17,1978995,2013-07-09,1527475,-451520,2822,-160.0
"20 WEST STREET, 18C",2007-05-31,1272812,2012-10-02,960000,-312812,1951,-160.33418759610456
"231 EAST 55TH   STREET, PH-B",2007-11-28,2774731,2016-09-08,2260000,-514731,3207,-160.50233863423762
"330 SPRING STREET, 9C",2008-06-27,1800000,2011-07-18,1620000,-180000,1116,-161.29032258064515
"200 EAST 61ST   STREET, 30E",2008-09-10,1335000,2011-10-31,1150000,-185000,1146,-161.43106457242584
"101 WARREN STREET, 2640",2009-04-23,2728910,2011-12-02,2575000,-153910,953,-161.50052465897167
"15 BROAD STREET, 1726",2006-09-22,911333,2012-04-19,582500,-328833,2036,-161.50933202357564
"15 WILLIAM STREET, 36B",2009-03-31,1237173,2013-04-12,999000,-238173,1473,-161.69246435845213
"1 YORK STREET, 5A",2008-07-24,1218005,2011-02-25,1065000,-153005,946,-161.73890063424946
"20 CLINTON STREET, 6F",2005-10-18,945000,2018-05-16,200000,-745000,4593,-162.20335292836927
"100 RIVERSIDE BOULEVARD, 8P",2008-07-28,1373619,2010-09-03,1249000,-124619,767,-162.47588005215124
"222 RIVERSIDE DRIVE, 5A",2006-08-17,2200000,2012-07-05,1850000,-350000,2149,-162.86644951140065
"36 HUDSON STREET, 7A",2007-05-10,4174825,2012-10-22,3850000,-324825,1992,-163.06475903614458
"1 CENTRAL PARK WEST, 30F",2012-07-13,3060000,2015-03-19,2900000,-160000,979,-163.4320735444331
"255 EAST 49TH   STREET, 22A",2007-10-15,860000,2009-08-18,750000,-110000,673,-163.44725111441306
"159 WEST 53RD STREET, 30B",2007-07-06,1210000,2011-06-02,975000,-235000,1427,-164.68114926419062
"160 CENTRAL PARK SOUTH, 414",2007-06-27,4582125,2013-10-29,4200000,-382125,2316,-164.99352331606218
"510 CATHEDRAL PARKWAY, 6E",2008-08-07,620000,2009-10-05,550000,-70000,424,-165.0943396226415
"1600 BROADWAY, 16E",2006-08-10,906242,2009-07-09,730000,-176242,1064,-165.64097744360902
"220, 22A",2003-03-06,1043706,2004-01-21,990000,-53706,321,-167.30841121495328
"408 EAST 79TH STREET, 12C",2005-12-12,2107713,2010-03-01,1850000,-257713,1540,-167.3461038961039
"454 ST NICHOLAS AVENUE, 4NR",2007-02-16,520000,2011-10-21,233220,-286780,1708,-167.903981264637
"1 MORTON SQUARE, PH B",2004-11-10,2723818,2016-08-16,2000000,-723818,4297,-168.44728880614383
"350 WEST 57TH STREET, 3G",2006-06-16,1095000,2009-06-15,910000,-185000,1095,-168.9497716894977
"252 7 AVENUE, 16H",2007-04-13,2500000,2011-04-28,2250000,-250000,1476,-169.37669376693768
"211 EAST 46TH   STREET, 12C",2008-04-17,622150,2013-09-06,288000,-334150,1968,-169.79166666666666
"39 EAST 29TH STREET, 30B",2008-12-02,1425550,2011-09-29,1250000,-175550,1031,-170.27158098933074
"10 WEST END AVENUE, 18B",2008-03-06,1781937,2012-06-12,1515000,-266937,1559,-171.22322001282873
"610 PARK AVENUE, 15F",2008-07-30,4650000,2014-12-22,4250000,-400000,2336,-171.23287671232876
"491 GREENWICH STREET, 7A",2006-01-09,3105662,2009-04-16,2900000,-205662,1193,-172.39061190276612
"450 EAST 83RD STREET, 4K",2006-05-24,626223,2011-08-25,295000,-331223,1919,-172.6018759770714
"80 RIVERSIDE BOULEVARD, 14M",2013-05-06,4518438,2018-05-24,4200000,-318438,1844,-172.68872017353578
"40 BOND STREET, 5D",2007-08-07,3156575,2016-09-15,2575000,-581575,3327,-174.80462879470994
"59 JOHN STREET, 12C",2007-11-29,2331792,2013-10-22,1955000,-376792,2154,-174.92664809656452
"182 9 AVENUE, 2",2006-04-06,1175000,2009-05-22,975000,-200000,1142,-175.13134851138355
"300 EAST 62ND   STREET, 1903",2008-12-09,3950000,2015-03-11,3550000,-400000,2283,-175.20805957074026
"420 CENTRAL PARK WEST, 5K",2005-07-18,896000,2015-03-30,274290,-621710,3542,-175.52512704686617
"50 RIVERSIDE BOULEVARD, 12P",2015-11-09,4117730,2017-09-08,4000000,-117730,669,-175.97907324364724
"170 EAST 87TH   STREET, W11H",2010-03-10,1200000,2011-09-28,1100000,-100000,567,-176.3668430335097
"1600 BROADWAY, 15F",2006-07-18,763687,2018-01-30,20000,-743687,4214,-176.48006644518273
"240 EAST 10TH   STREET, 12A",2007-10-25,1780000,2011-11-01,1520000,-260000,1468,-177.1117166212534
"270 WEST 19TH STREET, 4A",2005-11-17,1451006,2015-12-01,799410,-651596,3666,-177.74031642116748
"225 WEST 83RD   STREET, 7J",2012-05-23,2956282,2015-07-22,2750000,-206282,1155,-178.5991341991342
"200 WEST END AVENUE, 9K",2008-02-22,758596,2009-08-25,660000,-98596,550,-179.26545454545453
"381 LENOX AVENUE, 6-C",2009-04-02,858384,2012-05-31,650000,-208384,1155,-180.41904761904763
"225 FIFTH AVENUE, 11A",2007-08-22,1822667,2009-12-29,1667000,-155667,860,-181.00813953488372
"245 SEVENTH AVENUE, 4C",2008-03-20,1275000,2012-06-05,995000,-280000,1538,-182.05461638491548
"80 RIVERSIDE BOULEVARD, 20D",2010-04-02,2926000,2012-04-17,2790000,-136000,746,-182.30563002680964
"635 WEST 42ND STREET, 10N",2007-07-26,946972,2014-06-05,490000,-456972,2506,-182.3511572226656
"28 EAST 10TH STREET, 8C",2013-06-10,2250000,2015-09-09,2100000,-150000,821,-182.70401948842874
"340 EAST 23RD STREET, 15M",2008-04-30,2143416,2011-12-22,1900000,-243416,1331,-182.88204357625844
"251 WEST 89TH   STREET, 9D",2009-08-26,1674107,2012-11-06,1460000,-214107,1168,-183.31078767123287
"330 EAST 38TH   STREET, 42L",2007-12-18,1160000,2010-06-29,990000,-170000,924,-183.982683982684
"140 EAST 63RD STREET, 13C",2007-08-23,3652236,2011-01-06,3425000,-227236,1232,-184.44480519480518
"200 RIVERSIDE BOULEVARD, 15K",2007-04-09,3680000,2012-02-27,3350000,-330000,1785,-184.87394957983193
"100 RIVERSIDE BOULEVARD, 12E",2008-10-03,943255,2010-07-30,820000,-123255,665,-185.34586466165413
"630 1 AVENUE, 18P",2004-10-05,615000,2010-02-18,249148,-365852,1962,-186.46890927624872
"212 EAST 47TH STREET, 25H",2008-01-23,762669,2009-07-23,660000,-102669,547,-187.6946983546618
"1 RIVER TERRACE, 29E",2010-10-28,2461880,2011-05-23,2422887,-38993,207,-188.3719806763285
"200 RIVERSIDE BOULEVARD, 35E",2006-06-30,1550000,2009-07-31,1337500,-212500,1127,-188.5536823425022
"411 EAST 53RD   STREET, 8J",2008-09-08,450000,2011-12-12,225000,-225000,1190,-189.07563025210084
"200 11TH   AVENUE, 11S",2011-07-19,4640000,2017-07-07,4225000,-415000,2180,-190.36697247706422
"372 CENTRAL PARK WEST, 18P",2005-11-29,1168000,2017-02-15,384649,-783351,4096,-191.247802734375
"101 WARREN STREET, 680",2008-06-20,1563013,2011-11-16,1325000,-238013,1244,-191.32877813504822
"251 WEST 19TH STREET, 1C",2005-06-29,1200000,2009-10-13,900000,-300000,1567,-191.44862795149967
"11 EAST 29TH   STREET, 18B",2008-01-29,870603,2017-08-31,200000,-670603,3502,-191.4914334665905
"425 WEST 50TH STREET, 11H",2014-12-18,1832850,2017-09-20,1640000,-192850,1007,-191.50943396226415
"200 WEST END AVENUE, 15H",2008-05-02,1323725,2012-05-16,1039500,-284225,1475,-192.6949152542373
"555 WEST 59TH STREET, 31B",2008-06-09,3319495,2012-04-03,3050000,-269495,1394,-193.32496413199425
"400 EAST 90TH   STREET, 9D",2007-08-09,997885,2009-08-11,855000,-142885,733,-194.9317871759891
"230 WEST 56TH STREET, 59D",2006-10-05,2950000,2009-07-22,2750000,-200000,1021,-195.88638589618023
"201 EAST 80TH STREET, 7I",2008-06-27,2200000,2011-04-14,2000000,-200000,1021,-195.88638589618023
"404 PARK AVENUE SOUTH, 12C",2014-11-12,4246102,2017-03-28,4075000,-171102,867,-197.34948096885813
"211 MADISON AVENUE, 12A",2008-05-09,1300000,2012-07-19,995000,-305000,1532,-199.08616187989557
"55 WALL STREET, 630",2007-11-06,2530713,2016-07-07,1900000,-630713,3166,-199.21446620341123
"517 WEST 46TH   STREET, 501",2008-03-06,1125000,2011-06-21,885000,-240000,1202,-199.66722129783693
"15 WILLIAM STREET, 33C",2009-01-27,1206626,2013-04-10,900000,-306626,1534,-199.8865710560626
"200, 18A",2003-03-28,1350000,2003-12-03,1300000,-50000,250,-200.0
"15 WEST 53RD STREET, 16K",2007-05-11,925000,2017-10-11,160208,-764792,3806,-200.94377299001576
"2112 BROADWAY, 6A",2008-02-12,4327562,2012-08-24,3995000,-332562,1655,-200.94380664652567
"220 RIVERSIDE BOULEVARD, 4B",2005-11-10,1049000,2008-10-08,835000,-214000,1063,-201.3170272812794
"322 WEST 57TH STREET, 32P2",2008-03-10,1654656,2012-04-30,1350000,-304656,1512,-201.4920634920635
"421 EAST 13TH   STREET, PHC",2008-05-08,2911600,2015-03-27,2400000,-511600,2514,-203.50039777247414
"184 THOMPSON STREET, 6L",2007-08-06,840056,2009-08-12,690000,-150056,737,-203.60379918588873
"366 WEST 11TH   STREET, 3C",2014-12-15,1300000,2017-08-16,1100000,-200000,975,-205.12820512820514
"10 WEST STREET, 25D",2007-09-20,1050000,2009-08-31,903388,-146612,711,-206.2053445850914
"340 EAST 23RD   STREET, SHB",2008-06-19,1257538,2010-03-22,1125000,-132538,641,-206.76755070202807
"635 WEST 42ND   STREET, 4D",2008-06-04,720000,2013-02-19,363000,-357000,1721,-207.4375363160953
"220 RIVERSIDE BOULEVARD, 8G",2005-06-03,1150000,2009-05-18,850000,-300000,1445,-207.61245674740485
"425 WEST 50TH   STREET, 11C",2015-01-08,2545625,2018-04-03,2300000,-245625,1181,-207.9805249788315
"515 EAST 72ND STREET, 36C",2014-02-03,1613926,2014-10-20,1560000,-53926,259,-208.20849420849422
"845 UNITED NATIONS PLAZA, 7A",2009-02-02,3200000,2018-04-18,2500000,-700000,3362,-208.20939916716242
"80 JOHN STREET, 14B",2007-11-16,1541223,2012-12-31,1150000,-391223,1872,-208.9866452991453
"117 EAST 57TH STREET, 40E",2006-09-20,1200000,2008-09-05,1050000,-150000,716,-209.49720670391062
"330 EAST 38 STREET, 44K",2005-01-10,1300000,2006-09-21,1170000,-130000,619,-210.016155088853
"211 EAST 46TH   STREET, 12A",2008-08-18,526231,2013-12-23,115992,-410239,1953,-210.0558115719406
"150 WEST 51 STREET, 41124",2003-05-02,399396,2004-06-03,315000,-84396,398,-212.0502512562814
"116 CENTRAL PARK SOUTH, PHB",2005-04-15,3800000,2009-06-19,3475000,-325000,1526,-212.9750982961992
"2112 BROADWAY, 2A",2007-06-19,2672906,2013-07-16,2200000,-472906,2219,-213.1167192429022
"21 LUDLOW STREET, 5C",2009-11-19,539672,2012-12-07,300000,-239672,1114,-215.14542190305207
"261 WEST 28TH STREET, 2A",2007-11-28,1298268,2009-10-19,1147000,-151268,691,-218.91172214182345
"308 EAST 72ND   STREET, 12B",2007-08-10,2100000,2012-04-12,1725000,-375000,1707,-219.6836555360281
"25 COLUMBUS CIRCLE, ST60F",2004-01-23,1857656,2010-03-22,1363000,-494656,2250,-219.8471111111111
"75 WALL STREET, 28O",2009-03-05,1828693,2013-05-22,1490000,-338693,1539,-220.07342430149447
"450 EAST 83RD   STREET, 8A",2007-06-25,1934675,2017-11-03,1100000,-834675,3784,-220.58007399577167
"41 WEST 72 STREET, 8C",2004-12-01,319410,2006-03-24,213743,-105667,478,-221.06066945606693
"324 PEARL STREET, 5F",2008-06-12,800000,2016-06-20,150000,-650000,2930,-221.8430034129693
"243 WEST 98TH STREET, 7A",2006-01-16,800000,2011-09-19,340000,-460000,2072,-222.007722007722
"211 EAST 46TH   STREET, 19D",2009-09-24,469847,2013-12-28,124204,-345643,1556,-222.13560411311053
"75 WALL STREET, 20M",2009-06-05,1348163,2018-06-21,610950,-737213,3303,-223.19497426581896
"22 WEST 15TH   STREET, 6D",2007-07-06,910000,2009-02-06,780000,-130000,581,-223.75215146299485
"455 EAST 86 STREET, 9A",2005-03-17,1070000,2006-02-14,995000,-75000,334,-224.55089820359282
"421 EAST 13TH   STREET, PHD",2008-03-27,2087412,2010-07-09,1900000,-187412,834,-224.7146282973621
"101 WARREN STREET, 7D",2008-07-11,3110753,2010-10-07,2926525,-184228,818,-225.21760391198043
"1623 THIRD AVENUE, 23A",2007-06-01,1335000,2010-04-08,1100000,-235000,1042,-225.5278310940499
"610 PARK AVENUE, 7C",2007-11-15,4950000,2012-02-07,4600000,-350000,1545,-226.53721682847896
"170 EAST END AVENUE, 7A/B",2009-02-13,6211325,2012-11-15,5900000,-311325,1371,-227.07877461706784
"28 EAST 10TH   STREET, 11C",2010-07-13,1450000,2015-12-14,1000000,-450000,1980,-227.27272727272728
"220 RIVERSIDE BOULEVARD, 5L",2007-02-05,2100000,2011-07-20,1730000,-370000,1626,-227.55227552275522
"322 WEST 57TH STREET, 41E",2010-04-29,793200,2015-08-18,350000,-443200,1937,-228.80743417656169
"33 WEST 56TH   STREET, 7E",2011-04-04,2719262,2013-07-30,2525000,-194262,848,-229.08254716981133
"200 EAST 69TH   STREET, 5Q",2007-06-13,856000,2010-04-30,615000,-241000,1052,-229.0874524714829
"300 EAST 77TH STREET, 29A",2006-11-10,4200000,2010-05-25,3900000,-300000,1292,-232.19814241486068
"15 BROAD STREET, 3710",2007-01-12,2133233,2017-06-06,1250000,-883233,3798,-232.5521327014218
"515 EAST 72ND STREET, 18F",2007-12-27,1680112,2011-04-11,1400000,-280112,1201,-233.2323064113239
"200 RIVERSIDE BOULEVARD, 43C",2015-01-30,2350000,2018-08-07,2050000,-300000,1285,-233.46303501945525
"20 PINE STREET, 1210",2008-08-26,972428,2015-06-16,390000,-582428,2485,-234.3774647887324
"101 WARREN STREET, 2610",2008-12-19,3686065,2010-06-10,3559664,-126401,538,-234.9460966542751
"150 EAST 56TH STREET, 11E",2005-11-22,800000,2013-05-02,160324,-639676,2718,-235.34805003679176
"450 EAST 83RD   STREET, 23C",2007-09-06,2295000,2011-09-09,1950000,-345000,1464,-235.65573770491804
"100 11TH   AVENUE, 10B",2010-01-12,4485391,2013-05-07,4200000,-285391,1211,-235.6655656482246
"159 WEST 53RD   STREET, 18F",2008-08-27,690000,2013-02-08,306500,-383500,1626,-235.8548585485855
"111 CENTRAL PARK NORTH, 18B",2007-11-30,2602647,2012-08-01,2200000,-402647,1706,-236.01817116060963
"515 EAST 72ND   STREET, 6H",2008-02-27,826878,2010-12-17,585000,-241878,1024,-236.208984375
"425 FIFTH AVENUE, 64A",2006-05-25,1537557,2007-12-07,1405000,-132557,561,-236.28698752228163
"1200 5 AVENUE, 14N",2008-06-27,6124773,2016-04-21,5450000,-674773,2855,-236.34781085814362
"20 PINE STREET, 1003",2015-09-02,825000,2017-09-26,646258,-178742,755,-236.74437086092715
"220 RIVERSIDE BOULEVARD, 4S",2006-01-10,860000,2009-10-30,530000,-330000,1389,-237.58099352051835
"100 RIVERSIDE BOULEVARD, 18F",2008-06-03,2418343,2012-08-28,2050000,-368343,1547,-238.10148674854557
"44 MARKET STREET, 12B",2012-01-18,378259,2016-01-08,31000,-347259,1451,-239.3239145416954
"1 YORK STREET, 6G",2008-08-13,2291062,2011-03-25,2062500,-228562,954,-239.58280922431865
"15 WILLIAM STREET, 39B",2009-04-06,1267721,2013-03-25,920000,-347721,1449,-239.97308488612836
"225 EAST 34TH   STREET, 6J",2008-03-14,890968,2009-04-14,795000,-95968,396,-242.34343434343435
"515 EAST 72ND   STREET, 17B",2008-02-29,1439380,2010-06-16,1235000,-204380,838,-243.89021479713603
"245 WEST 14TH STREET, 2B",2016-05-03,1578287,2017-10-11,1450000,-128287,526,-243.89163498098858
"115 MERCER STREET, 4A",2007-02-21,3156575,2010-04-19,2875000,-281575,1153,-244.21075455333911
"206 EAST 73RD STREET, 3W",2008-02-11,2700000,2012-06-05,2315000,-385000,1576,-244.28934010152284
"200 CHAMBERS STREET, 21B",2007-05-14,1766663,2009-10-13,1550000,-216663,883,-245.3714609286523
"184 THOMPSON STREET, 6H",2007-06-29,933430,2011-02-02,610000,-323430,1314,-246.1415525114155
"88 GREENWICH STREET, 2101",2009-01-21,1200000,2013-09-20,780000,-420000,1703,-246.62360540223136
"70 WEST 107 STREET, 3A",2006-03-15,1196443,2009-08-06,890000,-306443,1240,-247.13145161290322
"211 EAST 46TH   STREET, 10G",2008-06-30,1004748,2009-10-26,885000,-119748,483,-247.92546583850933
"100 UNITED NATIONS PLAZA, 18D",2007-09-18,810000,2009-04-03,670000,-140000,563,-248.6678507992895
"90 PRINCE STREET, 8B",2003-01-28,1310000,2008-02-15,850000,-460000,1844,-249.45770065075922
"923 FIFTH AVENUE, 3E",2008-04-03,2200000,2012-02-03,1850000,-350000,1401,-249.82155603140615
"350 WEST 42ND STREET, 40D",2006-09-20,1481553,2010-02-12,1170000,-311553,1241,-251.04995970991135
"15 WILLIAM STREET, 10D",2009-10-23,972428,2012-06-28,725000,-247428,979,-252.73544433094995
"100 WEST 119 STREET, 7D",2006-05-03,1242265,2011-03-30,789143,-453122,1792,-252.85825892857142
"143 AVENUE B, 4C",2003-07-01,652500,2010-06-02,12000,-640500,2528,-253.3623417721519
"450 WEST 17TH   STREET, 1110",2008-09-26,824782,2009-06-25,755000,-69782,272,-256.5514705882353
"610 PARK AVENUE, 9E",2006-11-30,6500000,2011-03-02,6100000,-400000,1553,-257.56600128783003
"236 EAST 47TH STREET, 19E",2007-03-06,1080000,2017-08-04,100000,-980000,3804,-257.6235541535226
"845 UNITED NATIONS PLAZA, 80C",2007-09-28,5550000,2010-05-25,5300000,-250000,970,-257.7319587628866
"845 UNITED NATIONS PLAZA, 39C",2007-07-27,3200000,2012-11-05,2700000,-500000,1928,-259.33609958506224
"100 UNITED NATIONS PLAZA, 29A",2005-01-19,1325000,2016-05-04,255000,-1070000,4123,-259.51976715983506
"1 MORTON SQUARE, 6F W",2004-11-10,1975000,2010-11-18,1400000,-575000,2199,-261.4824920418372
"340 EAST 23RD STREET, 6D",2008-05-27,1122111,2009-11-06,984000,-138111,528,-261.5738636363636
"420 EAST 58TH   STREET, 12A",2007-09-25,824500,2009-07-23,650000,-174500,667,-261.6191904047976
"240 RIVERSIDE BOULEVARD, 3AB",2008-08-07,3375000,2011-09-07,3080000,-295000,1126,-261.9893428063943
"15 WILLIAM STREET, 28C",2009-07-08,1191352,2012-01-25,947000,-244352,931,-262.46186895810956
"240 EAST 47TH   STREET, 17F",2010-04-05,925000,2014-09-23,495000,-430000,1632,-263.48039215686276
"240 EAST 47TH   STREET, 17E",2010-04-08,925000,2014-09-23,495000,-430000,1629,-263.96562308164516
"2 RIVER TERRACE, 10L",2012-05-07,2440745,2013-01-11,2375000,-65745,249,-264.03614457831327
"160 CENTRAL PARK SOUTH, 1109",2008-02-19,2392887,2012-12-21,1925000,-467887,1767,-264.7917374080362
"220 RIVERSIDE BOULEVARD, 20N",2007-10-25,4260000,2011-07-14,3900000,-360000,1358,-265.0957290132548
"25 COLUMBUS CIRCLE, SU-33",2005-11-29,101895,2006-06-12,50000,-51895,195,-266.12820512820514
"101 WARREN STREET, 830",2008-07-07,1308417,2010-02-19,1150000,-158417,592,-267.5962837837838
"146 CHAMBERS STREET, 2",2008-01-18,1891399,2014-03-07,1291055,-600344,2240,-268.0107142857143
"240 PARK AVENUE SOUTH, 7A",2008-04-15,2810370,2011-02-24,2530000,-280370,1045,-268.29665071770336
"99 BATTERY PLACE, 20-E",2005-10-21,610000,2011-01-21,95000,-515000,1918,-268.5088633993743
"25 CENTRAL PARK WEST, 27J",2008-06-25,5150000,2012-07-12,4750000,-400000,1478,-270.6359945872801
"340 EAST 23RD   STREET, PH4D",2009-04-21,2363188,2010-12-13,2200000,-163188,601,-271.52745424292846
"15 WEST 53RD STREET, 32C",2014-07-03,2000000,2018-07-13,1600000,-400000,1471,-271.92386131883075
"400 EAST 51ST STREET, 28B",2007-06-12,4350000,2010-12-20,4000000,-350000,1287,-271.95027195027194
"55 WALL STREET, 632",2010-02-11,1215000,2014-12-29,730000,-485000,1782,-272.16610549943886
"555 WEST 59TH STREET, 28A",2008-05-02,2545625,2011-10-20,2200000,-345625,1266,-273.0055292259084
"327 CENTRAL PARK WEST, 2B",2006-02-10,2925000,2010-05-13,2500000,-425000,1553,-273.6638763683194
"117 EAST 57 STREET, 45B",2003-06-12,1150000,2004-06-08,1050000,-100000,362,-276.24309392265195
"2 RIVER TERRACE, 18E",2011-09-30,2051773,2016-09-17,1550000,-501773,1814,-276.6113561190739
"181 7 AVENUE, 3A",2010-07-29,494500,2011-02-14,439000,-55500,200,-277.5
"80 PARK AVENUE, 14G",2015-12-02,1050000,2017-11-20,850000,-200000,719,-278.1641168289291
"1 CENTRAL PARK WEST, 47B",2008-03-05,26022485,2018-03-19,25000000,-1022485,3666,-278.9102564102564
"133 WEST 22ND   STREET, 7A",2008-12-19,717866,2010-03-22,590000,-127866,458,-279.1834061135371
"62 WEST 62ND STREET, 16A",2008-06-30,1865000,2011-07-27,1550000,-315000,1122,-280.7486631016043
"380 RECTOR PLACE, 3E",2004-10-27,500000,2007-03-26,252818,-247182,880,-280.88863636363635
"768 5 AVENUE, 805",2008-01-28,5635994,2014-04-07,5000000,-635994,2261,-281.2888102609465
"1 IRVING PLACE, V18I",2014-04-08,705000,2017-07-27,362500,-342500,1206,-283.9966832504146
"200 WEST END AVENUE, 22A",2008-05-16,2469256,2017-11-27,1475000,-994256,3482,-285.5416427340609
"464 WEST 44TH   STREET, 4F",2008-02-14,1294185,2010-06-03,1050000,-244185,840,-290.69642857142856
"222 WEST 14 STREET, 2A",2004-03-26,417908,2004-06-30,390000,-27908,96,-290.7083333333333
"220 RIVERSIDE BOULEVARD, 35C",2008-01-15,2200000,2010-08-17,1925000,-275000,945,-291.005291005291
"350 WEST 42ND STREET, 40F",2006-11-10,796780,2012-08-01,185000,-611780,2091,-292.5777140124342
"1623 3 AVENUE, 36A",2003-02-20,619402,2005-11-04,330000,-289402,988,-292.917004048583
"180 AVENUE OF THE AMER, 10A",2016-03-30,6722975,2017-05-23,6600000,-122975,419,-293.49642004773267
"120 RIVERSIDE BOULEVARD, PH4B",2006-05-22,1568105,2010-03-29,1150000,-418105,1407,-297.16062544420754
"127 MERCER STREET, 2A",2005-03-17,1425000,2009-07-31,947000,-478000,1597,-299.31120851596745
"415 EAST 54TH   STREET, 8F",2009-10-26,995000,2014-02-05,525000,-470000,1563,-300.70377479206655
"101 WEST 24TH STREET, 26B",2015-05-19,3250000,2018-07-16,2900000,-350000,1154,-303.29289428076254
"2 COLUMBUS AVENUE, 16B",2008-02-06,2400000,2012-02-28,1950000,-450000,1483,-303.43897505057316
"400 WEST 12TH STREET, 3F",2013-12-06,4925000,2018-03-13,4450000,-475000,1558,-304.8780487804878
"45 PARK AVENUE, 1601",2008-02-08,2163525,2009-05-05,2025000,-138525,452,-306.4712389380531
"220 RIVERSIDE BOULEVARD, 4A",2005-11-10,1049000,2009-07-24,630000,-419000,1352,-309.9112426035503
"330 EAST 49TH   STREET, TOWER",2007-09-05,1425000,2009-08-28,1200000,-225000,723,-311.2033195020747
"200 WEST END AVENUE, 10C",2008-03-04,1730006,2009-06-04,1587500,-142506,457,-311.8293216630197
"2 COLUMBUS AVENUE, 37B",2006-06-14,2350000,2009-12-17,1950000,-400000,1282,-312.01248049922
"20 WEST 64TH STREET, 18D",2006-09-27,1755000,2010-04-08,1350000,-405000,1289,-314.1970519782777
"135 WEST 70TH STREET, 3B",2012-03-28,4165000,2017-09-29,3530000,-635000,2011,-315.7633018398807
"420 WEST 25TH   STREET, 5A",2010-08-02,997885,2014-12-17,491963,-505922,1598,-316.5969962453066
"150 CHARLES STREET, M9",2015-09-09,9611214,2017-07-06,9400000,-211214,666,-317.1381381381381
"131 WEST 82ND   STREET, 2",2007-08-16,1760000,2012-05-22,1200000,-560000,1741,-321.65422171165994
"141 EAST 88TH STREET, 11C",2015-03-18,3950000,2017-10-03,3650000,-300000,930,-322.5806451612903
"109 GREENE STREET, 2B",2006-07-27,2710000,2009-06-22,2365000,-345000,1061,-325.16493873704053
"505 WEST 47TH   STREET, 6A-N",2011-05-27,815000,2016-01-20,260000,-555000,1699,-326.6627427898764
"40 SUTTON PLACE, 8H",2004-05-25,690000,2008-04-15,220000,-470000,1421,-330.752990851513
"1965 BROADWAY, 10A",2008-02-26,3295000,2012-08-17,2750000,-545000,1634,-333.5373317013464
"400 EAST 51ST   STREET, 14A",2008-02-08,2650000,2012-05-31,2125000,-525000,1574,-333.54510800508257
"7 HARRISON STREET, 5N",2015-01-14,6364062,2017-02-06,6112500,-251562,754,-333.6366047745358
"101 WEST 24TH   STREET, 36B",2008-10-02,2749275,2015-09-16,1900000,-849275,2540,-334.3602362204724
"30 CROSBY STREET, PH-B",2010-02-24,12750000,2013-03-21,12375000,-375000,1121,-334.52274754683316
"225 EAST 34TH STREET, 8C",2007-10-15,1328816,2009-07-21,1112500,-216316,645,-335.3736434108527
"15 WILLIAM STREET, 29G",2009-03-20,1308451,2012-07-09,900000,-408451,1207,-338.40182270091134
"160 CENTRAL PARK SOUTH, 1709",2007-12-20,3120936,2016-12-22,2000000,-1120936,3290,-340.71003039513676
"157 CHAMBERS STREET, 14A",2009-12-16,3182031,2017-03-29,2272500,-909531,2660,-341.92894736842106
"125 CENTRAL PARK NORTH, PH4",2006-08-23,1425550,2009-08-18,1050000,-375550,1091,-344.22548120989916
"340 WEST 57 STREET, 10C",2003-01-30,328000,2004-06-30,150000,-178000,517,-344.294003868472
"525 PARK AVENUE, 6S",2010-03-05,7750000,2017-09-06,6800000,-950000,2742,-346.4624361779723
"120 RIVERSIDE BOULEVARD, 16G",2006-04-27,1076290,2013-12-10,110000,-966290,2784,-347.08692528735634
"275 WEST 96TH   STREET, 9M",2015-01-14,805000,2018-03-09,402500,-402500,1150,-350.0
"350 EAST 82ND STREET, 11H",2006-10-26,1035560,2014-07-07,50000,-985560,2811,-350.60832443970116
"15 BROAD STREET, 716",2008-02-22,1750000,2010-12-29,1385000,-365000,1041,-350.6243996157541
"211 EAST 46TH   STREET, 24G",2009-02-27,965000,2013-03-06,450000,-515000,1468,-350.8174386920981
"18 WEST 48TH   STREET, 28C",2007-09-19,1420458,2010-03-19,1100000,-320458,912,-351.3793859649123
"90 EAST END AVENUE, 6B",2003-06-03,1475000,2007-02-15,997254,-477746,1353,-353.10125646711015
"25 5 AVENUE, 2A",2008-07-10,814600,2012-08-14,285000,-529600,1496,-354.01069518716577
"225 5 AVENUE, PHA",2007-11-08,2450000,2011-05-02,2000000,-450000,1271,-354.05192761605036
"2000 BROADWAY, 11A",2004-09-28,790500,2007-07-27,425000,-365500,1032,-354.1666666666667
"515 EAST 72ND   STREET, 30D",2008-02-26,1934675,2012-03-02,1415000,-519675,1466,-354.4849931787176
"324 PEARL STREET, 3J",2007-01-12,660000,2009-11-02,296474,-363526,1025,-354.659512195122
"100 RIVERSIDE BOULEVARD, 17E",2008-11-03,1466280,2009-12-04,1325000,-141280,396,-356.7676767676768
"421 HUDSON STREET, 413",2014-02-26,4174825,2016-10-05,3835000,-339825,952,-356.9590336134454
"105 NORFOLK STREET, 9B",2007-02-26,2336883,2010-07-01,1900000,-436883,1221,-357.8075348075348
"275 WEST 96TH   STREET, 8C",2014-12-30,840000,2018-03-09,420000,-420000,1165,-360.51502145922746
"101 WARREN STREET, 2540",2008-12-22,2683088,2017-07-25,1550000,-1133088,3137,-361.20114759324196
"215 EAST 80TH   STREET, 11D",2007-05-23,1950000,2014-12-03,950000,-1000000,2751,-363.50418029807344
"517 WEST 46TH   STREET, 502",2008-03-06,1025000,2009-06-30,850000,-175000,481,-363.8253638253638
"308 EAST 72ND   STREET, 4A",2009-05-08,1995000,2011-07-26,1700000,-295000,809,-364.6477132262052
"68 BRADHURST AVENUE, 9-H",2007-06-29,948780,2011-10-17,375000,-573780,1571,-365.23233609166135
"140 7 AVENUE, 7C",2012-07-25,745863,2013-07-30,610000,-135863,370,-367.1972972972973
"303 GREENWICH STREET, 3A",2008-03-28,850000,2009-09-22,650000,-200000,543,-368.3241252302026
"44 EAST 67TH STREET, 11A",2013-06-27,4750000,2015-05-05,4500000,-250000,677,-369.2762186115214
"2 SOUTH END AVENUE, 9B",2003-08-12,990000,2005-01-12,797800,-192200,519,-370.3275529865125
"303 EAST 77TH STREET, 4",2011-01-06,1400093,2018-07-31,371488,-1028605,2763,-372.27832066594283
"90 WILLIAM STREET, 14D",2009-02-09,764705,2010-03-04,620000,-144705,388,-372.95103092783506
"530 PARK AVENUE, 16D",2013-12-20,7568437,2017-05-18,7100000,-468437,1245,-376.25461847389556
"152 FRANKLIN STREET, 7 Res",2005-08-03,5500000,2007-03-22,5275000,-225000,596,-377.51677852348996
"200 EAST 32ND STREET, 9B",2007-06-15,1635000,2013-06-28,800000,-835000,2205,-378.68480725623584
"155 FRANKLIN STREET, 4N",2007-06-01,4300000,2012-06-20,3600000,-700000,1846,-379.1982665222102
"301 EAST 79TH   STREET, 23 M",2015-02-20,845000,2018-03-09,422500,-422500,1113,-379.6046720575022
"246 WEST 17TH   STREET, 3B",2008-10-10,1654656,2010-05-26,1429000,-225656,593,-380.5328836424958
"2 EAST 55TH   STREET, 907",2006-12-08,370110,2007-04-20,319410,-50700,133,-381.203007518797
"70 BATTERY PLACE, 20C",2009-06-10,2143416,2011-06-23,1860000,-283416,743,-381.44818304172276
"10 WEST END AVENUE, 26D",2007-08-31,1583887,2009-06-04,1337500,-246387,643,-383.18351477449454
"2628 BROADWAY, 29A",2007-12-17,3599513,2009-12-22,3315000,-284513,736,-386.5665760869565
"333 EAST 34TH   STREET, 8D",2007-12-13,1206626,2012-07-30,545772,-660854,1691,-390.8066232998226
"21 SOUTH WILLIAM STREET, PH",2007-06-11,2400000,2015-06-29,1245000,-1155000,2940,-392.85714285714283
"252 7 AVENUE, 5I",2015-04-16,4675000,2017-11-21,4300000,-375000,950,-394.7368421052632
"425 FIFTH AVENUE, 41A",2008-02-29,1210000,2009-10-15,975000,-235000,594,-395.6228956228956
"350 EAST 82ND   STREET, 12A",2007-11-21,2046682,2010-08-11,1650000,-396682,994,-399.07645875251507
"140 EAST 63RD   STREET, 5D",2007-12-12,1985587,2012-11-08,1268687,-716900,1793,-399.8326826547685
"515 EAST 72ND   STREET, 6K",2010-03-19,1376865,2015-11-06,550457,-826408,2058,-401.55879494655005
"445 5TH AVENUE, 18H",2012-05-30,680800,2015-05-26,240000,-440800,1091,-404.03299725022913
"160 CENTRAL PARK SOUTH, 807",2007-01-12,2138325,2009-12-28,1700000,-438325,1081,-405.4810360777058
"259 EAST 7TH STREET, G",2007-10-25,2418343,2009-10-15,2125000,-293343,721,-406.85575589459086
"53 NORTH MOORE STREET, 2H",2004-08-20,1200000,2006-02-23,975000,-225000,552,-407.60869565217394
"845 WEST END AVENUE, 6D",2012-05-31,2175000,2017-08-11,1399894,-775106,1898,-408.3804004214963
"555 WEST 23RD   STREET, N8M",2014-12-23,960000,2018-03-09,480000,-480000,1172,-409.55631399317406
"80 ELIZABETH STREET, 8A",2008-05-28,625000,2008-11-26,550000,-75000,182,-412.0879120879121
"150 NASSAU STREET, 9K",2003-03-25,286962,2004-10-21,49515,-237447,576,-412.234375
"12 EAST 12TH   STREET, 5SE",2007-01-18,1910000,2009-02-18,1595000,-315000,762,-413.38582677165357
"145 EAST 48TH   STREET, 35PH-A",2013-03-04,5000000,2014-09-04,4772750,-227250,549,-413.9344262295082
"143 AVENUE B, 4B",2007-07-18,1800000,2012-06-25,1050000,-750000,1804,-415.7427937915743
"220 RIVERSIDE BOULEVARD, 46B",2005-04-01,2200000,2013-03-04,992329,-1207671,2894,-417.3016586040083
"372 CENTRAL PARK WEST, 5V",2014-12-05,995000,2018-03-09,497500,-497500,1190,-418.06722689075633
"340 EAST 23RD STREET, SHD",2008-05-13,2637267,2011-11-18,2100000,-537267,1284,-418.43224299065423
"240 PARK AVENUE SOUTH, 8A",2008-04-08,2876556,2010-05-27,2550000,-326556,779,-419.198973042362
"123 WASHINGTON STREET, 35E",2016-02-17,1349181,2018-03-15,1030000,-319181,757,-421.6393659180978
"530 EAST 76TH   STREET, 35H",2008-12-17,4200000,2017-09-19,2845000,-1355000,3198,-423.7023139462164
"400 WEST 12TH STREET, 3H",2012-05-07,2925000,2015-02-04,2500000,-425000,1003,-423.728813559322
"555 WEST 59TH STREET, 17E",2008-03-25,977520,2012-12-20,236500,-741020,1731,-428.08781051415366
"55 WALL STREET, 550",2008-01-11,2366147,2013-10-30,1450000,-916147,2119,-432.3487494100991
"425 FIFTH AVENUE, 49A",2006-01-05,2240150,2014-09-19,865512,-1374638,3179,-432.41207927021077
"403 EAST 62ND   STREET, 14A",2011-11-03,597000,2012-06-29,493108,-103892,239,-434.69456066945605
"30 PARK PLACE, 53D",2017-01-26,4317380,2018-08-06,4075000,-242380,557,-435.1526032315978
"15 WILLIAM STREET, 38B",2009-08-24,1472500,2013-03-08,906550,-565950,1292,-438.04179566563465
"100 WEST 119 STREET, 2B",2015-11-30,1500000,2017-08-18,1224000,-276000,627,-440.1913875598086
"171 WEST 57TH   STREET, 3B",2007-06-04,4327562,2011-04-29,3700000,-627562,1425,-440.39438596491226
"421 EAST 13TH   STREET, PHF",2008-10-02,1545375,2012-10-03,900000,-645375,1462,-441.43296853625174
"200 EAST 94TH   STREET, 522",2016-05-19,1971987,2017-06-08,1800000,-171987,385,-446.7194805194805
"9 MURRAY STREET, 8NE",2007-01-05,2200000,2012-11-28,1225000,-975000,2154,-452.64623955431756
"15 WILLIAM STREET, 34E",2009-03-02,2029592,2012-12-21,1400000,-629592,1390,-452.9438848920863
"240 PARK AVENUE SOUTH, 4A",2008-03-27,2774731,2010-04-29,2425000,-349731,763,-458.3630406290957
"101 WARREN STREET, 1020",2008-08-05,2637267,2010-06-15,2325000,-312267,679,-459.8924889543446
"17 CORNELIA STREET, 2C",2004-07-21,2464000,2011-03-08,1350000,-1114000,2421,-460.1404378356051
"200 EAST 69TH   STREET, 40B",2016-07-14,3800000,2017-06-01,3650000,-150000,322,-465.83850931677017
"300 RECTOR PLACE, 7R",2005-03-31,370000,2006-12-28,72000,-298000,637,-467.81789638932497
"80 JOHN STREET, 3E",2007-01-26,510906,2008-06-18,272500,-238406,509,-468.3811394891945
"120 EAST 87TH   STREET, P28-C",2008-07-31,2765000,2011-04-07,2300000,-465000,980,-474.48979591836735
"211 EAST 46TH   STREET, 17G",2008-06-25,1070180,2013-07-02,200000,-870180,1833,-474.72995090016366
"15 MERCER STREET, 2A",2011-01-20,3728750,2012-01-27,3550000,-178750,372,-480.51075268817203
"10 LITTLE WEST STREET, 15A",2015-01-12,2500000,2018-05-22,1900000,-600000,1226,-489.3964110929853
"110 WEST 17TH STREET, 6",2005-01-12,1550000,2011-06-06,399999,-1150001,2336,-492.294948630137
"170 EAST END AVENUE, 2M",2008-04-23,2189237,2012-02-22,1500000,-689237,1400,-492.3121428571429
"36 HUDSON STREET, 4A",2007-05-04,2851100,2009-11-04,2400000,-451100,915,-493.0054644808743
"520 WEST 19TH STREET, 4B",2008-09-26,2647450,2010-08-26,2300000,-347450,699,-497.0672389127325
"823 PARK AVENUE, 10",2008-01-24,13860000,2012-09-27,13000000,-860000,1708,-503.5128805620609
"350 EAST 82ND STREET, 12H",2008-12-22,1170987,2010-01-19,972000,-198987,393,-506.32824427480915
"823 PARK AVENUE, 8",2008-01-02,13827835,2013-01-07,12900000,-927835,1832,-506.460152838428
"200 WEST END AVENUE, 6L",2008-06-18,1323725,2014-10-06,150000,-1173725,2301,-510.0934376358105
"779 RIVERSIDE DRIVE, B-60",2008-11-05,480000,2011-04-05,28065,-451935,881,-512.9795686719636
"52 EAST 72ND   STREET, 6A",2007-06-12,4200000,2009-12-21,3725000,-475000,923,-514.6262188515709
"42 EAST 20TH STREET, 3A",2006-03-30,3495000,2008-09-16,3025000,-470000,901,-521.6426193118757
"1965 BROADWAY, 11H",2007-04-30,2100000,2009-07-21,1675000,-425000,813,-522.7552275522755
"415 EAST 54TH   STREET, 10C",2007-03-09,1040000,2010-07-15,399702,-640298,1224,-523.1192810457517
"25 COLUMBUS CIRCLE, ST65F",2004-02-20,2224231,2009-06-30,1200000,-1024231,1957,-523.3679100664282
"1845 ADAM C POWELL BLVD, A1B",2011-06-30,2800000,2017-04-27,1685000,-1115000,2128,-523.9661654135339
"250 EAST 53RD STREET, 602",2008-08-14,1503412,2009-06-01,1350000,-153412,291,-527.1890034364261
"333 EAST 34 STREET, 12J",2005-06-10,585493,2006-04-18,421000,-164493,312,-527.2211538461538
"319 EAST 105 STREET, 6E",2008-06-04,484098,2008-12-08,385000,-99098,187,-529.9358288770053
"175 EAST 2ND   STREET, 1B",2017-09-26,674100,2018-05-03,555863,-118237,219,-539.8949771689498
"402 EAST 90TH   STREET, 3C",2013-02-06,1964158,2013-11-25,1805000,-159158,292,-545.0616438356165
"455 CENTRAL PARK WEST, 19C",2005-09-29,4052635,2006-07-06,3900000,-152635,280,-545.125
"845 SECOND AVENUE, 3A",2017-09-14,900000,2018-08-01,725000,-175000,321,-545.171339563863
"768 5 AVENUE, 1804",2008-03-11,3485256,2012-12-05,2537500,-947756,1730,-547.835838150289
"203 WEST 81ST   STREET, 7F",2009-06-10,630426,2011-10-11,160000,-470426,853,-551.495896834701
"15 WILLIAM STREET, 19D",2009-02-20,1023341,2013-10-23,80995,-942346,1706,-552.3716295427902
"120 EAST 87TH   STREET, R24-B",2008-09-10,2700000,2010-08-30,2300000,-400000,719,-556.3282336578582
"351 EAST 51 STREET, L1B",2004-08-18,5769400,2010-05-06,4600000,-1169400,2087,-560.3258265452803
"1 RIVER TERRACE, 29D",2010-10-28,3429211,2011-05-23,3313113,-116098,207,-560.8599033816425
"211 EAST 46TH   STREET, 26F",2009-09-18,1150622,2013-11-12,300000,-850622,1516,-561.0963060686016
"259 BOWERY, 5",2008-09-12,1900000,2013-09-26,864662,-1035338,1840,-562.6836956521739
"111 CENTRAL PARK NORTH, PHA",2008-02-13,5065793,2010-09-27,4525000,-540793,957,-565.0919540229885
"374 BROADWAY, 7A",2005-03-03,335000,2006-08-18,30000,-305000,533,-572.2326454033771
"170 EAST END AVENUE, 2B",2008-05-16,1629200,2009-12-08,1300000,-329200,571,-576.5323992994746
"160 CENTRAL PARK SOUTH, 1726",2008-07-09,2128142,2012-06-14,1300000,-828142,1436,-576.700557103064
